,onset,offset,label,onset_sample,offset_sample,length
0,1.818614,1.988614,1,54558,59658,5100
1,2.183614,2.332614,1,65508,69978,4470
2,2.334614,2.348614,2,70038,70458,420
3,4.386175,4.638175,1,131585,139145,7560
4,4.881175,4.957175,1,146435,148715,2280
5,5.200175,5.280175,1,156005,158405,2400
6,5.547175,5.681175,1,166415,170435,4020
7,5.878175,5.951175,2,176345,178535,2190
8,5.960175,5.987175,2,178805,179615,810
9,6.023175,6.207175,2,180695,186215,5520
10,6.213175,6.246175,2,186395,187385,990
11,6.276175,6.288175,2,188285,188645,360
12,6.299175,6.508175,1,188975,195245,6270
13,6.834175,6.883175,1,205025,206495,1470
14,6.937175,6.999175,1,208115,209975,1860
15,7.051175,7.110175,1,211535,213305,1770
16,7.544175,7.712175,1,226325,231365,5040
17,7.911175,7.945175,2,237335,238355,1020
18,7.956175,7.977175,2,238685,239315,630
19,8.048175,8.115175,1,241445,243455,2010
20,8.134175,8.216175,1,244025,246485,2460
21,8.281175,8.332175,1,248435,249965,1530
22,9.092175,9.270175,1,272765,278105,5340
23,9.272175,9.329175,1,278165,279875,1710
24,9.523175,9.625175,1,285695,288755,3060
25,9.740175,9.870175,1,292205,296105,3900
26,10.097175,10.228175,2,302915,306845,3930
27,10.230175,10.268175,2,306905,308045,1140
28,10.289175,10.384175,2,308675,311525,2850
29,10.451175,10.462175,2,313535,313865,330
30,10.684175,10.694175,2,320525,320825,300
31,10.888175,10.904175,2,326645,327125,480
32,10.907175,10.946175,2,327215,328385,1170
33,10.960175,10.979175,2,328805,329375,570
34,10.986175,10.999175,2,329585,329975,390
35,11.023175,11.034175,2,330695,331025,330
36,11.222175,11.277175,2,336665,338315,1650
37,11.285175,11.335175,2,338555,340055,1500
38,11.341175,11.384175,2,340235,341525,1290
39,11.421175,11.438175,2,342635,343145,510
40,11.486175,11.501175,2,344585,345035,450
41,11.640175,11.656175,2,349205,349685,480
42,11.664175,11.730175,1,349925,351905,1980
43,11.793175,12.020175,1,353795,360605,6810
44,12.176175,12.228175,1,365285,366845,1560
45,12.232175,12.245175,1,366965,367355,390
46,12.255175,12.358175,1,367655,370745,3090
47,12.536175,12.643175,1,376085,379295,3210
48,12.752175,12.898175,1,382565,386945,4380
49,13.105175,13.423175,1,393155,402695,9540
50,13.611175,13.661175,1,408335,409835,1500
51,13.917175,13.985175,1,417515,419555,2040
52,14.513175,14.683175,2,435395,440495,5100
53,14.693175,14.770175,2,440795,443105,2310
54,14.795175,14.809175,2,443855,444275,420
55,14.816175,14.894175,2,444485,446825,2340
56,14.992175,15.010175,2,449765,450305,540
57,15.331175,15.484175,1,459935,464525,4590
58,15.488175,15.523175,1,464645,465695,1050
59,15.774175,15.933175,1,473225,477995,4770
60,15.935175,16.043175,1,478055,481295,3240
61,16.391175,16.655175,1,491735,499655,7920
62,16.754175,16.827175,1,502625,504815,2190
63,16.934175,17.247175,1,508025,517415,9390
64,17.506175,17.649175,1,525185,529475,4290
65,17.748175,17.789175,1,532445,533675,1230
66,18.001175,18.094175,1,540035,542825,2790
67,18.431175,18.909175,1,552935,567275,14340
68,19.043175,19.191175,1,571295,575735,4440
69,19.240175,19.250175,2,577205,577505,300
70,19.255175,19.306175,1,577655,579185,1530
71,19.309175,19.319175,2,579275,579575,300
72,19.375175,19.465175,1,581255,583955,2700
73,19.507175,19.525175,1,585215,585755,540
74,19.785175,19.802175,2,593555,594065,510
75,19.808175,19.836175,1,594245,595085,840
76,19.840175,20.043175,1,595205,601295,6090
77,20.175175,20.414175,1,605255,612425,7170
78,20.521175,20.544175,1,615635,616325,690
79,20.635175,20.675175,1,619055,620255,1200
80,20.733175,20.769175,1,621995,623075,1080
81,20.790175,20.800175,1,623705,624005,300
82,20.819175,20.831175,1,624575,624935,360
83,20.833175,20.846175,1,624995,625385,390
84,20.867175,20.878175,1,626015,626345,330
85,20.880175,20.893175,1,626405,626795,390
86,20.916175,20.952175,1,627485,628565,1080
87,21.091175,21.175175,2,632735,635255,2520
88,21.189175,21.239175,2,635675,637175,1500
89,21.254175,21.298175,2,637625,638945,1320
90,21.325175,21.449175,1,639755,643475,3720
91,21.527175,21.544175,1,645815,646325,510
92,21.549175,21.637175,1,646475,649115,2640
93,21.715175,21.733175,2,651455,651995,540
94,21.744175,21.794175,2,652325,653825,1500
95,21.797175,21.830175,2,653915,654905,990
96,21.917175,21.929175,2,657515,657875,360
97,21.931175,21.965175,2,657935,658955,1020
98,22.001175,22.046175,2,660035,661385,1350
99,22.054175,22.102175,2,661625,663065,1440
100,22.116175,22.145175,2,663485,664355,870
101,22.163175,22.191175,1,664895,665735,840
102,22.194175,22.229175,2,665825,666875,1050
103,22.244175,22.272175,2,667325,668165,840
104,22.280175,22.307175,1,668405,669215,810
105,22.346175,22.358175,2,670385,670745,360
106,22.368175,22.457175,2,671045,673715,2670
107,22.522175,22.537175,2,675665,676115,450
108,22.548175,22.643175,1,676445,679295,2850
109,22.713175,22.736175,1,681395,682085,690
110,22.739175,22.754175,1,682175,682625,450
111,22.780175,22.819175,1,683405,684575,1170
112,22.880175,22.903175,1,686405,687095,690
113,22.953175,22.991175,1,688595,689735,1140
114,22.997175,23.028175,1,689915,690845,930
115,23.031175,23.056175,1,690935,691685,750
116,23.079175,23.111175,1,692375,693335,960
117,23.190175,23.335175,1,695705,700055,4350
118,23.431175,23.461175,1,702935,703835,900
119,23.567175,23.712175,1,707015,711365,4350
120,23.988175,24.071175,1,719645,722135,2490
121,24.145175,24.200175,1,724355,726005,1650
122,24.202175,24.313175,1,726065,729395,3330
123,24.392175,24.539175,1,731765,736175,4410
124,24.689175,24.809175,1,740675,744275,3600
125,24.811175,24.842175,1,744335,745265,930
126,24.844175,25.017175,1,745325,750515,5190
127,25.023175,25.117175,1,750695,753515,2820
128,25.120175,25.160175,1,753605,754805,1200
129,25.253175,25.295175,2,757595,758855,1260
130,25.306175,25.368175,2,759185,761045,1860
131,25.412175,25.494175,1,762365,764825,2460
132,25.504175,25.687175,1,765125,770615,5490
133,25.737175,25.767175,1,772115,773015,900
134,25.827175,25.890175,1,774815,776705,1890
135,25.965175,26.124175,1,778955,783725,4770
136,26.197175,26.232175,1,785915,786965,1050
137,26.255175,26.274175,2,787655,788225,570
138,26.285175,26.480175,1,788555,794405,5850
139,26.487175,26.520175,1,794615,795605,990
140,26.632175,26.668175,2,798965,800045,1080
141,26.676175,26.747175,2,800285,802415,2130
142,26.751175,26.761175,2,802535,802835,300
143,26.766175,26.784175,2,802985,803525,540
144,26.787175,26.852175,2,803615,805565,1950
145,26.854175,27.014175,1,805625,810425,4800
146,27.016175,27.040175,1,810485,811205,720
147,27.083175,27.104175,2,812495,813125,630
148,27.108175,27.126175,2,813245,813785,540
149,27.140175,27.167175,2,814205,815015,810
150,27.170175,27.193175,2,815105,815795,690
151,27.199175,27.238175,2,815975,817145,1170
152,27.266175,27.284175,2,817985,818525,540
153,27.289175,27.318175,2,818675,819545,870
154,27.336175,27.358175,2,820085,820745,660
155,27.483175,27.506175,1,824495,825185,690
156,27.566175,27.589175,1,826985,827675,690
157,27.602175,27.615175,1,828065,828455,390
158,27.668175,27.717175,1,830045,831515,1470
159,27.728175,27.770175,1,831845,833105,1260
160,27.817175,27.858175,1,834515,835745,1230
161,27.866175,27.878175,1,835985,836345,360
162,27.881175,27.896175,1,836435,836885,450
163,27.900175,27.911175,1,837005,837335,330
164,27.949175,27.981175,1,838475,839435,960
165,28.045175,28.190175,1,841355,845705,4350
166,28.341175,28.368175,1,850235,851045,810
167,28.373175,28.446175,1,851195,853385,2190
168,28.448175,28.468175,1,853445,854045,600
169,28.539175,28.712175,1,856175,861365,5190
170,28.728175,28.961175,1,861845,868835,6990
171,28.963175,29.004175,1,868895,870125,1230
172,29.323175,29.396175,1,879695,881885,2190
173,29.399175,29.448175,1,881975,883445,1470
174,29.505175,29.531175,1,885155,885935,780
175,29.584175,29.624175,1,887525,888725,1200
176,29.681175,29.692175,1,890435,890765,330
177,29.694175,29.710175,1,890825,891305,480
178,29.839175,29.971175,1,895175,899135,3960
179,29.996175,30.006175,2,899885,900185,300
180,30.020175,30.047175,1,900605,901415,810
181,30.118175,30.155175,1,903545,904655,1110
182,30.164175,30.231175,1,904925,906935,2010
183,30.264175,30.314175,1,907925,909425,1500
184,30.318175,30.502175,1,909545,915065,5520
185,30.547175,30.562175,2,916415,916865,450
186,30.579175,30.601175,2,917375,918035,660
187,30.626175,30.660175,2,918785,919805,1020
188,30.926175,30.980175,1,927785,929405,1620
189,30.984175,31.072175,1,929525,932165,2640
190,31.128175,31.185175,1,933845,935555,1710
191,31.190175,31.256175,1,935705,937685,1980
192,31.307175,31.324175,1,939215,939725,510
193,31.329175,31.342175,1,939875,940265,390
194,31.344175,31.367175,1,940325,941015,690
195,31.468175,31.629175,1,944045,948875,4830
196,31.682175,31.708175,2,950465,951245,780
197,31.728175,31.740175,2,951845,952205,360
198,31.758175,31.769175,2,952745,953075,330
199,31.782175,31.940175,1,953465,958205,4740
200,31.944175,31.977175,1,958325,959315,990
201,32.023175,32.033175,2,960695,960995,300
202,32.039175,32.063175,2,961175,961895,720
203,32.097175,32.146175,2,962915,964385,1470
204,32.148175,32.198175,2,964445,965945,1500
205,32.209175,32.220175,2,966275,966605,330
206,32.225175,32.257175,2,966755,967715,960
207,32.278175,32.313175,2,968345,969395,1050
208,32.406175,32.436175,1,972185,973085,900
209,32.441175,32.462175,1,973235,973865,630
210,32.554175,32.577175,1,976625,977315,690
211,32.583175,32.599175,1,977495,977975,480
212,32.620175,32.676175,1,978605,980285,1680
213,32.690175,32.720175,1,980705,981605,900
214,32.722175,32.736175,1,981665,982085,420
215,32.740175,32.750175,1,982205,982505,300
216,32.753175,32.776175,1,982595,983285,690
217,32.796175,32.826175,1,983885,984785,900
218,32.882175,33.010175,1,986465,990305,3840
219,33.219175,33.382175,1,996575,1001465,4890
220,33.941175,34.010175,1,1018235,1020305,2070
221,34.093175,34.402175,1,1022795,1032065,9270
222,34.407175,34.510175,1,1032215,1035305,3090
223,34.520175,34.646175,1,1035605,1039385,3780
224,34.933175,34.947175,2,1047995,1048415,420
225,34.953175,35.113175,1,1048595,1053395,4800
226,35.191175,35.334175,1,1055735,1060025,4290
227,35.672175,35.686175,2,1070165,1070585,420
228,35.690175,35.717175,2,1070705,1071515,810
229,35.734175,35.905175,1,1072025,1077155,5130
230,36.218175,36.370175,1,1086545,1091105,4560
231,36.626175,36.755175,2,1098785,1102655,3870
232,36.761175,36.783175,2,1102835,1103495,660
233,36.788175,36.894175,2,1103645,1106825,3180
234,36.903175,37.095175,1,1107095,1112855,5760
235,37.105175,37.126175,1,1113155,1113785,630
236,37.264175,37.489175,1,1117925,1124675,6750
237,37.544175,37.793175,1,1126325,1133795,7470
238,38.038175,38.126175,1,1141145,1143785,2640
239,38.189175,38.482175,1,1145675,1154465,8790
240,38.486175,38.544175,1,1154585,1156325,1740
241,38.645175,38.666175,1,1159355,1159985,630
242,38.672175,38.823175,1,1160165,1164695,4530
243,38.838175,38.848175,1,1165145,1165445,300
244,39.082175,39.299175,2,1172465,1178975,6510
245,39.328175,39.355175,2,1179845,1180655,810
246,39.381175,39.407175,2,1181435,1182215,780
247,39.409175,39.441175,2,1182275,1183235,960
248,39.476175,39.486175,2,1184285,1184585,300
249,39.494175,39.530175,1,1184825,1185905,1080
250,39.533175,39.701175,1,1185995,1191035,5040
251,39.704175,39.751175,1,1191125,1192535,1410
252,40.052175,40.098175,1,1201565,1202945,1380
253,40.282175,40.432175,1,1208465,1212965,4500
254,40.490175,40.502175,2,1214705,1215065,360
255,40.571175,40.661175,1,1217135,1219835,2700
256,40.797175,40.874175,1,1223915,1226225,2310
257,40.966175,41.023175,1,1228985,1230695,1710
258,41.091175,41.235175,1,1232735,1237055,4320
259,41.300175,41.315175,2,1239005,1239455,450
260,41.442175,41.460175,2,1243265,1243805,540
261,41.466175,41.559175,2,1243985,1246775,2790
262,41.577175,41.607175,2,1247315,1248215,900
263,41.623175,41.742175,2,1248695,1252265,3570
264,41.837175,42.034175,1,1255115,1261025,5910
265,42.039175,42.061175,1,1261175,1261835,660
266,42.064175,42.092175,1,1261925,1262765,840
267,42.342175,42.449175,1,1270265,1273475,3210
268,42.493175,42.503175,2,1274795,1275095,300
269,42.556175,42.568175,2,1276685,1277045,360
270,42.941175,43.006175,1,1288235,1290185,1950
271,43.091175,43.368175,1,1292735,1301045,8310
272,43.594175,43.663175,1,1307825,1309895,2070
273,43.945175,43.981175,2,1318355,1319435,1080
274,43.986175,44.153175,1,1319585,1324595,5010
275,44.334175,44.390175,1,1330025,1331705,1680
276,44.433175,44.504175,1,1332995,1335125,2130
277,44.577175,44.590175,2,1337315,1337705,390
278,44.709175,44.806175,2,1341275,1344185,2910
279,44.815175,44.918175,2,1344455,1347545,3090
280,44.920175,45.152175,1,1347605,1354565,6960
281,45.255175,45.315175,2,1357655,1359455,1800
282,45.446175,45.533175,1,1363385,1365995,2610
283,47.817529,47.910529,1,1434525,1437315,2790
284,47.974529,48.202529,1,1439235,1446075,6840
285,48.377529,48.505529,1,1451325,1455165,3840
286,48.615529,48.700529,1,1458465,1461015,2550
287,48.833529,48.886529,1,1465005,1466595,1590
288,49.023529,49.169529,1,1470705,1475085,4380
289,49.301529,49.444529,1,1479045,1483335,4290
290,49.971529,50.115529,1,1499145,1503465,4320
291,50.117529,50.149529,1,1503525,1504485,960
292,50.277529,50.530529,1,1508325,1515915,7590
293,50.604529,50.836529,1,1518135,1525095,6960
294,51.131529,51.270529,1,1533945,1538115,4170
295,51.313529,51.323529,2,1539405,1539705,300
296,51.326529,51.468529,1,1539795,1544055,4260
297,53.096993,53.283993,1,1592909,1598519,5610
298,53.285993,53.320993,1,1598579,1599629,1050
299,53.492993,53.719993,1,1604789,1611599,6810
300,53.819993,53.844993,1,1614599,1615349,750
301,53.850993,53.870993,1,1615529,1616129,600
302,53.888993,53.924993,1,1616669,1617749,1080
303,53.989993,54.014993,1,1619699,1620449,750
304,54.109993,54.138993,1,1623299,1624169,870
305,54.790667,54.957667,1,1643720,1648730,5010
306,54.960667,55.012667,1,1648820,1650380,1560
307,55.188667,55.276667,1,1655660,1658300,2640
308,55.379667,55.472667,2,1661390,1664180,2790
309,55.488667,55.527667,2,1664660,1665830,1170
310,55.544667,55.604667,2,1666340,1668140,1800
311,55.619667,55.632667,2,1668590,1668980,390
312,55.636667,55.744667,1,1669100,1672340,3240
313,55.748667,55.767667,1,1672460,1673030,570
314,55.815667,55.825667,2,1674470,1674770,300
315,55.856667,55.895667,2,1675700,1676870,1170
316,55.919667,55.956667,2,1677590,1678700,1110
317,55.972667,56.159667,1,1679180,1684790,5610
318,56.228667,56.239667,2,1686860,1687190,330
319,56.258667,56.301667,2,1687760,1689050,1290
320,56.307667,56.360667,2,1689230,1690820,1590
321,56.384667,56.395667,2,1691540,1691870,330
322,56.397667,56.435667,2,1691930,1693070,1140
323,56.454667,56.496667,2,1693640,1694900,1260
324,56.511667,56.523667,2,1695350,1695710,360
325,56.529667,56.562667,2,1695890,1696880,990
326,56.569667,56.580667,2,1697090,1697420,330
327,56.624667,56.643667,1,1698740,1699310,570
328,56.649667,56.660667,2,1699490,1699820,330
329,56.716667,56.760667,1,1701500,1702820,1320
330,56.807667,56.833667,1,1704230,1705010,780
331,56.892667,56.915667,1,1706780,1707470,690
332,56.955667,56.972667,2,1708670,1709180,510
333,56.975667,57.023667,1,1709270,1710710,1440
334,57.041667,57.060667,1,1711250,1711820,570
335,57.375667,57.387667,2,1721270,1721630,360
336,57.391667,57.425667,1,1721750,1722770,1020
337,57.430667,57.484667,1,1722920,1724540,1620
338,57.650667,57.714667,1,1729520,1731440,1920
339,57.754667,57.777667,1,1732640,1733330,690
340,57.804667,57.823667,1,1734140,1734710,570
341,57.904667,57.929667,1,1737140,1737890,750
342,57.933667,58.057667,1,1738010,1741730,3720
343,58.296667,58.512667,1,1748900,1755380,6480
344,58.517667,58.593667,1,1755530,1757810,2280
345,58.650667,58.689667,1,1759520,1760690,1170
346,58.711667,58.808667,1,1761350,1764260,2910
347,58.875667,59.106667,1,1766270,1773200,6930
348,59.320667,59.433667,1,1779620,1783010,3390
349,59.512667,59.650667,1,1785380,1789520,4140
350,59.832667,59.859667,2,1794980,1795790,810
351,59.864667,59.900667,2,1795940,1797020,1080
352,60.441667,60.638667,1,1813250,1819160,5910
353,60.647667,60.674667,1,1819430,1820240,810
354,60.755667,60.897667,1,1822670,1826930,4260
355,61.028667,61.093667,1,1830860,1832810,1950
356,61.099667,61.109667,2,1832990,1833290,300
357,61.459667,61.616667,1,1843790,1848500,4710
358,61.777667,61.934667,1,1853330,1858040,4710
359,62.048667,62.163667,1,1861460,1864910,3450
360,62.591667,62.710667,1,1877750,1881320,3570
361,62.712667,62.722667,1,1881380,1881680,300
362,62.737667,62.763667,1,1882130,1882910,780
363,62.818667,62.919667,1,1884560,1887590,3030
364,63.650667,63.841667,1,1909520,1915250,5730
365,64.024667,64.176667,1,1920740,1925300,4560
366,64.388667,64.398667,2,1931660,1931960,300
367,64.403667,64.512667,1,1932110,1935380,3270
368,64.678667,64.775667,1,1940360,1943270,2910
369,64.822667,64.850667,2,1944680,1945520,840
370,64.865667,64.899667,1,1945970,1946990,1020
371,64.918667,64.929667,2,1947560,1947890,330
372,64.934667,64.968667,1,1948040,1949060,1020
373,65.039667,65.228667,1,1951190,1956860,5670
374,65.249667,65.301667,1,1957490,1959050,1560
375,65.323667,65.340667,2,1959710,1960220,510
376,65.362667,65.395667,2,1960880,1961870,990
377,65.430667,65.465667,2,1962920,1963970,1050
378,65.473667,65.511667,1,1964210,1965350,1140
379,65.726667,65.807667,1,1971800,1974230,2430
380,65.879667,65.964667,1,1976390,1978940,2550
381,65.967667,66.208667,1,1979030,1986260,7230
382,66.392667,66.417667,1,1991780,1992530,750
383,66.545667,66.649667,1,1996370,1999490,3120
384,66.753667,66.847667,1,2002610,2005430,2820
385,67.202667,67.353667,1,2016080,2020610,4530
386,67.382667,67.429667,1,2021480,2022890,1410
387,67.509667,67.534667,1,2025290,2026040,750
388,67.545667,67.557667,2,2026370,2026730,360
389,67.583667,67.607667,1,2027510,2028230,720
390,67.674667,67.698667,1,2030240,2030960,720
391,67.758667,67.771667,1,2032760,2033150,390
392,67.861667,67.895667,1,2035850,2036870,1020
393,67.898667,67.908667,1,2036960,2037260,300
394,67.910667,67.923667,1,2037320,2037710,390
395,68.036667,68.237667,1,2041100,2047130,6030
396,68.277667,68.313667,2,2048330,2049410,1080
397,68.355667,68.554667,1,2050670,2056640,5970
398,68.559667,68.585667,1,2056790,2057570,780
399,68.719667,68.732667,2,2061590,2061980,390
400,68.775667,68.790667,2,2063270,2063720,450
401,68.910667,68.973667,1,2067320,2069210,1890
402,69.297667,69.384667,1,2078930,2081540,2610
403,69.485667,69.843667,1,2084570,2095310,10740
404,69.859667,69.988667,1,2095790,2099660,3870
405,70.182667,70.251667,1,2105480,2107550,2070
406,70.350667,70.469667,1,2110520,2114090,3570
407,70.708667,70.856667,1,2121260,2125700,4440
408,70.955667,71.119667,1,2128670,2133590,4920
409,71.127667,71.244667,1,2133830,2137340,3510
410,71.332667,71.370667,1,2139980,2141120,1140
411,71.417667,71.444667,1,2142530,2143340,810
412,71.493667,71.532667,1,2144810,2145980,1170
413,71.582667,71.746667,1,2147480,2152400,4920
414,71.928667,72.092667,1,2157860,2162780,4920
415,72.095667,72.137667,1,2162870,2164130,1260
416,72.254667,72.284667,2,2167640,2168540,900
417,72.321667,72.334667,2,2169650,2170040,390
418,72.837667,72.863667,1,2185130,2185910,780
419,72.997667,73.080667,1,2189930,2192420,2490
420,73.093667,73.227667,1,2192810,2196830,4020
421,73.332667,73.495667,1,2199980,2204870,4890
422,73.519667,73.593667,2,2205590,2207810,2220
423,73.656667,73.782667,1,2209700,2213480,3780
424,73.855667,73.866667,2,2215670,2216000,330
425,74.799667,74.838667,1,2243990,2245160,1170
426,74.853667,74.877667,1,2245610,2246330,720
427,74.998667,75.356667,1,2249960,2260700,10740
428,75.942667,76.021667,1,2278280,2280650,2370
429,76.023667,76.169667,1,2280710,2285090,4380
430,76.861667,77.050667,1,2305850,2311520,5670
431,79.813083,79.909083,1,2394392,2397272,2880
432,80.021083,80.064083,1,2400632,2401922,1290
433,80.082083,80.093083,1,2402462,2402792,330
434,80.097083,80.107083,1,2402912,2403212,300
435,80.116083,80.126083,1,2403482,2403782,300
436,80.130083,80.142083,1,2403902,2404262,360
437,80.226083,80.349083,1,2406782,2410472,3690
438,80.351083,80.370083,1,2410532,2411102,570
439,80.499083,80.516083,2,2414972,2415482,510
440,80.532083,80.572083,2,2415962,2417162,1200
441,80.578083,80.619083,2,2417342,2418572,1230
442,80.628083,80.676083,1,2418842,2420282,1440
443,80.697083,80.802083,1,2420912,2424062,3150
444,81.985788,82.066788,1,2459573,2462003,2430
445,82.183788,82.241788,1,2465513,2467253,1740
446,82.249788,82.507788,1,2467493,2475233,7740
447,82.599788,82.628788,1,2477993,2478863,870
448,82.741788,82.775788,1,2482253,2483273,1020
449,82.835788,83.022788,1,2485073,2490683,5610
450,83.495889,83.528889,1,2504876,2505866,990
451,83.649889,83.687889,1,2509496,2510636,1140
452,83.711889,83.752889,1,2511356,2512586,1230
453,83.814889,83.837889,1,2514446,2515136,690
454,83.932889,83.965889,1,2517986,2518976,990
455,83.967889,83.977889,2,2519036,2519336,300
456,84.159889,84.173889,2,2524796,2525216,420
457,84.175889,84.205889,1,2525276,2526176,900
458,84.222889,84.270889,1,2526686,2528126,1440
459,84.277889,84.397889,1,2528336,2531936,3600
460,84.544889,84.793889,1,2536346,2543816,7470
461,85.102889,85.123889,1,2553086,2553716,630
462,85.213889,85.241889,1,2556416,2557256,840
463,85.497889,85.601889,1,2564936,2568056,3120
464,85.685889,85.918889,1,2570576,2577566,6990
465,85.923889,86.045889,1,2577716,2581376,3660
466,86.299889,86.492889,1,2588996,2594786,5790
467,86.494889,86.529889,1,2594846,2595896,1050
468,86.674889,86.749889,1,2600246,2602496,2250
469,86.751889,86.761889,2,2602556,2602856,300
470,86.786889,86.799889,2,2603606,2603996,390
471,87.082889,87.134889,1,2612486,2614046,1560
472,87.140889,87.281889,1,2614226,2618456,4230
473,87.685889,87.802889,1,2630576,2634086,3510
474,87.861889,87.979889,1,2635856,2639396,3540
475,87.996889,88.099889,1,2639906,2642996,3090
476,88.166889,88.189889,1,2645006,2645696,690
477,88.247889,88.259889,2,2647436,2647796,360
478,88.267889,88.529889,1,2648036,2655896,7860
479,88.531889,88.589889,1,2655956,2657696,1740
480,88.660889,88.680889,1,2659826,2660426,600
481,88.781889,88.808889,1,2663456,2664266,810
482,88.863889,88.887889,1,2665916,2666636,720
483,88.949889,89.201889,1,2668496,2676056,7560
484,89.252889,89.272889,2,2677586,2678186,600
485,89.365889,89.434889,1,2680976,2683046,2070
486,89.438889,89.448889,2,2683166,2683466,300
487,89.620889,89.637889,2,2688626,2689136,510
488,89.639889,89.755889,1,2689196,2692676,3480
489,89.757889,89.823889,1,2692736,2694716,1980
490,89.901889,89.933889,1,2697056,2698016,960
491,90.011889,90.295889,1,2700356,2708876,8520
492,90.328889,90.420889,1,2709866,2712626,2760
493,90.716889,90.827889,1,2721506,2724836,3330
494,90.904889,91.047889,1,2727146,2731436,4290
495,91.055889,91.142889,1,2731676,2734286,2610
496,91.301889,91.486889,1,2739056,2744606,5550
497,91.511889,91.629889,1,2745356,2748896,3540
498,91.734889,91.759889,1,2752046,2752796,750
499,91.822889,91.873889,1,2754686,2756216,1530
500,91.915889,91.929889,1,2757476,2757896,420
501,91.931889,91.950889,1,2757956,2758526,570
502,92.009889,92.241889,1,2760296,2767256,6960
503,92.246889,92.358889,1,2767406,2770766,3360
504,92.382889,92.464889,1,2771486,2773946,2460
505,92.637889,92.679889,1,2779136,2780396,1260
506,92.754889,92.840889,1,2782646,2785226,2580
507,92.842889,92.939889,1,2785286,2788196,2910
508,92.955889,93.060889,1,2788676,2791826,3150
509,93.105889,93.196889,1,2793176,2795906,2730
510,93.266889,93.289889,1,2798006,2798696,690
511,93.296889,93.311889,1,2798906,2799356,450
512,93.331889,93.345889,1,2799956,2800376,420
513,93.586889,93.778889,1,2807606,2813366,5760
514,93.781889,94.002889,1,2813456,2820086,6630
515,94.031889,94.064889,2,2820956,2821946,990
516,94.145889,94.258889,1,2824376,2827766,3390
517,94.260889,94.533889,1,2827826,2836016,8190
518,94.535889,94.567889,1,2836076,2837036,960
519,94.649889,94.669889,1,2839496,2840096,600
520,94.718889,94.751889,1,2841566,2842556,990
521,94.848889,95.019889,1,2845466,2850596,5130
522,95.021889,95.157889,1,2850656,2854736,4080
523,95.182889,95.236889,1,2855486,2857106,1620
524,95.238889,95.267889,1,2857166,2858036,870
525,95.424889,95.434889,2,2862746,2863046,300
526,95.442889,95.491889,1,2863286,2864756,1470
527,95.578889,95.756889,1,2867366,2872706,5340
528,95.764889,95.825889,1,2872946,2874776,1830
529,95.931889,95.992889,1,2877956,2879786,1830
530,95.995889,96.011889,2,2879876,2880356,480
531,96.084889,96.280889,1,2882546,2888426,5880
532,96.283889,96.461889,1,2888516,2893856,5340
533,96.542889,96.556889,2,2896286,2896706,420
534,96.568889,96.649889,1,2897066,2899496,2430
535,96.658889,96.669889,2,2899766,2900096,330
536,96.718889,96.961889,1,2901566,2908856,7290
537,97.000889,97.010889,2,2910026,2910326,300
538,97.014889,97.027889,2,2910446,2910836,390
539,97.064889,97.097889,2,2911946,2912936,990
540,97.099889,97.165889,2,2912996,2914976,1980
541,97.242889,97.254889,2,2917286,2917646,360
542,97.264889,97.278889,2,2917946,2918366,420
543,97.358889,97.521889,1,2920766,2925656,4890
544,97.583889,97.666889,1,2927516,2930006,2490
545,97.734889,97.907889,1,2932046,2937236,5190
546,97.931889,97.988889,2,2937956,2939666,1710
547,97.996889,98.032889,1,2939906,2940986,1080
548,98.047889,98.066889,2,2941436,2942006,570
549,98.071889,98.087889,2,2942156,2942636,480
550,98.099889,98.292889,1,2942996,2948786,5790
551,98.333889,98.380889,2,2950016,2951426,1410
552,98.383889,98.398889,2,2951516,2951966,450
553,98.403889,98.431889,2,2952116,2952956,840
554,98.433889,98.488889,2,2953016,2954666,1650
555,98.490889,98.617889,2,2954726,2958536,3810
556,98.628889,98.644889,2,2958866,2959346,480
557,98.654889,98.699889,2,2959646,2960996,1350
558,98.714889,98.752889,2,2961446,2962586,1140
559,98.758889,98.776889,2,2962766,2963306,540
560,98.789889,98.800889,2,2963696,2964026,330
561,98.820889,98.854889,1,2964626,2965646,1020
562,98.918889,98.936889,1,2967566,2968106,540
563,98.954889,98.964889,2,2968646,2968946,300
564,98.984889,99.055889,2,2969546,2971676,2130
565,99.062889,99.077889,2,2971886,2972336,450
566,99.079889,99.150889,2,2972396,2974526,2130
567,99.154889,99.177889,2,2974646,2975336,690
568,99.230889,99.388889,1,2976926,2981666,4740
569,99.447889,99.474889,1,2983436,2984246,810
570,99.478889,99.564889,1,2984366,2986946,2580
571,99.662889,99.672889,2,2989886,2990186,300
572,99.684889,99.923889,1,2990546,2997716,7170
573,100.199889,100.429889,1,3005996,3012896,6900
574,100.512889,100.529889,2,3015386,3015896,510
575,100.538889,100.812889,1,3016166,3024386,8220
576,101.084889,101.154889,1,3032546,3034646,2100
577,101.166889,101.207889,1,3035006,3036236,1230
578,101.212889,101.359889,1,3036386,3040796,4410
579,101.373889,101.493889,1,3041216,3044816,3600
580,101.547889,101.557889,2,3046436,3046736,300
581,101.576889,101.811889,1,3047306,3054356,7050
582,102.191889,102.258889,1,3065756,3067766,2010
583,102.280889,102.393889,1,3068426,3071816,3390
584,102.401889,102.496889,1,3072056,3074906,2850
585,102.500889,102.669889,1,3075026,3080096,5070
586,102.720889,102.733889,2,3081626,3082016,390
587,102.775889,102.824889,2,3083276,3084746,1470
588,102.837889,102.858889,2,3085136,3085766,630
589,102.966889,103.229889,1,3089006,3096896,7890
590,103.266889,103.277889,2,3098006,3098336,330
591,103.441889,103.531889,1,3103256,3105956,2700
592,103.661889,103.693889,2,3109856,3110816,960
593,103.696889,103.710889,2,3110906,3111326,420
594,103.725889,103.762889,2,3111776,3112886,1110
595,103.888889,104.100889,1,3116666,3123026,6360
596,104.500889,104.511889,2,3135026,3135356,330
597,104.528889,104.706889,1,3135866,3141206,5340
598,104.737889,104.753889,2,3142136,3142616,480
599,104.755889,104.775889,2,3142676,3143276,600
600,104.815889,104.825889,2,3144476,3144776,300
601,104.859889,104.872889,2,3145796,3146186,390
602,105.065889,105.084889,2,3151976,3152546,570
603,105.088889,105.116889,1,3152666,3153506,840
604,105.225889,105.263889,1,3156776,3157916,1140
605,105.270889,105.456889,1,3158126,3163706,5580
606,105.462889,105.606889,1,3163886,3168206,4320
607,105.631889,105.643889,2,3168956,3169316,360
608,105.658889,105.697889,1,3169766,3170936,1170
609,105.746889,106.005889,1,3172406,3180176,7770
610,106.143889,106.170889,2,3184316,3185126,810
611,106.285889,106.322889,1,3188576,3189686,1110
612,106.336889,106.353889,1,3190106,3190616,510
613,106.364889,106.432889,1,3190946,3192986,2040
614,106.687889,106.900889,1,3200636,3207026,6390
615,107.131889,107.143889,2,3213956,3214316,360
616,107.189889,107.200889,2,3215696,3216026,330
617,107.205889,107.339889,1,3216176,3220196,4020
618,107.405889,107.441889,1,3222176,3223256,1080
619,107.444889,107.523889,1,3223346,3225716,2370
620,107.577889,107.609889,1,3227336,3228296,960
621,107.679889,107.862889,1,3230396,3235886,5490
622,108.199889,108.402889,1,3245996,3252086,6090
623,108.408889,108.442889,1,3252266,3253286,1020
624,108.767889,108.793889,1,3263036,3263816,780
625,108.805889,108.817889,1,3264176,3264536,360
626,108.910889,109.169889,1,3267326,3275096,7770
627,109.176889,109.187889,2,3275306,3275636,330
628,109.217889,109.238889,2,3276536,3277166,630
629,109.255889,109.337889,2,3277676,3280136,2460
630,109.396889,109.422889,2,3281906,3282686,780
631,109.554889,109.613889,1,3286646,3288416,1770
632,109.615889,109.770889,1,3288476,3293126,4650
633,109.772889,109.816889,1,3293186,3294506,1320
634,109.905889,110.115889,1,3297176,3303476,6300
635,110.481889,110.529889,1,3314456,3315896,1440
636,110.617889,110.688889,1,3318536,3320666,2130
637,110.695889,111.060889,1,3320876,3331826,10950
638,111.078889,111.141889,2,3332366,3334256,1890
639,111.144889,111.171889,2,3334346,3335156,810
640,111.188889,111.216889,2,3335666,3336506,840
641,111.232889,111.242889,2,3336986,3337286,300
642,111.244889,111.406889,1,3337346,3342206,4860
643,111.429889,111.475889,2,3342896,3344276,1380
644,111.477889,111.505889,1,3344336,3345176,840
645,111.546889,111.814889,1,3346406,3354446,8040
646,111.909889,111.926889,2,3357296,3357806,510
647,112.132889,112.155889,1,3363986,3364676,690
648,112.168889,112.181889,1,3365066,3365456,390
649,112.221889,112.263889,2,3366656,3367916,1260
650,112.300889,112.418889,1,3369026,3372566,3540
651,112.444889,112.455889,2,3373346,3373676,330
652,112.678889,112.893889,1,3380366,3386816,6450
653,112.949889,113.110889,1,3388496,3393326,4830
654,113.125889,113.138889,2,3393776,3394166,390
655,113.152889,113.164889,2,3394586,3394946,360
656,113.186889,113.236889,2,3395606,3397106,1500
657,113.248889,113.333889,2,3397466,3400016,2550
658,113.351889,113.366889,2,3400556,3401006,450
659,113.378889,113.403889,2,3401366,3402116,750
660,113.408889,113.467889,1,3402266,3404036,1770
661,113.470889,113.512889,1,3404126,3405386,1260
662,113.564889,113.587889,1,3406946,3407636,690
663,113.624889,113.680889,1,3408746,3410426,1680
664,113.721889,113.745889,1,3411656,3412376,720
665,113.750889,113.795889,2,3412526,3413876,1350
666,113.808889,113.821889,2,3414266,3414656,390
667,113.823889,113.856889,2,3414716,3415706,990
668,113.862889,113.906889,2,3415886,3417206,1320
669,114.014889,114.106889,1,3420446,3423206,2760
670,114.113889,114.158889,2,3423416,3424766,1350
671,114.195889,114.483889,1,3425876,3434516,8640
672,114.502889,114.558889,2,3435086,3436766,1680
673,114.562889,114.588889,2,3436886,3437666,780
674,114.613889,114.643889,2,3438416,3439316,900
675,114.652889,114.680889,2,3439586,3440426,840
676,114.682889,114.704889,2,3440486,3441146,660
677,114.712889,114.736889,1,3441386,3442106,720
678,114.743889,114.760889,1,3442316,3442826,510
679,114.884889,114.909889,2,3446546,3447296,750
680,114.914889,115.101889,1,3447446,3453056,5610
681,115.193889,115.203889,2,3455816,3456116,300
682,115.237889,115.482889,1,3457136,3464486,7350
683,115.514889,115.707889,1,3465446,3471236,5790
684,115.894889,116.019889,1,3476846,3480596,3750
685,116.036889,116.048889,2,3481106,3481466,360
686,116.126889,116.432889,1,3483806,3492986,9180
687,116.453889,116.475889,2,3493616,3494276,660
688,116.480889,116.508889,1,3494426,3495266,840
689,116.566889,116.806889,1,3497006,3504206,7200
690,116.819889,116.830889,2,3504596,3504926,330
691,116.851889,116.947889,2,3505556,3508436,2880
692,116.977889,117.044889,2,3509336,3511346,2010
693,117.070889,117.113889,2,3512126,3513416,1290
694,117.123889,117.145889,2,3513716,3514376,660
695,117.153889,117.165889,2,3514616,3514976,360
696,117.176889,117.195889,2,3515306,3515876,570
697,117.279889,117.304889,2,3518396,3519146,750
698,117.314889,117.325889,2,3519446,3519776,330
699,117.429889,117.604889,1,3522896,3528146,5250
700,117.633889,117.698889,1,3529016,3530966,1950
701,117.705889,117.948889,1,3531176,3538466,7290
702,117.950889,118.062889,2,3538526,3541886,3360
703,118.072889,118.126889,2,3542186,3543806,1620
704,118.139889,118.156889,2,3544196,3544706,510
705,118.231889,118.250889,1,3546956,3547526,570
706,118.264889,118.374889,1,3547946,3551246,3300
707,118.390889,118.403889,2,3551726,3552116,390
708,118.424889,118.452889,2,3552746,3553586,840
709,118.456889,118.508889,2,3553706,3555266,1560
710,118.511889,118.539889,2,3555356,3556196,840
711,118.542889,118.612889,2,3556286,3558386,2100
712,118.616889,118.646889,2,3558506,3559406,900
713,118.661889,118.708889,2,3559856,3561266,1410
714,118.739889,118.754889,2,3562196,3562646,450
715,118.767889,118.819889,1,3563036,3564596,1560
716,118.833889,118.845889,2,3565016,3565376,360
717,118.887889,118.900889,2,3566636,3567026,390
718,118.912889,119.164889,1,3567386,3574946,7560
719,119.229889,119.368889,1,3576896,3581066,4170
720,119.385889,119.399889,2,3581576,3581996,420
721,119.637889,119.848889,1,3589136,3595466,6330
722,119.850889,119.870889,2,3595526,3596126,600
723,119.887889,120.058889,1,3596636,3601766,5130
724,120.114889,120.213889,1,3603446,3606416,2970
725,120.303889,120.828889,1,3609116,3624866,15750
726,120.839889,120.957889,1,3625196,3628736,3540
727,120.978889,121.012889,1,3629366,3630386,1020
728,121.014889,121.084889,1,3630446,3632546,2100
729,121.098889,121.188889,2,3632966,3635666,2700
730,121.193889,121.236889,2,3635816,3637106,1290
731,121.239889,121.291889,2,3637196,3638756,1560
732,121.293889,121.331889,2,3638816,3639956,1140
733,121.333889,121.723889,1,3640016,3651716,11700
734,121.725889,121.776889,2,3651776,3653306,1530
735,121.780889,121.804889,2,3653426,3654146,720
736,121.814889,121.825889,2,3654446,3654776,330
737,121.827889,122.054889,1,3654836,3661646,6810
738,122.064889,122.097889,2,3661946,3662936,990
739,122.099889,122.146889,2,3662996,3664406,1410
740,122.150889,122.284889,2,3664526,3668546,4020
741,122.327889,122.420889,1,3669836,3672626,2790
742,122.424889,122.456889,2,3672746,3673706,960
743,122.463889,122.659889,1,3673916,3679796,5880
744,122.666889,122.882889,1,3680006,3686486,6480
745,122.884889,122.910889,1,3686546,3687326,780
746,122.913889,122.940889,1,3687416,3688226,810
747,122.969889,123.046889,2,3689096,3691406,2310
748,123.052889,123.145889,2,3691586,3694376,2790
749,123.199889,123.249889,1,3695996,3697496,1500
750,123.259889,123.282889,1,3697796,3698486,690
751,123.329889,123.733889,1,3699896,3712016,12120
752,123.764889,123.782889,2,3712946,3713486,540
753,123.799889,124.003889,1,3713996,3720116,6120
754,124.024889,124.067889,2,3720746,3722036,1290
755,124.072889,124.120889,2,3722186,3723626,1440
756,124.133889,124.173889,2,3724016,3725216,1200
757,124.183889,124.222889,2,3725516,3726686,1170
758,124.236889,124.278889,2,3727106,3728366,1260
759,124.350889,124.403889,1,3730526,3732116,1590
760,124.512889,124.782889,1,3735386,3743486,8100
761,125.131889,125.151889,2,3753956,3754556,600
762,125.259889,125.306889,1,3757796,3759206,1410
763,125.311889,125.373889,1,3759356,3761216,1860
764,125.427889,125.480889,1,3762836,3764426,1590
765,125.493889,125.516889,1,3764816,3765506,690
766,125.519889,125.541889,2,3765596,3766256,660
767,125.564889,125.778889,1,3766946,3773366,6420
768,125.783889,125.838889,1,3773516,3775166,1650
769,125.944889,126.033889,2,3778346,3781016,2670
770,126.035889,126.071889,2,3781076,3782156,1080
771,126.075889,126.124889,2,3782276,3783746,1470
772,126.199889,126.253889,1,3785996,3787616,1620
773,126.357889,126.415889,1,3790736,3792476,1740
774,126.429889,126.526889,1,3792896,3795806,2910
775,126.529889,126.753889,1,3795896,3802616,6720
776,126.783889,126.796889,2,3803516,3803906,390
777,126.814889,127.017889,1,3804446,3810536,6090
778,127.024889,127.043889,2,3810746,3811316,570
779,127.049889,127.094889,2,3811496,3812846,1350
780,127.111889,127.133889,2,3813356,3814016,660
781,127.145889,127.228889,2,3814376,3816866,2490
782,127.256889,127.448889,1,3817706,3823466,5760
783,127.452889,127.479889,1,3823586,3824396,810
784,127.489889,127.539889,2,3824696,3826196,1500
785,127.561889,127.620889,1,3826856,3828626,1770
786,127.622889,127.648889,1,3828686,3829466,780
787,127.665889,128.081889,1,3829976,3842456,12480
788,128.120889,128.156889,2,3843626,3844706,1080
789,128.179889,128.457889,1,3845396,3853736,8340
790,128.488889,128.514889,2,3854666,3855446,780
791,128.531889,128.557889,2,3855956,3856736,780
792,128.593889,128.829889,1,3857816,3864896,7080
793,129.200889,129.346889,1,3876026,3880406,4380
794,129.365889,129.375889,2,3880976,3881276,300
795,129.398889,129.508889,1,3881966,3885266,3300
796,129.510889,129.545889,1,3885326,3886376,1050
797,129.589889,129.614889,2,3887696,3888446,750
798,129.644889,129.654889,2,3889346,3889646,300
799,129.687889,129.698889,2,3890636,3890966,330
800,129.713889,129.733889,2,3891416,3892016,600
801,129.737889,129.928889,1,3892136,3897866,5730
802,129.982889,130.012889,2,3899486,3900386,900
803,130.017889,130.043889,2,3900536,3901316,780
804,130.050889,130.100889,2,3901526,3903026,1500
805,130.102889,130.176889,2,3903086,3905306,2220
806,130.181889,130.210889,2,3905456,3906326,870
807,130.215889,130.295889,2,3906476,3908876,2400
808,130.324889,130.335889,2,3909746,3910076,330
809,130.339889,130.448889,1,3910196,3913466,3270
810,130.450889,130.759889,1,3913526,3922796,9270
811,130.764889,130.788889,1,3922946,3923666,720
812,130.807889,130.836889,2,3924236,3925106,870
813,130.844889,130.872889,2,3925346,3926186,840
814,130.874889,130.886889,2,3926246,3926606,360
815,130.911889,130.980889,2,3927356,3929426,2070
816,130.985889,131.003889,2,3929576,3930116,540
817,131.006889,131.021889,2,3930206,3930656,450
818,131.038889,131.086889,2,3931166,3932606,1440
819,131.101889,131.137889,2,3933056,3934136,1080
820,131.151889,131.170889,2,3934556,3935126,570
821,131.173889,131.243889,2,3935216,3937316,2100
822,131.250889,131.279889,2,3937526,3938396,870
823,131.299889,131.377889,1,3938996,3941336,2340
824,131.459889,131.700889,1,3943796,3951026,7230
825,131.820889,131.843889,2,3954626,3955316,690
826,131.887889,131.911889,1,3956636,3957356,720
827,131.968889,131.993889,2,3959066,3959816,750
828,131.995889,132.026889,1,3959876,3960806,930
829,132.029889,132.056889,1,3960896,3961706,810
830,132.061889,132.098889,1,3961856,3962966,1110
831,132.100889,132.140889,1,3963026,3964226,1200
832,132.180889,132.210889,2,3965426,3966326,900
833,132.222889,132.236889,1,3966686,3967106,420
834,132.246889,132.266889,1,3967406,3968006,600
835,132.371889,132.449889,1,3971156,3973496,2340
836,132.478889,132.489889,1,3974366,3974696,330
837,132.491889,132.524889,1,3974756,3975746,990
838,132.723889,132.756889,2,3981716,3982706,990
839,132.804889,132.957889,1,3984146,3988736,4590
840,133.002889,133.170889,1,3990086,3995126,5040
841,133.174889,133.198889,1,3995246,3995966,720
842,133.204889,133.240889,1,3996146,3997226,1080
843,133.245889,133.466889,1,3997376,4004006,6630
844,133.499889,133.519889,2,4004996,4005596,600
845,133.543889,133.707889,1,4006316,4011236,4920
846,133.821889,134.195889,1,4014656,4025876,11220
847,134.199889,134.224889,2,4025996,4026746,750
848,134.257889,134.272889,2,4027736,4028186,450
849,134.278889,134.294889,2,4028366,4028846,480
850,134.296889,134.321889,2,4028906,4029656,750
851,134.345889,134.632889,1,4030376,4038986,8610
852,134.657889,134.688889,2,4039736,4040666,930
853,134.714889,134.727889,2,4041446,4041836,390
854,134.840889,134.963889,1,4045226,4048916,3690
855,135.001889,135.070889,2,4050056,4052126,2070
856,135.086889,135.178889,2,4052606,4055366,2760
857,135.191889,135.202889,2,4055756,4056086,330
858,135.204889,135.232889,1,4056146,4056986,840
859,135.237889,135.304889,1,4057136,4059146,2010
860,135.306889,135.351889,2,4059206,4060556,1350
861,135.358889,135.557889,1,4060766,4066736,5970
862,135.561889,135.582889,1,4066856,4067486,630
863,135.628889,135.699889,2,4068866,4070996,2130
864,135.706889,135.730889,2,4071206,4071926,720
865,135.735889,135.749889,2,4072076,4072496,420
866,135.757889,135.868889,2,4072736,4076066,3330
867,135.879889,136.097889,1,4076396,4082936,6540
868,136.101889,136.129889,1,4083056,4083896,840
869,136.152889,136.229889,2,4084586,4086896,2310
870,136.243889,136.268889,2,4087316,4088066,750
871,136.284889,136.523889,1,4088546,4095716,7170
872,136.528889,136.552889,1,4095866,4096586,720
873,136.601889,136.793889,1,4098056,4103816,5760
874,136.795889,136.849889,1,4103876,4105496,1620
875,136.912889,136.923889,2,4107386,4107716,330
876,136.934889,136.946889,2,4108046,4108406,360
877,136.956889,136.999889,2,4108706,4109996,1290
878,137.008889,137.034889,2,4110266,4111046,780
879,137.131889,137.186889,1,4113956,4115606,1650
880,137.264889,137.316889,1,4117946,4119506,1560
881,137.330889,137.775889,1,4119926,4133276,13350
882,137.793889,137.826889,2,4133816,4134806,990
883,137.842889,137.860889,2,4135286,4135826,540
884,137.924889,138.103889,1,4137746,4143116,5370
885,138.139889,138.162889,2,4144196,4144886,690
886,138.226889,138.290889,2,4146806,4148726,1920
887,138.303889,138.316889,2,4149116,4149506,390
888,138.458889,138.741889,1,4153766,4162256,8490
889,138.802889,139.137889,1,4164086,4174136,10050
890,139.259889,139.282889,2,4177796,4178486,690
891,139.303889,139.383889,2,4179116,4181516,2400
892,139.385889,139.417889,2,4181576,4182536,960
893,139.445889,139.476889,2,4183376,4184306,930
894,139.535889,139.605889,1,4186076,4188176,2100
895,139.621889,139.639889,1,4188656,4189196,540
896,139.645889,139.659889,1,4189376,4189796,420
897,139.742889,139.804889,1,4192286,4194146,1860
898,139.814889,139.857889,1,4194446,4195736,1290
899,139.941889,139.953889,1,4198256,4198616,360
900,139.982889,140.003889,1,4199486,4200116,630
901,140.102889,140.118889,2,4203086,4203566,480
902,140.120889,140.306889,1,4203626,4209206,5580
903,140.333889,140.407889,1,4210016,4212236,2220
904,140.433889,140.448889,2,4213016,4213466,450
905,140.465889,140.654889,1,4213976,4219646,5670
906,140.657889,140.711889,1,4219736,4221356,1620
907,140.716889,140.752889,2,4221506,4222586,1080
908,140.773889,140.801889,2,4223216,4224056,840
909,140.838889,140.871889,2,4225166,4226156,990
910,140.898889,140.927889,2,4226966,4227836,870
911,140.930889,140.942889,2,4227926,4228286,360
912,141.067889,141.172889,1,4232036,4235186,3150
913,141.190889,141.278889,1,4235726,4238366,2640
914,141.297889,141.399889,1,4238936,4241996,3060
915,141.410889,141.423889,2,4242326,4242716,390
916,141.425889,141.484889,1,4242776,4244546,1770
917,141.494889,141.660889,1,4244846,4249826,4980
918,141.672889,141.694889,2,4250186,4250846,660
919,141.698889,141.772889,2,4250966,4253186,2220
920,141.786889,141.815889,2,4253606,4254476,870
921,141.959889,142.095889,1,4258796,4262876,4080
922,142.149889,142.161889,2,4264496,4264856,360
923,142.194889,142.231889,2,4265846,4266956,1110
924,142.248889,142.328889,2,4267466,4269866,2400
925,142.346889,142.358889,2,4270406,4270766,360
926,142.376889,142.432889,1,4271306,4272986,1680
927,142.516889,142.982889,1,4275506,4289486,13980
928,143.023889,143.050889,2,4290716,4291526,810
929,143.077889,143.214889,1,4292336,4296446,4110
930,143.242889,143.256889,2,4297286,4297706,420
931,143.262889,143.507889,1,4297886,4305236,7350
932,143.547889,143.628889,2,4306436,4308866,2430
933,143.668889,143.694889,2,4310066,4310846,780
934,143.729889,143.739889,2,4311896,4312196,300
935,143.797889,143.949889,1,4313936,4318496,4560
936,143.952889,143.983889,2,4318586,4319516,930
937,144.027889,144.082889,2,4320836,4322486,1650
938,144.084889,144.120889,2,4322546,4323626,1080
939,144.143889,144.153889,2,4324316,4324616,300
940,144.267889,144.491889,1,4328036,4334756,6720
941,144.559889,144.717889,1,4336796,4341536,4740
942,144.743889,144.759889,2,4342316,4342796,480
943,144.766889,144.777889,2,4343006,4343336,330
944,144.783889,144.877889,1,4343516,4346336,2820
945,145.011889,145.388889,1,4350356,4361666,11310
946,145.574889,145.696889,1,4367246,4370906,3660
947,145.827889,146.128889,1,4374836,4383866,9030
948,146.150889,146.188889,2,4384526,4385666,1140
949,146.285889,146.311889,1,4388576,4389356,780
950,146.314889,146.584889,1,4389446,4397546,8100
951,146.605889,146.679889,1,4398176,4400396,2220
952,146.700889,146.712889,2,4401026,4401386,360
953,146.716889,146.726889,2,4401506,4401806,300
954,146.745889,146.944889,1,4402376,4408346,5970
955,146.952889,146.969889,2,4408586,4409096,510
956,146.975889,146.988889,2,4409276,4409666,390
957,147.319889,147.339889,1,4419596,4420196,600
958,147.353889,147.364889,2,4420616,4420946,330
959,147.407889,147.423889,2,4422236,4422716,480
960,147.479889,147.516889,1,4424396,4425506,1110
961,147.518889,147.696889,1,4425566,4430906,5340
962,147.700889,147.725889,2,4431026,4431776,750
963,147.792889,148.147889,1,4433786,4444436,10650
964,148.165889,148.192889,2,4444976,4445786,810
965,148.195889,148.206889,2,4445876,4446206,330
966,148.208889,148.259889,2,4446266,4447796,1530
967,148.275889,148.301889,2,4448276,4449056,780
968,148.401889,148.448889,1,4452056,4453466,1410
969,148.457889,148.472889,2,4453736,4454186,450
970,148.526889,148.537889,2,4455806,4456136,330
971,148.542889,148.798889,1,4456286,4463966,7680
972,148.853889,148.869889,2,4465616,4466096,480
973,148.917889,148.937889,2,4467536,4468136,600
974,149.019889,149.030889,2,4470596,4470926,330
975,149.032889,149.064889,2,4470986,4471946,960
976,149.174889,149.271889,1,4475246,4478156,2910
977,149.351889,149.603889,1,4480556,4488116,7560
978,149.626889,149.638889,2,4488806,4489166,360
979,149.649889,149.675889,2,4489496,4490276,780
980,149.679889,149.783889,2,4490396,4493516,3120
981,149.787889,149.827889,2,4493636,4494836,1200
982,149.840889,149.858889,2,4495226,4495766,540
983,149.891889,150.108889,1,4496756,4503266,6510
984,150.119889,150.253889,1,4503596,4507616,4020
985,150.283889,150.324889,2,4508516,4509746,1230
986,150.341889,150.370889,2,4510256,4511126,870
987,150.379889,150.423889,2,4511396,4512716,1320
988,150.451889,150.606889,1,4513556,4518206,4650
989,150.651889,150.718889,2,4519556,4521566,2010
990,150.721889,150.803889,2,4521656,4524116,2460
991,150.806889,150.826889,2,4524206,4524806,600
992,150.886889,150.967889,1,4526606,4529036,2430
993,150.983889,151.194889,1,4529516,4535846,6330
994,151.197889,151.211889,2,4535936,4536356,420
995,151.234889,151.529889,1,4537046,4545896,8850
996,151.557889,151.597889,2,4546736,4547936,1200
997,151.602889,151.614889,2,4548086,4548446,360
998,151.616889,151.642889,2,4548506,4549286,780
999,151.644889,151.672889,2,4549346,4550186,840
1000,151.679889,151.705889,2,4550396,4551176,780
1001,151.749889,151.761889,2,4552496,4552856,360
1002,151.771889,151.781889,2,4553156,4553456,300
1003,151.797889,151.835889,1,4553936,4555076,1140
1004,151.842889,151.869889,1,4555286,4556096,810
1005,151.945889,151.956889,2,4558376,4558706,330
1006,151.958889,152.332889,1,4558766,4569986,11220
1007,153.087889,153.146889,1,4592636,4594406,1770
1008,153.153889,153.171889,2,4594616,4595156,540
1009,153.309889,153.397889,1,4599296,4601936,2640
1010,153.415889,153.490889,1,4602476,4604726,2250
1011,153.501889,153.670889,1,4605056,4610126,5070
1012,153.755889,153.785889,1,4612676,4613576,900
1013,154.216889,154.382889,1,4626506,4631486,4980
1014,154.394889,154.424889,1,4631846,4632746,900
1015,154.533889,154.548889,2,4636016,4636466,450
1016,154.550889,154.564889,2,4636526,4636946,420
1017,154.591889,154.854889,1,4637756,4645646,7890
1018,154.864889,154.984889,1,4645946,4649546,3600
1019,155.085889,155.279889,1,4652576,4658396,5820
1020,155.282889,155.314889,1,4658486,4659446,960
1021,155.671889,155.702889,1,4670156,4671086,930
1022,155.811889,155.840889,1,4674356,4675226,870
1023,155.912889,155.940889,2,4677386,4678226,840
1024,155.948889,155.960889,2,4678466,4678826,360
1025,155.967889,155.983889,2,4679036,4679516,480
1026,155.993889,156.145889,1,4679816,4684376,4560
1027,156.175889,156.353889,1,4685276,4690616,5340
1028,156.398889,156.432889,2,4691966,4692986,1020
1029,156.438889,156.484889,2,4693166,4694546,1380
1030,156.574889,156.632889,1,4697246,4698986,1740
1031,156.715889,156.818889,1,4701476,4704566,3090
1032,156.833889,156.926889,1,4705016,4707806,2790
1033,156.932889,156.942889,1,4707986,4708286,300
1034,156.952889,156.982889,1,4708586,4709486,900
1035,156.989889,157.056889,1,4709696,4711706,2010
1036,157.070889,157.083889,1,4712126,4712516,390
1037,157.089889,157.193889,1,4712696,4715816,3120
1038,157.223889,157.251889,1,4716716,4717556,840
1039,157.255889,157.331889,1,4717676,4719956,2280
1040,157.573889,157.718889,1,4727216,4731566,4350
1041,157.834889,157.849889,2,4735046,4735496,450
1042,157.861889,157.949889,2,4735856,4738496,2640
1043,157.954889,158.117889,1,4738646,4743536,4890
1044,158.120889,158.149889,1,4743626,4744496,870
1045,158.180889,158.256889,2,4745426,4747706,2280
1046,158.258889,158.354889,2,4747766,4750646,2880
1047,158.364889,158.392889,2,4750946,4751786,840
1048,158.395889,158.408889,2,4751876,4752266,390
1049,158.417889,158.457889,2,4752536,4753736,1200
1050,158.459889,158.477889,2,4753796,4754336,540
1051,158.491889,158.510889,2,4754756,4755326,570
1052,158.516889,158.530889,2,4755506,4755926,420
1053,158.571889,158.672889,1,4757156,4760186,3030
1054,158.730889,158.747889,2,4761926,4762436,510
1055,158.759889,158.890889,1,4762796,4766726,3930
1056,158.919889,159.139889,1,4767596,4774196,6600
1057,159.141889,159.224889,1,4774256,4776746,2490
1058,159.296889,159.533889,1,4778906,4786016,7110
1059,159.649889,159.701889,2,4789496,4791056,1560
1060,159.724889,159.749889,2,4791746,4792496,750
1061,159.843889,159.865889,1,4795316,4795976,660
1062,160.045889,160.252889,1,4801376,4807586,6210
1063,160.585889,160.620889,1,4817576,4818626,1050
1064,160.634889,160.659889,1,4819046,4819796,750
1065,160.747889,160.808889,1,4822436,4824266,1830
1066,160.812889,161.436889,1,4824386,4843106,18720
1067,161.494889,161.509889,2,4844846,4845296,450
1068,161.590889,161.757889,1,4847726,4852736,5010
1069,161.794889,161.823889,2,4853846,4854716,870
1070,161.829889,161.841889,2,4854896,4855256,360
1071,161.844889,161.933889,2,4855346,4858016,2670
1072,161.939889,161.950889,2,4858196,4858526,330
1073,161.979889,162.052889,1,4859396,4861586,2190
1074,162.068889,162.165889,1,4862066,4864976,2910
1075,162.178889,162.465889,1,4865366,4873976,8610
1076,162.475889,162.608889,1,4874276,4878266,3990
1077,162.724889,162.737889,2,4881746,4882136,390
1078,162.758889,162.769889,2,4882766,4883096,330
1079,162.802889,162.816889,2,4884086,4884506,420
1080,162.866889,163.011889,1,4886006,4890356,4350
1081,163.020889,163.368889,1,4890626,4901066,10440
1082,163.372889,163.496889,1,4901186,4904906,3720
1083,163.636889,163.658889,2,4909106,4909766,660
1084,163.660889,163.767889,1,4909826,4913036,3210
1085,163.823889,163.856889,2,4914716,4915706,990
1086,163.876889,163.912889,2,4916306,4917386,1080
1087,163.914889,163.925889,2,4917446,4917776,330
1088,163.935889,163.963889,2,4918076,4918916,840
1089,164.020889,164.034889,2,4920626,4921046,420
1090,164.037889,164.160889,1,4921136,4924826,3690
1091,164.163889,164.397889,1,4924916,4931936,7020
1092,164.426889,164.443889,2,4932806,4933316,510
1093,164.456889,164.507889,1,4933706,4935236,1530
1094,164.563889,164.810889,1,4936916,4944326,7410
1095,164.864889,164.968889,1,4945946,4949066,3120
1096,164.975889,165.000889,2,4949276,4950026,750
1097,165.058889,165.196889,1,4951766,4955906,4140
1098,165.243889,165.437889,1,4957316,4963136,5820
1099,165.439889,165.496889,1,4963196,4964906,1710
1100,165.580889,165.592889,2,4967426,4967786,360
1101,165.596889,165.641889,2,4967906,4969256,1350
1102,165.650889,165.682889,2,4969526,4970486,960
1103,165.685889,165.699889,2,4970576,4970996,420
1104,165.709889,165.719889,2,4971296,4971596,300
1105,165.723889,165.744889,2,4971716,4972346,630
1106,165.825889,165.893889,1,4974776,4976816,2040
1107,165.958889,166.187889,1,4978766,4985636,6870
1108,166.473889,166.568889,1,4994216,4997066,2850
1109,166.620889,166.745889,1,4998626,5002376,3750
1110,166.787889,166.829889,2,5003636,5004896,1260
1111,166.832889,167.159889,1,5004986,5014796,9810
1112,167.466889,167.479889,2,5024006,5024396,390
1113,167.562889,167.647889,1,5026886,5029436,2550
1114,167.653889,167.800889,1,5029616,5034026,4410
1115,167.945889,168.079889,1,5038376,5042396,4020
1116,168.115889,168.145889,2,5043476,5044376,900
1117,168.184889,168.196889,2,5045546,5045906,360
1118,168.198889,168.298889,1,5045966,5048966,3000
1119,168.306889,168.375889,2,5049206,5051276,2070
1120,168.385889,168.485889,2,5051576,5054576,3000
1121,168.487889,168.501889,2,5054636,5055056,420
1122,168.522889,168.565889,1,5055686,5056976,1290
1123,168.569889,168.642889,1,5057096,5059286,2190
1124,168.648889,168.667889,1,5059466,5060036,570
1125,168.691889,168.916889,1,5060756,5067506,6750
1126,168.919889,168.963889,1,5067596,5068916,1320
1127,168.974889,168.985889,2,5069246,5069576,330
1128,169.070889,169.093889,2,5072126,5072816,690
1129,169.110889,169.120889,2,5073326,5073626,300
1130,169.122889,169.196889,2,5073686,5075906,2220
1131,169.199889,169.317889,1,5075996,5079536,3540
1132,169.335889,169.488889,1,5080076,5084666,4590
1133,169.507889,169.595889,1,5085236,5087876,2640
1134,170.189889,170.200889,2,5105696,5106026,330
1135,170.205889,170.262889,1,5106176,5107886,1710
1136,170.427889,170.448889,2,5112836,5113466,630
1137,170.483889,170.525889,2,5114516,5115776,1260
1138,170.541889,170.740889,1,5116256,5122226,5970
1139,170.745889,170.769889,1,5122376,5123096,720
1140,170.821889,170.838889,2,5124656,5125166,510
1141,170.863889,170.952889,1,5125916,5128586,2670
1142,170.959889,170.979889,2,5128796,5129396,600
1143,170.982889,171.041889,2,5129486,5131256,1770
1144,171.043889,171.062889,2,5131316,5131886,570
1145,171.071889,171.088889,2,5132156,5132666,510
1146,171.093889,171.364889,1,5132816,5140946,8130
1147,171.411889,171.426889,2,5142356,5142806,450
1148,171.516889,171.686889,1,5145506,5150606,5100
1149,171.688889,171.713889,1,5150666,5151416,750
1150,171.715889,171.743889,1,5151476,5152316,840
1151,171.781889,171.840889,2,5153456,5155226,1770
1152,171.842889,171.868889,2,5155286,5156066,780
1153,171.898889,172.110889,1,5156966,5163326,6360
1154,172.112889,172.142889,1,5163386,5164286,900
1155,172.388889,172.655889,1,5171666,5179676,8010
1156,172.693889,172.703889,2,5180816,5181116,300
1157,172.708889,172.727889,2,5181266,5181836,570
1158,172.763889,172.788889,2,5182916,5183666,750
1159,172.794889,172.809889,2,5183846,5184296,450
1160,172.820889,172.859889,2,5184626,5185796,1170
1161,172.863889,173.093889,1,5185916,5192816,6900
1162,173.121889,173.160889,2,5193656,5194826,1170
1163,173.187889,173.467889,1,5195636,5204036,8400
1164,173.514889,173.528889,2,5205446,5205866,420
1165,173.542889,173.574889,2,5206286,5207246,960
1166,173.583889,173.602889,2,5207516,5208086,570
1167,173.611889,173.881889,1,5208356,5216456,8100
1168,173.917889,173.934889,2,5217536,5218046,510
1169,173.956889,173.966889,2,5218706,5219006,300
1170,173.970889,174.146889,1,5219126,5224406,5280
1171,174.188889,174.216889,2,5225666,5226506,840
1172,174.236889,174.286889,2,5227106,5228606,1500
1173,174.292889,174.336889,2,5228786,5230106,1320
1174,174.347889,174.525889,1,5230436,5235776,5340
1175,174.570889,174.582889,2,5237126,5237486,360
1176,174.587889,174.727889,1,5237636,5241836,4200
1177,174.760889,174.840889,2,5242826,5245226,2400
1178,174.854889,174.871889,2,5245646,5246156,510
1179,174.888889,174.913889,2,5246666,5247416,750
1180,174.920889,175.148889,1,5247626,5254466,6840
1181,175.184889,175.229889,2,5255546,5256896,1350
1182,175.252889,175.469889,1,5257586,5264096,6510
1183,175.472889,175.493889,1,5264186,5264816,630
1184,175.734889,175.906889,1,5272046,5277206,5160
1185,176.214889,176.378889,1,5286446,5291366,4920
1186,176.381889,176.417889,1,5291456,5292536,1080
1187,176.486889,176.717889,1,5294606,5301536,6930
1188,176.724889,176.779889,1,5301746,5303396,1650
1189,177.110889,177.343889,1,5313326,5320316,6990
1190,177.503889,177.837889,1,5325116,5335136,10020
1191,177.935889,178.116889,1,5338076,5343506,5430
1192,178.158889,178.182889,2,5344766,5345486,720
1193,178.210889,178.466889,1,5346326,5354006,7680
1194,178.470889,178.496889,1,5354126,5354906,780
1195,178.499889,178.639889,1,5354996,5359196,4200
1196,178.658889,178.928889,1,5359766,5367866,8100
1197,178.958889,178.999889,2,5368766,5369996,1230
1198,179.003889,179.111889,2,5370116,5373356,3240
1199,179.117889,179.398889,1,5373536,5381966,8430
1200,179.411889,179.454889,2,5382356,5383646,1290
1201,179.467889,179.479889,2,5384036,5384396,360
1202,179.481889,179.500889,2,5384456,5385026,570
1203,179.530889,179.793889,1,5385926,5393816,7890
1204,179.836889,179.847889,2,5395106,5395436,330
1205,179.921889,179.933889,2,5397656,5398016,360
1206,180.127889,180.185889,1,5403836,5405576,1740
1207,180.187889,180.271889,1,5405636,5408156,2520
1208,180.301889,180.347889,1,5409056,5410436,1380
1209,180.370889,180.384889,2,5411126,5411546,420
1210,180.408889,180.436889,1,5412266,5413106,840
1211,180.481889,180.505889,2,5414456,5415176,720
1212,180.518889,180.776889,1,5415566,5423306,7740
1213,180.784889,180.798889,2,5423546,5423966,420
1214,180.801889,180.870889,2,5424056,5426126,2070
1215,180.882889,181.131889,1,5426486,5433956,7470
1216,181.149889,181.161889,2,5434496,5434856,360
1217,181.174889,181.210889,2,5435246,5436326,1080
1218,181.239889,181.272889,2,5437196,5438186,990
1219,181.285889,181.506889,1,5438576,5445206,6630
1220,181.517889,181.641889,1,5445536,5449256,3720
1221,181.644889,181.662889,2,5449346,5449886,540
1222,181.677889,181.700889,2,5450336,5451026,690
1223,181.703889,181.989889,1,5451116,5459696,8580
1224,182.227889,182.438889,1,5466836,5473166,6330
1225,182.506889,182.798889,1,5475206,5483966,8760
1226,182.800889,182.810889,2,5484026,5484326,300
1227,182.816889,182.833889,2,5484506,5485016,510
1228,182.861889,182.876889,2,5485856,5486306,450
1229,182.879889,182.892889,2,5486396,5486786,390
1230,182.898889,182.944889,2,5486966,5488346,1380
1231,182.947889,183.288889,1,5488436,5498666,10230
1232,183.308889,183.427889,2,5499266,5502836,3570
1233,183.462889,183.717889,1,5503886,5511536,7650
1234,183.746889,183.783889,2,5512406,5513516,1110
1235,183.797889,183.815889,2,5513936,5514476,540
1236,183.839889,183.901889,2,5515196,5517056,1860
1237,183.944889,184.208889,1,5518346,5526266,7920
1238,184.275889,184.285889,2,5528276,5528576,300
1239,184.318889,184.340889,2,5529566,5530226,660
1240,184.454889,184.467889,2,5533646,5534036,390
1241,184.563889,184.659889,1,5536916,5539796,2880
1242,184.731889,184.853889,1,5541956,5545616,3660
1243,184.863889,184.873889,2,5545916,5546216,300
1244,184.891889,184.909889,2,5546756,5547296,540
1245,184.915889,184.940889,1,5547476,5548226,750
1246,184.957889,185.017889,1,5548736,5550536,1800
1247,185.020889,185.095889,1,5550626,5552876,2250
1248,185.100889,185.267889,1,5553026,5558036,5010
1249,185.271889,185.310889,1,5558156,5559326,1170
1250,185.323889,185.365889,2,5559716,5560976,1260
1251,185.369889,185.418889,2,5561096,5562566,1470
1252,185.434889,185.475889,2,5563046,5564276,1230
1253,185.478889,185.494889,2,5564366,5564846,480
1254,185.496889,185.548889,2,5564906,5566466,1560
1255,185.551889,185.570889,2,5566556,5567126,570
1256,185.584889,185.732889,1,5567546,5571986,4440
1257,185.771889,185.820889,1,5573156,5574626,1470
1258,185.824889,185.977889,1,5574746,5579336,4590
1259,186.010889,186.078889,2,5580326,5582366,2040
1260,186.082889,186.121889,2,5582486,5583656,1170
1261,186.125889,186.135889,2,5583776,5584076,300
1262,186.138889,186.303889,1,5584166,5589116,4950
1263,186.310889,186.335889,1,5589326,5590076,750
1264,186.339889,186.395889,1,5590196,5591876,1680
1265,186.405889,186.415889,2,5592176,5592476,300
1266,186.420889,186.439889,2,5592626,5593196,570
1267,186.495889,186.693889,1,5594876,5600816,5940
1268,186.820889,186.847889,2,5604626,5605436,810
1269,186.898889,186.908889,2,5606966,5607266,300
1270,187.031889,187.119889,1,5610956,5613596,2640
1271,187.137889,187.169889,1,5614136,5615096,960
1272,187.250889,187.534889,1,5617526,5626046,8520
1273,187.555889,187.565889,2,5626676,5626976,300
1274,187.586889,187.597889,2,5627606,5627936,330
1275,187.977889,188.126889,1,5639336,5643806,4470
1276,188.190889,188.207889,2,5645726,5646236,510
1277,188.228889,188.272889,2,5646866,5648186,1320
1278,188.278889,188.290889,2,5648366,5648726,360
1279,188.299889,188.333889,2,5648996,5650016,1020
1280,188.351889,188.361889,2,5650556,5650856,300
1281,188.368889,188.383889,2,5651066,5651516,450
1282,188.422889,188.484889,1,5652686,5654546,1860
1283,188.495889,188.518889,1,5654876,5655566,690
1284,188.521889,188.676889,1,5655656,5660306,4650
1285,188.682889,188.754889,1,5660486,5662646,2160
1286,188.768889,188.780889,2,5663066,5663426,360
1287,188.788889,188.810889,1,5663666,5664326,660
1288,188.824889,188.904889,1,5664746,5667146,2400
1289,188.917889,188.941889,1,5667536,5668256,720
1290,188.947889,189.017889,1,5668436,5670536,2100
1291,189.019889,189.039889,1,5670596,5671196,600
1292,189.052889,189.072889,1,5671586,5672186,600
1293,189.088889,189.146889,1,5672666,5674406,1740
1294,189.160889,189.179889,1,5674826,5675396,570
1295,189.185889,189.210889,1,5675576,5676326,750
1296,189.225889,189.292889,1,5676776,5678786,2010
1297,189.465889,189.687889,1,5683976,5690636,6660
1298,189.689889,189.715889,1,5690696,5691476,780
1299,189.725889,189.738889,2,5691776,5692166,390
1300,189.750889,189.762889,2,5692526,5692886,360
1301,189.769889,189.789889,2,5693096,5693696,600
1302,189.803889,189.816889,2,5694116,5694506,390
1303,189.831889,189.851889,2,5694956,5695556,600
1304,189.859889,189.893889,2,5695796,5696816,1020
1305,189.918889,189.928889,2,5697566,5697866,300
1306,189.930889,189.945889,2,5697926,5698376,450
1307,189.965889,189.975889,2,5698976,5699276,300
1308,189.998889,190.393889,1,5699966,5711816,11850
1309,190.411889,190.485889,2,5712356,5714576,2220
1310,190.488889,190.519889,2,5714666,5715596,930
1311,190.525889,190.675889,1,5715776,5720276,4500
1312,190.724889,190.745889,2,5721746,5722376,630
1313,190.749889,190.813889,2,5722496,5724416,1920
1314,190.824889,190.861889,2,5724746,5725856,1110
1315,190.874889,190.928889,2,5726246,5727866,1620
1316,190.935889,190.955889,2,5728076,5728676,600
1317,190.973889,190.986889,2,5729216,5729606,390
1318,191.019889,191.062889,1,5730596,5731886,1290
1319,191.151889,191.369889,1,5734556,5741096,6540
1320,191.393889,191.501889,1,5741816,5745056,3240
1321,191.507889,191.544889,2,5745236,5746346,1110
1322,191.551889,191.602889,1,5746556,5748086,1530
1323,191.609889,191.858889,1,5748296,5755766,7470
1324,191.874889,191.918889,1,5756246,5757566,1320
1325,191.921889,191.967889,2,5757656,5759036,1380
1326,191.977889,192.018889,1,5759336,5760566,1230
1327,192.020889,192.063889,2,5760626,5761916,1290
1328,192.074889,192.340889,1,5762246,5770226,7980
1329,192.413889,192.634889,1,5772416,5779046,6630
1330,192.640889,192.650889,2,5779226,5779526,300
1331,192.654889,192.678889,2,5779646,5780366,720
1332,192.684889,192.709889,2,5780546,5781296,750
1333,192.714889,192.737889,2,5781446,5782136,690
1334,192.768889,192.798889,2,5783066,5783966,900
1335,192.804889,192.871889,2,5784146,5786156,2010
1336,192.892889,193.167889,1,5786786,5795036,8250
1337,193.185889,193.254889,1,5795576,5797646,2070
1338,193.257889,193.311889,1,5797736,5799356,1620
1339,193.337889,193.360889,2,5800136,5800826,690
1340,193.374889,193.453889,1,5801246,5803616,2370
1341,193.460889,193.508889,1,5803826,5805266,1440
1342,193.538889,193.580889,1,5806166,5807426,1260
1343,193.627889,193.659889,1,5808836,5809796,960
1344,193.664889,193.690889,2,5809946,5810726,780
1345,193.710889,193.831889,1,5811326,5814956,3630
1346,193.871889,193.881889,1,5816156,5816456,300
1347,193.891889,193.902889,1,5816756,5817086,330
1348,193.918889,193.947889,2,5817566,5818436,870
1349,193.992889,194.003889,1,5819786,5820116,330
1350,194.012889,194.063889,2,5820386,5821916,1530
1351,194.066889,194.117889,2,5822006,5823536,1530
1352,194.137889,194.321889,1,5824136,5829656,5520
1353,194.324889,194.548889,1,5829746,5836466,6720
1354,194.551889,194.573889,2,5836556,5837216,660
1355,194.612889,194.622889,2,5838386,5838686,300
1356,194.627889,194.748889,1,5838836,5842466,3630
1357,194.813889,194.965889,1,5844416,5848976,4560
1358,194.988889,195.012889,2,5849666,5850386,720
1359,195.032889,195.174889,1,5850986,5855246,4260
1360,195.187889,195.202889,2,5855636,5856086,450
1361,195.205889,195.233889,2,5856176,5857016,840
1362,195.238889,195.452889,1,5857166,5863586,6420
1363,195.458889,195.488889,1,5863766,5864666,900
1364,195.491889,195.516889,2,5864756,5865506,750
1365,195.543889,195.825889,1,5866316,5874776,8460
1366,195.828889,195.889889,2,5874866,5876696,1830
1367,195.891889,195.937889,2,5876756,5878136,1380
1368,195.952889,195.967889,2,5878586,5879036,450
1369,195.977889,196.043889,1,5879336,5881316,1980
1370,196.054889,196.073889,2,5881646,5882216,570
1371,196.079889,196.118889,2,5882396,5883566,1170
1372,196.145889,196.225889,2,5884376,5886776,2400
1373,196.236889,196.259889,2,5887106,5887796,690
1374,196.261889,196.280889,2,5887856,5888426,570
1375,196.283889,196.394889,1,5888516,5891846,3330
1376,196.414889,196.443889,2,5892446,5893316,870
1377,196.464889,196.571889,1,5893946,5897156,3210
1378,196.609889,196.620889,2,5898296,5898626,330
1379,196.645889,196.662889,2,5899376,5899886,510
1380,196.678889,196.692889,2,5900366,5900786,420
1381,196.696889,196.724889,2,5900906,5901746,840
1382,196.726889,196.756889,2,5901806,5902706,900
1383,196.776889,196.811889,2,5903306,5904356,1050
1384,196.815889,196.827889,2,5904476,5904836,360
1385,196.836889,196.879889,1,5905106,5906396,1290
1386,196.891889,197.017889,1,5906756,5910536,3780
1387,197.027889,197.073889,2,5910836,5912216,1380
1388,197.076889,197.175889,2,5912306,5915276,2970
1389,197.198889,197.252889,1,5915966,5917586,1620
1390,197.265889,197.300889,1,5917976,5919026,1050
1391,197.355889,197.370889,2,5920676,5921126,450
1392,197.382889,197.411889,2,5921486,5922356,870
1393,197.420889,197.450889,2,5922626,5923526,900
1394,197.928889,198.044889,1,5937866,5941346,3480
1395,198.132889,198.593889,1,5943986,5957816,13830
1396,198.598889,198.703889,1,5957966,5961116,3150
1397,199.122889,199.133889,2,5973686,5974016,330
1398,199.140889,199.210889,1,5974226,5976326,2100
1399,199.278889,199.297889,2,5978366,5978936,570
1400,199.318889,199.368889,2,5979566,5981066,1500
1401,199.379889,199.403889,2,5981396,5982116,720
1402,199.423889,199.433889,2,5982716,5983016,300
1403,199.499889,199.607889,1,5984996,5988236,3240
1404,199.633889,199.646889,2,5989016,5989406,390
1405,199.675889,199.802889,1,5990276,5994086,3810
1406,199.833889,200.071889,1,5995016,6002156,7140
1407,200.075889,200.115889,2,6002276,6003476,1200
1408,200.122889,200.152889,2,6003686,6004586,900
1409,200.162889,200.199889,2,6004886,6005996,1110
1410,200.204889,200.261889,2,6006146,6007856,1710
1411,200.268889,200.314889,2,6008066,6009446,1380
1412,200.316889,200.369889,2,6009506,6011096,1590
1413,200.431889,200.489889,1,6012956,6014696,1740
1414,200.541889,200.596889,1,6016256,6017906,1650
1415,200.598889,200.856889,1,6017966,6025706,7740
1416,200.872889,200.924889,1,6026186,6027746,1560
1417,200.932889,200.967889,1,6027986,6029036,1050
1418,200.989889,201.003889,2,6029696,6030116,420
1419,201.027889,201.037889,2,6030836,6031136,300
1420,201.040889,201.228889,1,6031226,6036866,5640
1421,201.231889,201.285889,1,6036956,6038576,1620
1422,201.352889,201.391889,2,6040586,6041756,1170
1423,201.394889,201.424889,2,6041846,6042746,900
1424,201.459889,201.478889,2,6043796,6044366,570
1425,201.664889,201.718889,1,6049946,6051566,1620
1426,201.721889,201.737889,2,6051656,6052136,480
1427,201.824889,201.962889,1,6054746,6058886,4140
1428,202.008889,202.024889,2,6060266,6060746,480
1429,202.374889,202.386889,1,6071246,6071606,360
1430,202.388889,202.544889,1,6071666,6076346,4680
1431,202.690889,202.755889,1,6080726,6082676,1950
1432,202.757889,203.099889,1,6082736,6092996,10260
1433,203.138889,203.153889,2,6094166,6094616,450
1434,203.659889,203.670889,2,6109796,6110126,330
1435,203.674889,203.888889,1,6110246,6116666,6420
1436,203.946889,203.973889,2,6118406,6119216,810
1437,203.985889,204.004889,2,6119576,6120146,570
1438,204.057889,204.088889,2,6121736,6122666,930
1439,204.145889,204.171889,1,6124376,6125156,780
1440,204.245889,204.288889,1,6127376,6128666,1290
1441,204.329889,204.351889,1,6129896,6130556,660
1442,204.397889,204.445889,1,6131936,6133376,1440
1443,204.448889,204.491889,1,6133466,6134756,1290
1444,204.539889,204.630889,1,6136196,6138926,2730
1445,204.858889,204.868889,2,6145766,6146066,300
1446,204.880889,205.033889,1,6146426,6151016,4590
1447,205.330889,205.439889,1,6159926,6163196,3270
1448,205.443889,205.467889,1,6163316,6164036,720
1449,206.004889,206.082889,1,6180146,6182486,2340
1450,206.194889,206.302889,1,6185846,6189086,3240
1451,206.367889,206.486889,1,6191036,6194606,3570
1452,206.553889,206.664889,1,6196616,6199946,3330
1453,206.738889,206.860889,1,6202166,6205826,3660
1454,206.990889,207.179889,1,6209726,6215396,5670
1455,207.226889,207.236889,2,6216806,6217106,300
1456,207.405889,207.668889,1,6222176,6230066,7890
1457,207.803889,207.815889,2,6234116,6234476,360
1458,208.220889,208.387889,1,6246626,6251636,5010
