,onset,offset,label,onset_sample,offset_sample,length
0,1.709363,1.928363,1,75382,85040,9658
1,2.082363,2.242363,1,91832,98888,7056
2,2.285363,2.301363,2,100784,101490,706
3,2.694363,2.747363,2,118821,121158,2337
4,2.759363,2.840363,1,121687,125260,3573
5,2.852363,2.914363,1,125789,128523,2734
6,5.344529,5.352529,2,235693,236046,353
7,5.354529,5.525529,1,236134,243675,7541
8,5.614529,5.622529,2,247600,247953,353
9,5.627529,5.702529,1,248174,251481,3307
10,5.804529,5.894529,2,255979,259948,3969
11,5.902529,5.912529,2,260301,260742,441
12,5.914529,5.938529,2,260830,261889,1059
13,5.942529,5.963529,2,262065,262991,926
14,5.970529,6.033529,2,263300,266078,2778
15,6.037529,6.045529,2,266255,266607,352
16,6.055529,6.197529,1,267048,273311,6263
17,6.234529,6.277529,2,274942,276839,1897
18,6.285529,6.301529,2,277191,277897,706
19,6.304529,6.319529,2,278029,278691,662
20,6.321529,6.344529,2,278779,279793,1014
21,6.348529,6.379529,2,279970,281337,1367
22,6.408529,6.421529,2,282616,283189,573
23,6.429529,6.441529,2,283542,284071,529
24,6.445529,6.499529,1,284247,286629,2382
25,6.505529,6.517529,1,286893,287423,530
26,6.526529,6.538529,2,287819,288349,530
27,6.547529,6.623529,2,288746,292097,3351
28,6.625529,6.733529,2,292185,296948,4763
29,6.749529,6.768529,2,297654,298492,838
30,6.771529,6.779529,2,298624,298977,353
31,6.785529,6.911529,1,299241,304798,5557
32,7.012529,7.024529,2,309252,309781,529
33,7.027529,7.034529,2,309914,310222,308
34,7.058529,7.105529,2,311281,313353,2072
35,7.110529,7.214529,2,313574,318160,4586
36,7.216529,7.241529,2,318248,319351,1103
37,7.246529,7.266529,2,319571,320453,882
38,7.278529,7.305529,2,320983,322173,1190
39,7.311529,7.345529,2,322438,323937,1499
40,7.404529,7.484529,1,326539,330067,3528
41,7.575529,7.902529,1,334080,348501,14421
42,8.111529,8.213529,1,357718,362216,4498
43,8.356529,8.372529,2,368522,369228,706
44,8.407529,8.426529,2,370772,371609,837
45,8.441529,8.455529,2,372271,372888,617
46,8.472529,8.508529,2,373638,375226,1588
47,8.532529,8.582529,2,376284,378489,2205
48,8.585529,8.760529,1,378621,386339,7718
49,8.765529,8.901529,1,386559,392557,5998
50,8.942529,8.968529,2,394365,395512,1147
51,8.978529,9.009529,1,395953,397320,1367
52,9.027529,9.039529,2,398114,398643,529
53,9.048529,9.068529,2,399040,399922,882
54,9.090529,9.314529,1,400892,410770,9878
55,9.624529,9.636529,2,424441,424970,529
56,9.707529,9.761529,1,428102,430483,2381
57,9.766529,9.782529,2,430703,431409,706
58,9.791529,9.830529,1,431806,433526,1720
59,9.832529,9.867529,1,433614,435158,1544
60,9.916529,9.943529,1,437318,438509,1191
61,9.978529,10.019529,1,440053,441861,1808
62,10.026529,10.043529,1,442169,442919,750
63,10.055529,10.087529,1,443448,444860,1412
64,10.186529,10.340529,1,449225,456017,6792
65,10.736529,10.748529,2,473480,474010,530
66,10.751529,10.841529,1,474142,478111,3969
67,10.944529,11.351529,1,482653,500602,17949
68,11.379529,11.398529,2,501837,502675,838
69,11.438529,11.453529,2,504439,505100,661
70,11.489529,11.536529,1,506688,508760,2072
71,11.540529,11.656529,1,508937,514052,5115
72,11.685529,11.714529,2,515331,516610,1279
73,11.761529,11.861529,2,518683,523093,4410
74,11.865529,11.879529,2,523269,523887,618
75,11.927529,11.973529,1,526004,528032,2028
76,12.021529,12.041529,1,530149,531031,882
77,12.100529,12.143529,1,533633,535529,1896
78,12.150529,12.183529,1,535838,537293,1455
79,12.197529,12.207529,1,537911,538352,441
80,12.209529,12.224529,1,538440,539101,661
81,12.285529,12.301529,2,541791,542497,706
82,12.325529,12.341529,2,543555,544261,706
83,12.343529,12.364529,2,544349,545275,926
84,12.366529,12.654529,1,545363,558064,12701
85,12.691529,12.699529,2,559696,560049,353
86,12.705529,12.718529,2,560313,560887,574
87,12.760529,12.865529,2,562739,567369,4630
88,12.884529,12.893529,2,568207,568604,397
89,12.896529,13.058529,1,568736,575881,7145
90,13.060529,13.091529,1,575969,577336,1367
91,13.122529,13.158529,2,578703,580291,1588
92,13.160529,13.271529,2,580379,585274,4895
93,13.273529,13.286529,2,585362,585935,573
94,13.288529,13.322529,2,586024,587523,1499
95,13.327529,13.343529,2,587744,588449,705
96,13.349529,13.420529,1,588714,591845,3131
97,13.427529,13.511529,1,592154,595858,3704
98,13.522529,13.532529,2,596343,596784,441
99,13.545529,13.557529,2,597357,597887,530
100,13.563529,13.585529,1,598151,599121,970
101,13.589529,13.724529,1,599298,605251,5953
102,13.729529,13.810529,2,605472,609044,3572
103,13.815529,13.852529,2,609264,610896,1632
104,13.854529,13.895529,2,610984,612792,1808
105,13.897529,13.908529,2,612881,613366,485
106,13.958529,13.965529,2,615571,615879,308
107,14.222529,14.244529,2,627213,628183,970
108,14.249529,14.281529,1,628404,629815,1411
109,14.293529,14.387529,1,630344,634490,4146
110,14.444529,14.471529,1,637003,638194,1191
111,14.520529,14.732529,1,640355,649704,9349
112,14.735529,14.768529,1,649836,651292,1456
113,14.834529,14.848529,2,654202,654820,618
114,14.854529,14.866529,2,655084,655613,529
115,14.900529,14.917529,2,657113,657863,750
116,14.942529,14.981529,2,658965,660685,1720
117,15.082529,15.099529,2,665139,665889,750
118,15.104529,15.137529,1,666109,667565,1456
119,15.144529,15.262529,1,667873,673077,5204
120,15.319529,15.354529,1,675591,677134,1543
121,15.390529,15.409529,2,678722,679560,838
122,15.414529,15.609529,1,679780,688380,8600
123,15.611529,15.659529,1,688468,690585,2117
124,15.674529,15.698529,2,691246,692305,1059
125,15.776529,15.788529,2,695744,696274,530
126,15.919529,16.027529,1,702051,706814,4763
127,16.081529,16.107529,1,709195,710342,1147
128,16.142529,16.162529,1,711885,712767,882
129,16.242529,16.264529,1,716295,717265,970
130,16.340529,16.537529,1,720617,729305,8688
131,16.597529,16.643529,2,731951,733979,2028
132,16.659529,16.681529,2,734685,735655,970
133,16.685529,16.694529,2,735831,736228,397
134,16.700529,16.743529,2,736493,738389,1896
135,16.755529,16.813529,2,738918,741476,2558
136,16.822529,16.847529,2,741873,742976,1103
137,16.875529,16.886529,2,744210,744695,485
138,16.916529,16.935529,1,746018,746856,838
139,16.945529,17.101529,1,747297,754177,6880
140,17.104529,17.158529,1,754309,756691,2382
141,17.167529,17.176529,2,757088,757484,396
142,17.186529,17.205529,2,757925,758763,838
143,17.229529,17.236529,2,759822,760130,308
144,17.246529,17.426529,1,760571,768509,7938
145,17.431529,17.438529,2,768730,769039,309
146,17.458529,17.484529,2,769921,771067,1146
147,17.493529,17.505529,2,771464,771993,529
148,17.533529,17.751529,1,773228,782842,9614
149,17.795529,17.803529,2,784782,785135,353
150,18.072529,18.094529,1,796998,797968,970
151,18.217529,18.251529,1,803393,804892,1499
152,18.254529,18.285529,1,805024,806391,1367
153,18.292529,18.429529,1,806700,812742,6042
154,18.483529,18.499529,2,815123,815829,706
155,18.663529,18.670529,1,823061,823370,309
156,18.687529,18.862529,1,824120,831837,7717
157,18.968529,18.980529,2,836512,837041,529
158,18.991529,19.032529,2,837526,839334,1808
159,19.037529,19.085529,2,839555,841671,2116
160,19.093529,19.116529,2,842024,843038,1014
161,19.119529,19.263529,1,843171,849521,6350
162,19.271529,19.302529,2,849874,851241,1367
163,19.306529,19.321529,2,851417,852079,662
164,19.334529,19.365529,1,852652,854019,1367
165,19.375529,19.413529,2,854460,856136,1676
166,19.422529,19.671529,1,856533,867514,10981
167,19.687529,19.801529,2,868220,873247,5027
168,19.806529,19.832529,2,873467,874614,1147
169,19.864529,19.882529,2,876025,876819,794
170,19.885529,19.893529,2,876951,877304,353
171,19.947529,19.963529,2,879686,880391,705
172,19.965529,20.165529,1,880479,889299,8820
173,20.169529,20.193529,1,889476,890534,1058
174,20.202529,20.255529,1,890931,893268,2337
175,20.284529,20.326529,2,894547,896399,1852
176,20.335529,20.578529,1,896796,907513,10717
177,20.869529,20.876529,2,920346,920654,308
178,20.881529,20.987529,1,920875,925550,4675
179,21.075529,21.248529,1,929430,937060,7630
180,21.312529,21.355529,1,939882,941778,1896
181,21.384529,21.403529,2,943057,943895,838
182,21.407529,21.566529,1,944072,951083,7011
183,21.568529,21.597529,1,951172,952451,1279
184,21.675529,21.711529,2,955890,957478,1588
185,21.718529,21.728529,2,957787,958228,441
186,21.731529,21.784529,2,958360,960697,2337
187,21.855529,21.866529,2,963828,964313,485
188,21.868529,21.878529,2,964402,964843,441
189,21.880529,21.906529,2,964931,966077,1146
190,21.947529,21.961529,2,967886,968503,617
191,21.963529,21.989529,1,968591,969738,1147
192,21.997529,22.078529,1,970091,973663,3572
193,22.081529,22.102529,1,973795,974721,926
194,22.151529,22.182529,1,976882,978249,1367
195,22.253529,22.455529,1,981380,990288,8908
196,22.458529,22.523529,1,990421,993287,2866
197,22.639529,22.650529,2,998403,998888,485
198,22.667529,22.676529,2,999638,1000034,396
199,22.690529,22.697529,2,1000652,1000961,309
200,22.941529,22.994529,1,1011721,1014058,2337
201,23.007529,23.026529,1,1014632,1015469,837
202,23.028529,23.054529,1,1015558,1016704,1146
203,23.107529,23.150529,1,1019042,1020938,1896
204,23.176529,23.222529,1,1022084,1024113,2029
205,23.281529,23.479529,1,1026715,1035447,8732
206,23.481529,23.534529,1,1035535,1037872,2337
207,23.569529,23.612529,2,1039416,1041312,1896
208,23.646529,23.691529,2,1042811,1044796,1985
209,23.696529,23.717529,2,1045016,1045943,927
210,23.726529,23.889529,1,1046339,1053528,7189
211,23.893529,23.951529,1,1053704,1056262,2558
212,23.964529,24.005529,2,1056835,1058643,1808
213,24.012529,24.026529,2,1058952,1059569,617
214,24.035529,24.046529,2,1059966,1060451,485
215,24.140529,24.149529,2,1064597,1064994,397
216,24.158529,24.213529,2,1065391,1067816,2425
217,24.218529,24.231529,2,1068037,1068610,573
218,24.291529,24.301529,2,1071256,1071697,441
219,24.360529,24.386529,2,1074299,1075445,1146
220,24.389529,24.423529,1,1075578,1077077,1499
221,24.528529,24.617529,1,1081708,1085633,3925
222,24.620529,24.699529,1,1085765,1089249,3484
223,24.702529,24.796529,1,1089381,1093526,4145
224,25.021529,25.147529,1,1103449,1109006,5557
225,25.159529,25.182529,1,1109535,1110549,1014
226,25.185529,25.193529,2,1110681,1111034,353
227,25.239529,25.250529,2,1113063,1113548,485
228,25.255529,25.277529,1,1113768,1114739,971
229,25.281529,25.401529,1,1114915,1120207,5292
230,25.450529,25.477529,2,1122368,1123559,1191
231,25.480529,25.524529,1,1123691,1125631,1940
232,25.557529,25.582529,2,1127087,1128189,1102
233,25.591529,25.790529,1,1128586,1137362,8776
234,25.794529,25.834529,1,1137538,1139302,1764
235,25.886529,25.918529,2,1141595,1143007,1412
236,25.939529,25.968529,2,1143933,1145212,1279
237,25.978529,26.034529,2,1145653,1148122,2469
238,26.040529,26.088529,2,1148387,1150504,2117
239,26.100529,26.123529,2,1151033,1152047,1014
240,26.129529,26.164529,2,1152312,1153855,1543
241,26.167529,26.175529,2,1153988,1154340,352
242,26.184529,26.200529,2,1154737,1155443,706
243,26.202529,26.353529,1,1155531,1162190,6659
244,26.355529,26.415529,1,1162278,1164924,2646
245,26.420529,26.548529,2,1165145,1170790,5645
246,26.565529,26.573529,2,1171539,1171892,353
247,26.578529,26.629529,2,1172113,1174362,2249
248,26.738529,26.750529,2,1179169,1179698,529
249,26.754529,26.781529,1,1179874,1181065,1191
250,26.787529,26.802529,1,1181330,1181991,661
251,26.913529,26.938529,1,1186886,1187989,1103
252,26.946529,26.970529,1,1188341,1189400,1059
253,27.060529,27.221529,1,1193369,1200469,7100
254,27.224529,27.247529,2,1200601,1201616,1015
255,27.433529,27.538529,1,1209818,1214449,4631
256,27.627529,27.638529,2,1218374,1218859,485
257,27.901529,27.919529,2,1230457,1231251,794
258,27.963529,27.978529,2,1233191,1233853,662
259,27.984529,28.018529,1,1234117,1235617,1500
260,28.021529,28.081529,1,1235749,1238395,2646
261,28.084529,28.141529,1,1238527,1241041,2514
262,28.145529,28.167529,2,1241217,1242188,971
263,28.176529,28.194529,2,1242584,1243378,794
264,28.199529,28.226529,1,1243599,1244789,1190
265,28.252529,28.265529,2,1245936,1246509,573
266,28.301529,28.510529,1,1248097,1257314,9217
267,28.514529,28.548529,1,1257490,1258990,1500
268,28.584529,28.599529,2,1260577,1261239,662
269,28.615529,28.632529,2,1261944,1262694,750
270,28.660529,28.669529,2,1263929,1264326,397
271,28.671529,28.678529,2,1264414,1264723,309
272,28.688529,28.697529,2,1265164,1265561,397
273,28.702529,28.709529,2,1265781,1266090,309
274,28.718529,28.994529,1,1266487,1278658,12171
275,29.158529,29.165529,2,1285891,1286199,308
276,29.389529,29.422529,1,1296078,1297533,1455
277,29.535529,29.807529,1,1302516,1314512,11996
278,29.829529,29.953529,1,1315482,1320950,5468
279,29.976529,29.985529,2,1321964,1322361,397
280,29.993529,30.011529,2,1322714,1323508,794
281,30.043529,30.244529,1,1324919,1333783,8864
282,30.248529,30.297529,1,1333960,1336121,2161
283,30.322529,30.330529,2,1337223,1337576,353
284,30.332529,30.344529,2,1337664,1338193,529
285,30.454529,30.594529,1,1343044,1349218,6174
286,30.645529,30.661529,2,1351467,1352173,706
287,30.679529,30.699529,2,1352967,1353849,882
288,30.871529,30.888529,2,1361434,1362184,750
289,30.891529,31.158529,1,1362316,1374091,11775
290,31.160529,31.170529,2,1374179,1374620,441
291,31.188529,31.206529,2,1375414,1376207,793
292,31.211529,31.253529,1,1376428,1378280,1852
293,31.272529,31.500529,1,1379118,1389173,10055
294,31.525529,31.615529,1,1390275,1394244,3969
295,31.639529,31.667529,2,1395303,1396538,1235
296,31.675529,31.686529,2,1396890,1397375,485
297,32.036529,32.043529,2,1412810,1413119,309
298,32.048529,32.117529,1,1413340,1416383,3043
299,32.201529,32.535529,1,1420087,1434816,14729
300,32.923529,32.945529,1,1451927,1452897,970
301,33.002529,33.016529,2,1455411,1456028,617
302,33.050529,33.071529,2,1457528,1458454,926
303,33.074529,33.372529,1,1458586,1471728,13142
304,33.391529,33.398529,2,1472566,1472875,309
305,33.624529,33.635529,1,1482841,1483326,485
306,33.640529,33.839529,1,1483547,1492323,8776
307,33.922529,33.930529,2,1495983,1496336,353
308,33.972529,34.042529,1,1498188,1501275,3087
309,34.096529,34.111529,2,1503656,1504318,662
310,34.131529,34.225529,2,1505200,1509345,4145
311,34.233529,34.275529,2,1509698,1511550,1852
312,34.285529,34.311529,2,1511991,1513138,1147
313,34.317529,34.328529,2,1513403,1513888,485
314,34.347529,34.379529,2,1514726,1516137,1411
315,34.484529,34.687529,1,1520767,1529720,8953
316,34.719529,34.730529,2,1531131,1531616,485
317,34.733529,34.740529,2,1531748,1532057,309
318,34.742529,34.800529,2,1532145,1534703,2558
319,34.802529,34.819529,2,1534791,1535541,750
320,34.863529,34.903529,1,1537481,1539245,1764
321,34.923529,34.932529,2,1540127,1540524,397
322,34.946529,34.990529,1,1541141,1543082,1941
323,35.016529,35.066529,1,1544228,1546433,2205
324,35.118529,35.138529,1,1548727,1549609,882
325,35.205529,35.249529,1,1552563,1554504,1941
326,35.255529,35.306529,1,1554768,1557017,2249
327,35.358529,35.394529,1,1559311,1560898,1587
328,35.474529,35.511529,1,1564426,1566058,1632
329,35.513529,35.651529,1,1566146,1572232,6086
330,35.653529,35.671529,1,1572320,1573114,794
331,35.673529,35.702529,1,1573202,1574481,1279
332,36.097529,36.106529,2,1591901,1592297,396
333,36.109529,36.355529,1,1592430,1603278,10848
334,36.464529,36.555529,1,1608085,1612098,4013
335,36.578529,36.593529,2,1613113,1613774,661
336,36.601529,36.688529,2,1614127,1617964,3837
337,36.696529,36.901529,1,1618316,1627357,9041
338,36.905529,36.937529,1,1627533,1628945,1412
339,36.988529,37.007529,2,1631194,1632032,838
340,37.009529,37.030529,2,1632120,1633046,926
341,37.032529,37.043529,2,1633134,1633619,485
342,37.049529,37.135529,2,1633884,1637676,3792
343,37.144529,37.155529,2,1638073,1638558,485
344,37.165529,37.208529,2,1638999,1640896,1897
345,37.260529,37.316529,1,1643189,1645658,2469
346,37.319529,37.587529,1,1645791,1657610,11819
347,37.617529,37.633529,2,1658933,1659638,705
348,37.640529,37.672529,2,1659947,1661358,1411
349,37.700529,37.731529,1,1662593,1663960,1367
350,37.753529,37.769529,2,1664930,1665636,706
351,37.800529,38.037529,1,1667003,1677455,10452
352,38.057529,38.064529,2,1678337,1678645,308
353,38.183529,38.193529,2,1683893,1684334,441
354,38.203529,38.236529,1,1684775,1686230,1455
355,38.317529,38.491529,1,1689803,1697476,7673
356,38.507529,38.586529,1,1698182,1701665,3483
357,38.600529,38.612529,2,1702283,1702812,529
358,38.657529,38.693529,1,1704797,1706384,1587
359,38.718529,38.736529,2,1707487,1708280,793
360,38.756529,38.799529,1,1709162,1711059,1897
361,38.801529,39.208529,1,1711147,1729096,17949
362,39.221529,39.241529,2,1729669,1730551,882
363,39.245529,39.279529,2,1730727,1732227,1500
364,39.281529,39.297529,2,1732315,1733021,706
365,39.300529,39.325529,2,1733153,1734255,1102
366,39.327529,39.402529,2,1734344,1737651,3307
367,39.406529,39.414529,2,1737827,1738180,353
368,39.416529,39.428529,2,1738268,1738798,530
369,39.432529,39.455529,2,1738974,1739988,1014
370,39.462529,39.752529,1,1740297,1753086,12789
371,39.758529,39.775529,2,1753351,1754100,749
372,39.787529,39.828529,2,1754630,1756438,1808
373,39.844529,39.859529,2,1757143,1757805,662
374,39.873529,39.882529,2,1758422,1758819,397
375,39.886529,40.147529,1,1758995,1770506,11511
376,40.167529,40.190529,2,1771388,1772402,1014
377,40.210529,40.240529,2,1773284,1774607,1323
378,40.250529,40.271529,2,1775048,1775974,926
379,40.273529,40.304529,2,1776062,1777429,1367
380,40.362529,40.372529,2,1779987,1780428,441
381,40.427529,40.494529,1,1782854,1785808,2954
382,40.497529,40.521529,1,1785941,1786999,1058
383,40.538529,40.559529,1,1787749,1788675,926
384,40.562529,40.576529,1,1788807,1789424,617
385,40.677529,40.956529,1,1793879,1806182,12303
386,40.974529,40.981529,2,1806976,1807285,309
387,40.989529,41.040529,2,1807638,1809887,2249
388,41.045529,41.056529,2,1810107,1810592,485
389,41.060529,41.073529,2,1810769,1811342,573
390,41.080529,41.346529,1,1811651,1823381,11730
391,41.370529,41.377529,2,1824440,1824749,309
392,41.457529,41.471529,2,1828277,1828894,617
393,41.646529,41.670529,2,1836611,1837670,1059
394,41.673529,41.713529,1,1837802,1839566,1764
395,41.808529,41.831529,1,1843756,1844770,1014
396,41.833529,41.849529,1,1844858,1845564,706
397,41.868529,41.924529,1,1846402,1848871,2469
398,41.931529,41.957529,1,1849180,1850327,1147
399,41.963529,42.313529,1,1850591,1866026,15435
400,42.355529,42.373529,2,1867878,1868672,794
401,42.382529,42.393529,2,1869069,1869554,485
402,42.413529,42.573529,1,1870436,1877492,7056
403,42.575529,42.636529,1,1877580,1880270,2690
404,42.683529,42.707529,2,1882343,1883402,1059
405,42.714529,42.753529,2,1883710,1885430,1720
406,42.755529,42.768529,2,1885518,1886092,574
407,42.874529,42.895529,2,1890766,1891692,926
408,42.903529,43.045529,1,1892045,1898307,6262
409,43.078529,43.086529,2,1899763,1900115,352
410,43.097529,43.115529,2,1900601,1901394,793
411,43.124529,43.163529,2,1901791,1903511,1720
412,43.208529,43.228529,2,1905496,1906378,882
413,43.235529,43.247529,2,1906686,1907216,530
414,43.270529,43.278529,2,1908230,1908583,353
415,43.285529,43.341529,1,1908891,1911361,2470
416,43.407529,43.801529,1,1914272,1931647,17375
417,43.828529,43.864529,2,1932838,1934425,1587
418,43.901529,44.091529,1,1936057,1944436,8379
419,44.098529,44.127529,2,1944745,1946024,1279
420,44.133529,44.171529,2,1946288,1947964,1676
421,44.178529,44.231529,2,1948273,1950610,2337
422,44.233529,44.275529,2,1950698,1952550,1852
423,44.277529,44.287529,2,1952639,1953080,441
424,44.296529,44.306529,2,1953476,1953917,441
425,44.406529,44.449529,1,1958327,1960224,1897
426,44.452529,44.485529,1,1960356,1961811,1455
427,44.516529,44.575529,1,1963178,1965780,2602
428,44.579529,44.775529,1,1965957,1974600,8643
429,44.777529,44.788529,1,1974689,1975174,485
430,44.808529,44.858529,1,1976056,1978261,2205
431,44.865529,44.906529,1,1978569,1980377,1808
432,44.958529,45.199529,1,1982671,1993299,10628
433,45.227529,45.237529,2,1994534,1994975,441
434,45.245529,45.257529,2,1995327,1995857,530
435,45.262529,45.280529,2,1996077,1996871,794
436,45.370529,45.393529,2,2000840,2001854,1014
437,45.453529,45.464529,2,2004500,2004985,485
438,45.474529,45.702529,1,2005426,2015481,10055
439,45.916529,46.069529,1,2024918,2031666,6748
440,46.109529,46.126529,2,2033430,2034179,749
441,46.131529,46.145529,2,2034400,2035017,617
442,46.154529,46.162529,2,2035414,2035767,353
443,46.180529,46.196529,2,2036561,2037266,705
444,46.219529,46.239529,2,2038281,2039163,882
445,46.382529,46.703529,1,2045469,2059625,14156
446,46.710529,46.826529,1,2059934,2065049,5115
447,46.834529,46.843529,2,2065402,2065799,397
448,46.867529,46.890529,2,2066858,2067872,1014
449,46.896529,47.149529,1,2068136,2079294,11158
450,47.172529,47.182529,2,2080308,2080749,441
451,47.472529,47.495529,1,2093538,2094552,1014
452,47.505529,47.519529,2,2094993,2095611,618
453,47.588529,47.944529,1,2098654,2114353,15699
454,47.957529,47.965529,2,2114927,2115279,352
455,48.007529,48.278529,1,2117132,2129083,11951
456,48.610529,48.699529,1,2143724,2147649,3925
457,48.786529,49.045529,1,2151485,2162907,11422
458,49.182529,49.191529,2,2168949,2169346,397
459,49.463529,49.471529,2,2181341,2181694,353
460,49.487529,49.617529,1,2182400,2188133,5733
461,49.621529,49.757529,1,2188309,2194307,5998
462,49.761529,49.769529,2,2194483,2194836,353
463,49.787529,49.838529,1,2195630,2197879,2249
464,49.844529,49.895529,1,2198143,2200392,2249
465,49.913529,49.947529,2,2201186,2202686,1500
466,49.952529,50.009529,2,2202906,2205420,2514
467,50.011529,50.243529,1,2205508,2215739,10231
468,50.271529,50.301529,2,2216974,2218297,1323
469,50.304529,50.336529,2,2218429,2219840,1411
470,50.348529,50.403529,1,2220370,2222795,2425
471,50.557529,50.738529,1,2229587,2237569,7982
472,50.781529,50.815529,1,2239465,2240964,1499
473,50.836529,50.892529,2,2241890,2244360,2470
474,50.895529,51.116529,1,2244492,2254238,9746
475,51.126529,51.186529,1,2254679,2257325,2646
476,51.372529,51.443529,1,2265528,2268659,3131
477,51.540529,51.846529,1,2272937,2286431,13494
478,51.879529,51.887529,2,2287887,2288240,353
479,51.902529,51.915529,2,2288901,2289474,573
480,51.964529,51.978529,2,2291635,2292253,618
481,51.984529,52.003529,2,2292517,2293355,838
482,52.005529,52.019529,2,2293443,2294061,618
483,52.022529,52.070529,2,2294193,2296310,2117
484,52.073529,52.101529,2,2296442,2297677,1235
485,52.107529,52.275529,1,2297942,2305350,7408
486,52.279529,52.325529,1,2305527,2307555,2028
487,52.335529,52.350529,2,2307996,2308658,662
488,52.356529,52.416529,2,2308922,2311568,2646
489,52.433529,52.509529,1,2312318,2315670,3352
490,52.536529,52.589529,2,2316860,2319198,2338
491,52.617529,52.909529,1,2320433,2333310,12877
492,53.041529,53.050529,2,2339131,2339528,397
493,53.099529,53.134529,2,2341689,2343232,1543
494,53.141529,53.157529,2,2343541,2344247,706
495,53.185529,53.216529,1,2345481,2346848,1367
496,53.225529,53.440529,1,2347245,2356727,9482
497,53.491529,53.512529,2,2358976,2359902,926
498,53.525529,53.860529,1,2360475,2375249,14774
499,53.978529,53.988529,2,2380453,2380894,441
500,54.095529,54.104529,2,2385612,2386009,397
501,54.189529,54.238529,1,2389758,2391919,2161
502,54.289529,54.334529,1,2394168,2396152,1984
503,54.346529,54.431529,1,2396681,2400430,3749
504,54.435529,54.518529,1,2400606,2404267,3661
505,54.521529,54.740529,1,2404399,2414057,9658
506,54.766529,54.803529,2,2415203,2416835,1632
507,54.812529,54.829529,2,2417232,2417982,750
508,54.850529,55.093529,1,2418908,2429624,10716
509,55.099529,55.116529,2,2429889,2430638,749
510,55.121529,55.166529,2,2430859,2432843,1984
511,55.192529,55.221529,2,2433990,2435269,1279
512,55.476529,55.518529,1,2446514,2448367,1853
513,55.533529,55.542529,1,2449028,2449425,397
514,55.619529,55.670529,1,2452821,2455070,2249
515,55.693529,55.864529,1,2456084,2463625,7541
516,55.867529,55.984529,1,2463758,2468917,5159
517,56.004529,56.021529,2,2469799,2470549,750
518,56.031529,56.250529,1,2470990,2480648,9658
519,56.254529,56.261529,2,2480824,2481133,309
520,56.278529,56.318529,2,2481883,2483647,1764
521,56.321529,56.328529,2,2483779,2484088,309
522,56.334529,56.437529,2,2484352,2488895,4543
523,56.449529,56.464529,2,2489424,2490085,661
524,56.563529,56.608529,1,2494451,2496436,1985
525,56.619529,56.652529,1,2496921,2498376,1455
526,56.688529,56.733529,1,2499964,2501948,1984
527,56.738529,56.794529,1,2502169,2504638,2469
528,56.813529,56.932529,1,2505476,2510724,5248
529,56.936529,56.943529,2,2510900,2511209,309
530,56.945529,56.957529,2,2511297,2511827,530
531,56.968529,56.990529,2,2512312,2513282,970
532,56.995529,57.247529,1,2513502,2524616,11114
533,57.258529,57.269529,2,2525101,2525586,485
534,57.273529,57.376529,2,2525762,2530304,4542
535,57.394529,57.428529,2,2531098,2532598,1500
536,57.567529,57.635529,1,2538728,2541726,2998
537,58.009529,58.022529,2,2558220,2558793,573
538,58.025529,58.079529,1,2558925,2561307,2382
539,58.171529,58.645529,1,2565364,2586267,20903
540,58.649529,58.658529,2,2586444,2586841,397
541,58.673529,58.682529,2,2587502,2587899,397
542,58.684529,58.709529,2,2587987,2589090,1103
543,58.712529,58.723529,2,2589222,2589707,485
544,58.725529,58.746529,2,2589795,2590721,926
545,58.764529,58.902529,1,2591515,2597601,6086
546,58.961529,59.219529,1,2600203,2611581,11378
547,59.233529,59.252529,2,2612198,2613036,838
548,59.292529,59.301529,2,2614800,2615197,397
549,59.352529,59.363529,2,2617446,2617931,485
550,59.367529,59.376529,2,2618108,2618504,396
551,59.408529,59.415529,2,2619916,2620224,308
552,59.428529,59.439529,2,2620798,2621283,485
553,59.568529,59.576529,2,2626972,2627324,352
554,59.649529,59.710529,1,2630544,2633234,2690
555,59.713529,59.741529,1,2633366,2634601,1235
556,59.744529,59.757529,1,2634733,2635307,574
557,59.775529,59.815529,1,2636100,2637864,1764
558,59.883529,59.935529,1,2640863,2643156,2293
559,59.939529,59.991529,1,2643333,2645626,2293
560,59.998529,60.009529,1,2645935,2646420,485
561,60.013529,60.026529,1,2646596,2647169,573
562,60.091529,60.106529,1,2650036,2650697,661
563,60.116529,60.155529,1,2651138,2652858,1720
564,60.220529,60.437529,1,2655725,2665295,9570
565,60.439529,60.466529,1,2665383,2666573,1190
566,60.518529,60.572529,2,2668867,2671248,2381
567,60.574529,60.592529,2,2671336,2672130,794
568,60.597529,60.613529,2,2672351,2673056,705
569,60.923529,61.222529,1,2686727,2699913,13186
570,61.248529,61.256529,2,2701060,2701412,352
571,61.259529,61.287529,2,2701545,2702780,1235
572,61.289529,61.303529,2,2702868,2703485,617
573,61.309529,61.327529,2,2703750,2704544,794
574,61.331529,61.524529,1,2704720,2713231,8511
575,61.528529,61.552529,1,2713408,2714466,1058
576,61.555529,61.591529,1,2714598,2716186,1588
577,61.930529,62.034529,1,2731136,2735722,4586
578,62.167529,62.257529,1,2741588,2745557,3969
579,62.270529,62.582529,1,2746130,2759889,13759
580,62.626529,62.640529,2,2761829,2762447,618
581,62.648529,62.838529,1,2762800,2771179,8379
582,62.841529,62.895529,1,2771311,2773692,2381
583,63.389529,63.428529,1,2795478,2797198,1720
584,63.472529,63.491529,1,2799138,2799976,838
585,63.496529,63.532529,1,2800196,2801784,1588
586,63.535529,63.812529,1,2801916,2814132,12216
587,63.869529,64.134529,1,2816646,2828332,11686
588,64.185529,64.203529,2,2830581,2831375,794
589,64.205529,64.212529,2,2831463,2831772,309
590,64.226529,64.235529,2,2832389,2832786,397
591,64.241529,64.273529,2,2833051,2834462,1411
592,64.283529,64.496529,1,2834903,2844296,9393
593,64.500529,64.532529,1,2844473,2845884,1411
594,64.568529,64.598529,2,2847472,2848795,1323
595,64.603529,64.619529,2,2849015,2849721,706
596,64.627529,64.654529,2,2850074,2851264,1190
597,64.668529,64.730529,2,2851882,2854616,2734
598,64.742529,64.753529,2,2855145,2855630,485
599,64.878529,64.908529,1,2861143,2862466,1323
600,64.917529,64.935529,1,2862863,2863656,793
601,64.949529,64.965529,1,2864274,2864979,705
602,64.983529,65.018529,1,2865773,2867317,1544
603,65.075529,65.288529,1,2869830,2879224,9394
604,65.379529,65.582529,1,2883237,2892189,8952
605,65.584529,65.607529,1,2892277,2893292,1015
606,65.645529,65.652529,2,2894967,2895276,309
607,65.672529,65.680529,2,2896158,2896511,353
608,66.326529,66.404529,1,2924999,2928439,3440
609,66.464529,66.484529,2,2931085,2931967,882
610,66.493529,66.502529,2,2932364,2932761,397
611,66.507529,66.556529,2,2932982,2935142,2160
612,66.560529,66.614529,2,2935319,2937700,2381
613,66.623529,66.635529,2,2938097,2938626,529
614,66.681529,66.733529,1,2940655,2942948,2293
615,66.827529,67.262529,1,2947094,2966277,19183
616,67.669529,67.678529,2,2984226,2984623,397
617,67.683529,67.700529,2,2984843,2985593,750
618,67.710529,67.941529,1,2986034,2996221,10187
619,67.946529,67.960529,2,2996441,2997059,618
620,67.976529,68.046529,1,2997764,3000851,3087
621,68.051529,68.058529,2,3001072,3001381,309
622,68.078529,68.124529,2,3002263,3004291,2028
623,68.131529,68.148529,2,3004600,3005350,750
624,68.151529,68.175529,2,3005482,3006540,1058
625,68.177529,68.227529,2,3006629,3008834,2205
626,68.250529,68.263529,2,3009848,3010421,573
627,68.265529,68.274529,2,3010509,3010906,397
628,68.290529,68.451529,1,3011612,3018712,7100
629,68.454529,68.475529,1,3018844,3019770,926
630,68.478529,68.531529,1,3019903,3022240,2337
631,68.548529,68.555529,2,3022990,3023298,308
632,68.563529,68.573529,2,3023651,3024092,441
633,68.622529,68.668529,2,3026253,3028282,2029
634,68.690529,68.709529,2,3029252,3030090,838
635,68.726529,68.733529,2,3030839,3031148,309
636,68.753529,68.773529,2,3032030,3032912,882
637,68.778529,68.794529,2,3033133,3033838,705
638,68.831529,68.838529,2,3035470,3035779,309
639,68.938529,69.058529,1,3040189,3045481,5292
640,69.138529,69.310529,1,3049009,3056594,7585
641,69.357529,69.365529,2,3058667,3059019,352
642,69.373529,69.496529,1,3059372,3064796,5424
643,69.562529,69.761529,1,3067707,3076483,8776
644,69.766529,69.791529,1,3076703,3077806,1103
645,69.864529,69.875529,2,3081025,3081510,485
646,69.914529,69.926529,2,3083230,3083759,529
647,70.282529,70.350529,1,3099459,3102458,2999
648,70.443529,70.822529,1,3106559,3123273,16714
649,71.211529,71.265529,1,3140428,3142809,2381
650,71.285529,71.303529,1,3143691,3144485,794
651,71.313529,71.335529,1,3144926,3145896,970
652,71.388529,71.435529,1,3148234,3150306,2072
653,71.448529,71.495529,1,3150880,3152952,2072
654,71.544529,71.576529,1,3155113,3156524,1411
655,71.653529,71.822529,1,3159920,3167373,7453
656,71.826529,71.869529,1,3167549,3169446,1897
657,71.991529,72.031529,2,3174826,3176590,1764
658,72.051529,72.076529,2,3177472,3178574,1102
659,72.086529,72.093529,2,3179015,3179324,309
660,72.096529,72.104529,2,3179456,3179809,353
661,72.140529,72.147529,2,3181397,3181706,309
662,72.264529,72.271529,2,3186865,3187174,309
663,72.317529,72.329529,2,3189203,3189732,529
664,72.333529,72.434529,1,3189908,3194362,4454
665,72.438529,72.445529,2,3194539,3194847,308
666,72.522529,72.638529,1,3198243,3203359,5116
667,72.643529,72.671529,1,3203579,3204814,1235
668,72.906529,72.984529,1,3215177,3218617,3440
669,72.992529,73.031529,1,3218970,3220690,1720
670,73.119529,73.286529,1,3224571,3231935,7364
671,73.313529,73.383529,1,3233126,3236213,3087
672,73.450529,73.608529,1,3239168,3246136,6968
673,73.611529,73.640529,1,3246268,3247547,1279
674,73.683529,73.757529,2,3249443,3252707,3264
675,73.760529,73.845529,2,3252839,3256587,3748
676,73.853529,73.866529,2,3256940,3257513,573
677,73.868529,73.902529,2,3257602,3259101,1499
678,73.906529,74.014529,2,3259277,3264040,4763
679,74.033529,74.166529,1,3264878,3270743,5865
680,74.168529,74.259529,2,3270832,3274845,4013
681,74.261529,74.371529,2,3274933,3279784,4851
682,74.376529,74.415529,2,3280004,3281724,1720
683,74.440529,74.521529,1,3282827,3286399,3572
684,74.525529,74.633529,1,3286575,3291338,4763
685,74.693529,74.706529,2,3293984,3294557,573
686,74.711529,74.853529,1,3294778,3301040,6262
687,74.959529,74.970529,2,3305715,3306200,485
688,75.006529,75.253529,1,3307787,3318680,10893
689,75.368529,75.574529,1,3323752,3332836,9084
690,75.576529,75.606529,1,3332924,3334247,1323
691,75.943529,75.955529,2,3349109,3349638,529
692,75.957529,75.966529,2,3349727,3350123,396
693,75.972529,75.980529,2,3350388,3350741,353
694,75.994529,76.020529,2,3351358,3352505,1147
695,76.096529,76.163529,1,3355856,3358811,2955
696,76.167529,76.230529,1,3358988,3361766,2778
697,76.238529,76.255529,1,3362119,3362868,749
698,76.338529,76.423529,1,3366529,3370277,3748
699,76.427529,76.472529,1,3370454,3372438,1984
700,76.564529,76.724529,1,3376495,3383551,7056
701,78.478709,78.560709,1,3460911,3464527,3616
702,78.660709,78.756709,1,3468937,3473170,4233
703,78.758709,79.044709,1,3473259,3485871,12612
704,79.333709,79.454709,1,3498616,3503952,5336
705,79.672709,79.879709,2,3513566,3522695,9129
706,79.888709,79.975709,2,3523092,3526928,3836
707,79.985709,80.006709,2,3527369,3528295,926
708,80.008709,80.017709,2,3528384,3528780,396
709,80.025709,80.041709,2,3529133,3529839,706
710,80.061709,80.081709,2,3530721,3531603,882
711,80.087709,80.157709,2,3531867,3534954,3087
712,80.261709,80.268709,2,3539541,3539850,309
713,80.306709,80.343709,2,3541525,3543157,1632
714,80.555709,80.730709,1,3552506,3560224,7718
715,80.789709,80.801709,2,3562826,3563355,529
716,80.841709,80.873709,2,3565119,3566530,1411
717,80.880709,80.913709,2,3566839,3568294,1455
718,80.917709,80.928709,2,3568470,3568956,486
719,80.930709,80.979709,2,3569044,3571205,2161
720,80.995709,81.028709,2,3571910,3573366,1456
721,81.041709,81.092709,1,3573939,3576188,2249
722,81.095709,81.115709,2,3576320,3577202,882
723,81.129709,81.213709,1,3577820,3581524,3704
724,81.280709,81.293709,2,3584479,3585052,573
725,81.321709,81.353709,2,3586287,3587698,1411
726,81.398709,81.413709,2,3589683,3590344,661
727,81.428709,81.438709,2,3591006,3591447,441
728,81.485709,81.506709,2,3593519,3594445,926
729,81.546709,81.576709,2,3596209,3597532,1323
730,81.595709,81.614709,2,3598370,3599208,838
731,81.630709,81.642709,2,3599914,3600443,529
732,81.683709,81.947709,1,3602251,3613893,11642
733,82.082709,82.228709,1,3619847,3626286,6439
