onset,offset,label,type,onset_sample,offset_sample,length,path,bird,fold
9059.334241,9059.342241,1,voc,271780027,271780267,240,spec2/voc/Bl122_271780027.jpg,Bl122,0
7856.137748,7856.144748,1,voc,235684132,235684342,210,spec2/voc/Bl122_235684132.jpg,Bl122,0
6014.616533,6014.622533,1,voc,180438495,180438675,180,spec2/voc/Bl122_180438495.jpg,Bl122,0
9016.090241,9016.093241,1,voc,270482707,270482797,90,spec2/voc/Bl122_270482707.jpg,Bl122,0
9017.774241,9017.868241,1,voc,270533227,270536047,2820,spec2/voc/Bl122_270533227.jpg,Bl122,0
3820.049649,3820.126649,1,voc,114601489,114603799,2310,spec2/voc/Bl122_114601489.jpg,Bl122,0
13586.510236,13586.635236,1,voc,407595307,407599057,3750,spec2/voc/Bl122_407595307.jpg,Bl122,0
14162.865897,14162.896897,1,voc,424885976,424886906,930,spec2/voc/Bl122_424885976.jpg,Bl122,0
3882.250062,3882.256062,1,voc,116467501,116467681,180,spec2/voc/Bl122_116467501.jpg,Bl122,0
6067.915705,6067.919705,1,voc,182037471,182037591,120,spec2/voc/Bl122_182037471.jpg,Bl122,0
6143.391349,6143.412349,1,voc,184301740,184302370,630,spec2/voc/Bl122_184301740.jpg,Bl122,0
6228.329295,6228.338295,1,voc,186849878,186850148,270,spec2/voc/Bl122_186849878.jpg,Bl122,0
7986.933748,7987.020748,1,voc,239608012,239610622,2610,spec2/voc/Bl122_239608012.jpg,Bl122,0
6225.697295,6225.856295,1,voc,186770918,186775688,4770,spec2/voc/Bl122_186770918.jpg,Bl122,0
13744.550896,13744.558896,1,voc,412336526,412336766,240,spec2/voc/Bl122_412336526.jpg,Bl122,0
3847.853415,3847.896415,1,voc,115435602,115436892,1290,spec2/voc/Bl122_115435602.jpg,Bl122,0
5957.637256,5957.664256,1,voc,178729117,178729927,810,spec2/voc/Bl122_178729117.jpg,Bl122,0
8948.514967,8948.545967,1,voc,268455449,268456379,930,spec2/voc/Bl122_268455449.jpg,Bl122,0
3048.911397,3048.915397,1,voc,91467341,91467461,120,spec2/voc/Bl122_91467341.jpg,Bl122,0
5969.696256,5969.703256,1,voc,179090887,179091097,210,spec2/voc/Bl122_179090887.jpg,Bl122,0
13950.106911,13950.113911,1,voc,418503207,418503417,210,spec2/voc/Bl122_418503207.jpg,Bl122,0
6124.934706,6124.944706,1,voc,183748041,183748341,300,spec2/voc/Bl122_183748041.jpg,Bl122,0
3827.024649,3827.040649,1,voc,114810739,114811219,480,spec2/voc/Bl122_114810739.jpg,Bl122,0
14795.144551,14795.150551,1,voc,443854336,443854516,180,spec2/voc/Bl122_443854336.jpg,Bl122,0
5964.619256,5964.622256,1,voc,178938577,178938667,90,spec2/voc/Bl122_178938577.jpg,Bl122,0
9064.134241,9064.142241,1,voc,271924027,271924267,240,spec2/voc/Bl122_271924027.jpg,Bl122,0
7794.528748,7794.532748,1,voc,233835862,233835982,120,spec2/voc/Bl122_233835862.jpg,Bl122,0
7908.332748,7908.371748,1,voc,237249982,237251152,1170,spec2/voc/Bl122_237249982.jpg,Bl122,0
8015.348748,8015.354748,1,voc,240460462,240460642,180,spec2/voc/Bl122_240460462.jpg,Bl122,0
5947.788256,5948.020256,1,voc,178433647,178440607,6960,spec2/voc/Bl122_178433647.jpg,Bl122,0
5925.587581,5925.742581,1,voc,177767627,177772277,4650,spec2/voc/Bl122_177767627.jpg,Bl122,0
13933.113118,13933.247118,1,voc,417993393,417997413,4020,spec2/voc/Bl122_417993393.jpg,Bl122,0
10939.118807,10939.170807,1,voc,328173564,328175124,1560,spec2/voc/Bl122_328173564.jpg,Bl122,0
9081.091241,9081.105241,1,voc,272432737,272433157,420,spec2/voc/Bl122_272432737.jpg,Bl122,0
13163.535891,13163.539891,1,voc,394906076,394906196,120,spec2/voc/Bl122_394906076.jpg,Bl122,0
6114.887706,6114.913706,1,voc,183446631,183447411,780,spec2/voc/Bl122_183446631.jpg,Bl122,0
10913.718807,10913.724807,1,voc,327411564,327411744,180,spec2/voc/Bl122_327411564.jpg,Bl122,0
7945.494748,7945.508748,1,voc,238364842,238365262,420,spec2/voc/Bl122_238364842.jpg,Bl122,0
6111.124706,6111.134706,1,voc,183333741,183334041,300,spec2/voc/Bl122_183333741.jpg,Bl122,0
13824.63722,13824.66722,1,voc,414739116,414740016,900,spec2/voc/Bl122_414739116.jpg,Bl122,0
9137.479255,9137.486255,1,voc,274124377,274124587,210,spec2/voc/Bl122_274124377.jpg,Bl122,0
10887.296136,10887.428136,1,voc,326618884,326622844,3960,spec2/voc/Bl122_326618884.jpg,Bl122,0
11099.799855,11099.805855,1,voc,332993995,332994175,180,spec2/voc/Bl122_332993995.jpg,Bl122,0
6003.747256,6003.750256,1,voc,180112417,180112507,90,spec2/voc/Bl122_180112417.jpg,Bl122,0
14784.222465,14784.233465,1,voc,443526673,443527003,330,spec2/voc/Bl122_443526673.jpg,Bl122,0
7976.089748,7976.112748,1,voc,239282692,239283382,690,spec2/voc/Bl122_239282692.jpg,Bl122,0
6123.805706,6123.828706,1,voc,183714171,183714861,690,spec2/voc/Bl122_183714171.jpg,Bl122,0
8038.293748,8038.300748,1,voc,241148812,241149022,210,spec2/voc/Bl122_241148812.jpg,Bl122,0
8982.775025,8983.002025,1,voc,269483250,269490060,6810,spec2/voc/Bl122_269483250.jpg,Bl122,0
10947.125807,10947.135807,1,voc,328413774,328414074,300,spec2/voc/Bl122_328413774.jpg,Bl122,0
6222.128295,6222.132295,1,voc,186663848,186663968,120,spec2/voc/Bl122_186663848.jpg,Bl122,0
6227.310295,6227.423295,1,voc,186819308,186822698,3390,spec2/voc/Bl122_186819308.jpg,Bl122,0
9142.404757,9142.515757,1,voc,274272142,274275472,3330,spec2/voc/Bl122_274272142.jpg,Bl122,0
3881.381062,3881.460062,1,voc,116441431,116443801,2370,spec2/voc/Bl122_116441431.jpg,Bl122,0
13161.640891,13161.702891,1,voc,394849226,394851086,1860,spec2/voc/Bl122_394849226.jpg,Bl122,0
3852.372415,3852.383415,1,voc,115571172,115571502,330,spec2/voc/Bl122_115571172.jpg,Bl122,0
5952.661256,5952.712256,1,voc,178579837,178581367,1530,spec2/voc/Bl122_178579837.jpg,Bl122,0
13170.242701,13170.244701,1,voc,395107281,395107341,60,spec2/voc/Bl122_395107281.jpg,Bl122,0
6097.68815,6097.71415,1,voc,182930644,182931424,780,spec2/voc/Bl122_182930644.jpg,Bl122,0
13215.421389,13215.734389,1,voc,396462641,396472031,9390,spec2/voc/Bl122_396462641.jpg,Bl122,0
13516.09047,13516.13547,1,voc,405482714,405484064,1350,spec2/voc/Bl122_405482714.jpg,Bl122,0
11933.86957,11933.87357,1,voc,358016087,358016207,120,spec2/voc/Bl122_358016087.jpg,Bl122,0
6059.858705,6059.868705,1,voc,181795761,181796061,300,spec2/voc/Bl122_181795761.jpg,Bl122,0
6145.620349,6145.703349,1,voc,184368610,184371100,2490,spec2/voc/Bl122_184368610.jpg,Bl122,0
10903.292825,10903.294825,1,voc,327098784,327098844,60,spec2/voc/Bl122_327098784.jpg,Bl122,0
8945.909967,8945.912967,1,voc,268377299,268377389,90,spec2/voc/Bl122_268377299.jpg,Bl122,0
6146.583349,6146.759349,1,voc,184397500,184402780,5280,spec2/voc/Bl122_184397500.jpg,Bl122,0
10944.976807,10945.052807,1,voc,328349304,328351584,2280,spec2/voc/Bl122_328349304.jpg,Bl122,0
7916.204748,7916.214748,1,voc,237486142,237486442,300,spec2/voc/Bl122_237486142.jpg,Bl122,0
5959.829256,5960.014256,1,voc,178794877,178800427,5550,spec2/voc/Bl122_178794877.jpg,Bl122,0
6157.612349,6157.631349,1,voc,184728370,184728940,570,spec2/voc/Bl122_184728370.jpg,Bl122,0
6065.365705,6065.422705,1,voc,181960971,181962681,1710,spec2/voc/Bl122_181960971.jpg,Bl122,0
5974.661256,5974.664256,1,voc,179239837,179239927,90,spec2/voc/Bl122_179239837.jpg,Bl122,0
5988.283256,5988.286256,1,voc,179648497,179648587,90,spec2/voc/Bl122_179648497.jpg,Bl122,0
13163.777891,13163.791891,1,voc,394913336,394913756,420,spec2/voc/Bl122_394913336.jpg,Bl122,0
3845.790415,3845.978415,1,voc,115373712,115379352,5640,spec2/voc/Bl122_115373712.jpg,Bl122,0
13171.247701,13171.571701,1,voc,395137431,395147151,9720,spec2/voc/Bl122_395137431.jpg,Bl122,0
13968.057352,13968.091352,1,voc,419041720,419042740,1020,spec2/voc/Bl122_419041720.jpg,Bl122,0
3824.142649,3824.161649,1,voc,114724279,114724849,570,spec2/voc/Bl122_114724279.jpg,Bl122,0
11160.82918,11160.87718,1,voc,334824875,334826315,1440,spec2/voc/Bl122_334824875.jpg,Bl122,0
6131.428293,6131.474293,1,voc,183942848,183944228,1380,spec2/voc/Bl122_183942848.jpg,Bl122,0
11968.158795,11968.396795,1,voc,359044763,359051903,7140,spec2/voc/Bl122_359044763.jpg,Bl122,0
9062.185241,9062.337241,1,voc,271865557,271870117,4560,spec2/voc/Bl122_271865557.jpg,Bl122,0
14335.036707,14335.094707,1,voc,430051101,430052841,1740,spec2/voc/Bl122_430051101.jpg,Bl122,0
9010.752241,9010.757241,1,voc,270322567,270322717,150,spec2/voc/Bl122_270322567.jpg,Bl122,0
8924.134773,8924.228773,1,voc,267724043,267726863,2820,spec2/voc/Bl122_267724043.jpg,Bl122,0
9050.249241,9050.263241,1,voc,271507477,271507897,420,spec2/voc/Bl122_271507477.jpg,Bl122,0
9124.468182,9124.472182,1,voc,273734045,273734165,120,spec2/voc/Bl122_273734045.jpg,Bl122,0
7942.675748,7942.689748,1,voc,238280272,238280692,420,spec2/voc/Bl122_238280272.jpg,Bl122,0
9101.387241,9101.395241,1,voc,273041617,273041857,240,spec2/voc/Bl122_273041617.jpg,Bl122,0
13731.929497,13732.042497,1,voc,411957884,411961274,3390,spec2/voc/Bl122_411957884.jpg,Bl122,0
9078.354241,9078.551241,1,voc,272350627,272356537,5910,spec2/voc/Bl122_272350627.jpg,Bl122,0
11177.38818,11177.41718,1,voc,335321645,335322515,870,spec2/voc/Bl122_335321645.jpg,Bl122,0
5967.928256,5967.991256,1,voc,179037847,179039737,1890,spec2/voc/Bl122_179037847.jpg,Bl122,0
5938.740256,5938.742256,1,voc,178162207,178162267,60,spec2/voc/Bl122_178162207.jpg,Bl122,0
6125.178706,6125.193706,1,voc,183755361,183755811,450,spec2/voc/Bl122_183755361.jpg,Bl122,0
3176.612448,3176.615448,1,voc,95298373,95298463,90,spec2/voc/Bl122_95298373.jpg,Bl122,0
6097.47915,6097.50515,1,voc,182924374,182925154,780,spec2/voc/Bl122_182924374.jpg,Bl122,0
6144.768349,6144.809349,1,voc,184343050,184344280,1230,spec2/voc/Bl122_184343050.jpg,Bl122,0
6195.679327,6195.683327,1,voc,185870379,185870499,120,spec2/voc/Bl122_185870379.jpg,Bl122,0
14703.510546,14703.517546,1,voc,441105316,441105526,210,spec2/voc/Bl122_441105316.jpg,Bl122,0
8018.905748,8018.908748,1,voc,240567172,240567262,90,spec2/voc/Bl122_240567172.jpg,Bl122,0
9123.500182,9123.519182,1,voc,273705005,273705575,570,spec2/voc/Bl122_273705005.jpg,Bl122,0
11985.306611,11985.504611,1,voc,359559198,359565138,5940,spec2/voc/Bl122_359559198.jpg,Bl122,0
13588.924236,13589.043236,1,voc,407667727,407671297,3570,spec2/voc/Bl122_407667727.jpg,Bl122,0
5988.235256,5988.270256,1,voc,179647057,179648107,1050,spec2/voc/Bl122_179647057.jpg,Bl122,0
6036.417533,6036.425533,1,voc,181092525,181092765,240,spec2/voc/Bl122_181092525.jpg,Bl122,0
3842.956415,3843.030415,1,voc,115288692,115290912,2220,spec2/voc/Bl122_115288692.jpg,Bl122,0
7949.335748,7949.346748,1,voc,238480072,238480402,330,spec2/voc/Bl122_238480072.jpg,Bl122,0
3837.827415,3837.919415,1,voc,115134822,115137582,2760,spec2/voc/Bl122_115134822.jpg,Bl122,0
14174.545098,14174.564098,1,voc,425236352,425236922,570,spec2/voc/Bl122_425236352.jpg,Bl122,0
8926.809773,8926.833773,1,voc,267804293,267805013,720,spec2/voc/Bl122_267804293.jpg,Bl122,0
9158.151796,9158.161796,1,voc,274744553,274744853,300,spec2/voc/Bl122_274744553.jpg,Bl122,0
6004.535256,6004.578256,1,voc,180136057,180137347,1290,spec2/voc/Bl122_180136057.jpg,Bl122,0
13988.889864,13988.896864,1,voc,419666695,419666905,210,spec2/voc/Bl122_419666695.jpg,Bl122,0
14808.883551,14808.894551,1,voc,444266506,444266836,330,spec2/voc/Bl122_444266506.jpg,Bl122,0
11148.80218,11148.80518,1,voc,334464065,334464155,90,spec2/voc/Bl122_334464065.jpg,Bl122,0
10936.402807,10936.404807,1,voc,328092084,328092144,60,spec2/voc/Bl122_328092084.jpg,Bl122,0
6132.772293,6132.774293,1,voc,183983168,183983228,60,spec2/voc/Bl122_183983168.jpg,Bl122,0
10942.714807,10942.736807,1,voc,328281444,328282104,660,spec2/voc/Bl122_328281444.jpg,Bl122,0
6174.910327,6174.943327,1,voc,185247309,185248299,990,spec2/voc/Bl122_185247309.jpg,Bl122,0
7973.258748,7973.261748,1,voc,239197762,239197852,90,spec2/voc/Bl122_239197762.jpg,Bl122,0
13190.002662,13190.358662,1,voc,395700079,395710759,10680,spec2/voc/Bl122_395700079.jpg,Bl122,0
6028.570533,6028.585533,1,voc,180857115,180857565,450,spec2/voc/Bl122_180857115.jpg,Bl122,0
5949.081256,5949.084256,1,voc,178472437,178472527,90,spec2/voc/Bl122_178472437.jpg,Bl122,0
11915.285799,11915.345799,1,voc,357458573,357460373,1800,spec2/voc/Bl122_357458573.jpg,Bl122,0
12673.535513,12673.588513,1,voc,380206065,380207655,1590,spec2/voc/Bl122_380206065.jpg,Bl122,0
6032.951533,6033.029533,1,voc,180988545,180990885,2340,spec2/voc/Bl122_180988545.jpg,Bl122,0
11143.229955,11143.273955,1,voc,334296898,334298218,1320,spec2/voc/Bl122_334296898.jpg,Bl122,0
10912.931807,10912.996807,1,voc,327387954,327389904,1950,spec2/voc/Bl122_327387954.jpg,Bl122,0
5967.721256,5967.883256,1,voc,179031637,179036497,4860,spec2/voc/Bl122_179031637.jpg,Bl122,0
9028.933241,9028.966241,1,voc,270867997,270868987,990,spec2/voc/Bl122_270867997.jpg,Bl122,0
13583.079236,13583.119236,1,voc,407492377,407493577,1200,spec2/voc/Bl122_407492377.jpg,Bl122,0
9095.618241,9095.621241,1,voc,272868547,272868637,90,spec2/voc/Bl122_272868547.jpg,Bl122,0
6009.725533,6009.846533,1,voc,180291765,180295395,3630,spec2/voc/Bl122_180291765.jpg,Bl122,0
8033.238748,8033.248748,1,voc,240997162,240997462,300,spec2/voc/Bl122_240997162.jpg,Bl122,0
8921.951773,8921.975773,1,voc,267658553,267659273,720,spec2/voc/Bl122_267658553.jpg,Bl122,0
3809.707649,3809.746649,1,voc,114291229,114292399,1170,spec2/voc/Bl122_114291229.jpg,Bl122,0
5960.524256,5960.534256,1,voc,178815727,178816027,300,spec2/voc/Bl122_178815727.jpg,Bl122,0
11209.400894,11209.424894,1,voc,336282026,336282746,720,spec2/voc/Bl122_336282026.jpg,Bl122,0
12608.036866,12608.069866,1,voc,378241105,378242095,990,spec2/voc/Bl122_378241105.jpg,Bl122,0
13225.047389,13225.282389,1,voc,396751421,396758471,7050,spec2/voc/Bl122_396751421.jpg,Bl122,0
11196.49318,11196.49518,1,voc,335894795,335894855,60,spec2/voc/Bl122_335894795.jpg,Bl122,0
11186.52918,11186.54418,1,voc,335595875,335596325,450,spec2/voc/Bl122_335595875.jpg,Bl122,0
9060.972241,9060.983241,1,voc,271829167,271829497,330,spec2/voc/Bl122_271829167.jpg,Bl122,0
6104.187706,6104.224706,1,voc,183125631,183126741,1110,spec2/voc/Bl122_183125631.jpg,Bl122,0
6106.077706,6106.107706,1,voc,183182331,183183231,900,spec2/voc/Bl122_183182331.jpg,Bl122,0
7977.965748,7977.968748,1,voc,239338972,239339062,90,spec2/voc/Bl122_239338972.jpg,Bl122,0
13808.308653,13808.312653,1,voc,414249259,414249379,120,spec2/voc/Bl122_414249259.jpg,Bl122,0
13725.68841,13725.69841,1,voc,411770652,411770952,300,spec2/voc/Bl122_411770652.jpg,Bl122,0
9070.337241,9070.341241,1,voc,272110117,272110237,120,spec2/voc/Bl122_272110117.jpg,Bl122,0
14825.065551,14825.077551,1,voc,444751966,444752326,360,spec2/voc/Bl122_444751966.jpg,Bl122,0
5952.127256,5952.230256,1,voc,178563817,178566907,3090,spec2/voc/Bl122_178563817.jpg,Bl122,0
11194.69618,11194.70118,1,voc,335840885,335841035,150,spec2/voc/Bl122_335840885.jpg,Bl122,0
11175.40418,11175.45318,1,voc,335262125,335263595,1470,spec2/voc/Bl122_335262125.jpg,Bl122,0
6013.346533,6013.356533,1,voc,180400395,180400695,300,spec2/voc/Bl122_180400395.jpg,Bl122,0
5934.451256,5934.479256,1,voc,178033537,178034377,840,spec2/voc/Bl122_178033537.jpg,Bl122,0
11148.07618,11148.07818,1,voc,334442285,334442345,60,spec2/voc/Bl122_334442285.jpg,Bl122,0
11175.24118,11175.24418,1,voc,335257235,335257325,90,spec2/voc/Bl122_335257235.jpg,Bl122,0
8916.245773,8916.289773,1,voc,267487373,267488693,1320,spec2/voc/Bl122_267487373.jpg,Bl122,0
8992.914241,8992.917241,1,voc,269787427,269787517,90,spec2/voc/Bl122_269787427.jpg,Bl122,0
8919.304773,8919.500773,1,voc,267579143,267585023,5880,spec2/voc/Bl122_267579143.jpg,Bl122,0
7922.457748,7922.492748,1,voc,237673732,237674782,1050,spec2/voc/Bl122_237673732.jpg,Bl122,0
10962.914807,10963.017807,1,voc,328887444,328890534,3090,spec2/voc/Bl122_328887444.jpg,Bl122,0
3883.141062,3883.164062,1,voc,116494231,116494921,690,spec2/voc/Bl122_116494231.jpg,Bl122,0
3822.781649,3822.859649,1,voc,114683449,114685789,2340,spec2/voc/Bl122_114683449.jpg,Bl122,0
5947.301256,5947.315256,1,voc,178419037,178419457,420,spec2/voc/Bl122_178419037.jpg,Bl122,0
3894.011652,3894.029652,1,voc,116820349,116820889,540,spec2/voc/Bl122_116820349.jpg,Bl122,0
8013.601748,8013.603748,1,voc,240408052,240408112,60,spec2/voc/Bl122_240408052.jpg,Bl122,0
7911.284748,7911.289748,1,voc,237338542,237338692,150,spec2/voc/Bl122_237338542.jpg,Bl122,0
14842.128682,14842.154682,1,voc,445263860,445264640,780,spec2/voc/Bl122_445263860.jpg,Bl122,0
10920.813807,10921.022807,1,voc,327624414,327630684,6270,spec2/voc/Bl122_327624414.jpg,Bl122,0
6086.77315,6086.77815,1,voc,182603194,182603344,150,spec2/voc/Bl122_182603194.jpg,Bl122,0
5953.486256,5953.495256,1,voc,178604587,178604857,270,spec2/voc/Bl122_178604587.jpg,Bl122,0
14824.377551,14824.422551,1,voc,444731326,444732676,1350,spec2/voc/Bl122_444731326.jpg,Bl122,0
3875.239848,3875.245848,1,voc,116257195,116257375,180,spec2/voc/Bl122_116257195.jpg,Bl122,0
8957.132967,8957.207967,1,voc,268713989,268716239,2250,spec2/voc/Bl122_268713989.jpg,Bl122,0
11194.09318,11194.09918,1,voc,335822795,335822975,180,spec2/voc/Bl122_335822795.jpg,Bl122,0
9064.772241,9064.861241,1,voc,271943167,271945837,2670,spec2/voc/Bl122_271943167.jpg,Bl122,0
6157.003349,6157.049349,1,voc,184710100,184711480,1380,spec2/voc/Bl122_184710100.jpg,Bl122,0
11851.89073,11851.89473,1,voc,355556721,355556841,120,spec2/voc/Bl122_355556721.jpg,Bl122,0
11154.04418,11154.04718,1,voc,334621325,334621415,90,spec2/voc/Bl122_334621325.jpg,Bl122,0
3850.375415,3850.384415,1,voc,115511262,115511532,270,spec2/voc/Bl122_115511262.jpg,Bl122,0
14801.922551,14801.980551,1,voc,444057676,444059416,1740,spec2/voc/Bl122_444057676.jpg,Bl122,0
11175.24818,11175.25118,1,voc,335257445,335257535,90,spec2/voc/Bl122_335257445.jpg,Bl122,0
10912.239807,10912.618807,1,voc,327367194,327378564,11370,spec2/voc/Bl122_327367194.jpg,Bl122,0
14710.771469,14710.773469,1,voc,441323144,441323204,60,spec2/voc/Bl122_441323144.jpg,Bl122,0
5956.149256,5956.175256,1,voc,178684477,178685257,780,spec2/voc/Bl122_178684477.jpg,Bl122,0
8015.784748,8015.792748,1,voc,240473542,240473782,240,spec2/voc/Bl122_240473542.jpg,Bl122,0
6050.0392,6050.0702,1,voc,181501176,181502106,930,spec2/voc/Bl122_181501176.jpg,Bl122,0
10934.613807,10934.618807,1,voc,328038414,328038564,150,spec2/voc/Bl122_328038414.jpg,Bl122,0
8362.108263,8362.144263,1,voc,250863247,250864327,1080,spec2/voc/Bl122_250863247.jpg,Bl122,0
10955.467807,10955.471807,1,voc,328664034,328664154,120,spec2/voc/Bl122_328664034.jpg,Bl122,0
6178.314327,6178.338327,1,voc,185349429,185350149,720,spec2/voc/Bl122_185349429.jpg,Bl122,0
9067.376241,9067.384241,1,voc,272021287,272021527,240,spec2/voc/Bl122_272021287.jpg,Bl122,0
5964.993256,5964.997256,1,voc,178949797,178949917,120,spec2/voc/Bl122_178949797.jpg,Bl122,0
11194.02018,11194.05118,1,voc,335820605,335821535,930,spec2/voc/Bl122_335820605.jpg,Bl122,0
13156.596066,13156.599066,1,voc,394697881,394697971,90,spec2/voc/Bl122_394697881.jpg,Bl122,0
3891.021652,3891.145652,1,voc,116730649,116734369,3720,spec2/voc/Bl122_116730649.jpg,Bl122,0
9011.509241,9011.515241,1,voc,270345277,270345457,180,spec2/voc/Bl122_270345277.jpg,Bl122,0
6136.484293,6136.768293,1,voc,184094528,184103048,8520,spec2/voc/Bl122_184094528.jpg,Bl122,0
3810.382649,3810.385649,1,voc,114311479,114311569,90,spec2/voc/Bl122_114311479.jpg,Bl122,0
9027.952241,9028.075241,1,voc,270838567,270842257,3690,spec2/voc/Bl122_270838567.jpg,Bl122,0
14836.516682,14836.523682,1,voc,445095500,445095710,210,spec2/voc/Bl122_445095500.jpg,Bl122,0
6004.311256,6004.359256,1,voc,180129337,180130777,1440,spec2/voc/Bl122_180129337.jpg,Bl122,0
11854.269769,11854.430769,1,voc,355628093,355632923,4830,spec2/voc/Bl122_355628093.jpg,Bl122,0
2959.008975,2959.067975,1,voc,88770269,88772039,1770,spec2/voc/Bl122_88770269.jpg,Bl122,0
5942.592256,5942.597256,1,voc,178277767,178277917,150,spec2/voc/Bl122_178277767.jpg,Bl122,0
14841.899682,14841.901682,1,voc,445256990,445257050,60,spec2/voc/Bl122_445256990.jpg,Bl122,0
10918.094807,10918.114807,1,voc,327542844,327543444,600,spec2/voc/Bl122_327542844.jpg,Bl122,0
6056.605705,6056.623705,1,voc,181698171,181698711,540,spec2/voc/Bl122_181698171.jpg,Bl122,0
6013.639533,6013.655533,1,voc,180409185,180409665,480,spec2/voc/Bl122_180409185.jpg,Bl122,0
13583.975236,13583.988236,1,voc,407519257,407519647,390,spec2/voc/Bl122_407519257.jpg,Bl122,0
14809.608551,14809.623551,1,voc,444288256,444288706,450,spec2/voc/Bl122_444288256.jpg,Bl122,0
7936.626748,7936.638748,1,voc,238098802,238099162,360,spec2/voc/Bl122_238098802.jpg,Bl122,0
13966.750352,13966.757352,1,voc,419002510,419002720,210,spec2/voc/Bl122_419002510.jpg,Bl122,0
9052.070241,9052.076241,1,voc,271562107,271562287,180,spec2/voc/Bl122_271562107.jpg,Bl122,0
10913.017807,10913.021807,1,voc,327390534,327390654,120,spec2/voc/Bl122_327390534.jpg,Bl122,0
6104.226706,6104.273706,1,voc,183126801,183128211,1410,spec2/voc/Bl122_183126801.jpg,Bl122,0
7802.084748,7802.089748,1,voc,234062542,234062692,150,spec2/voc/Bl122_234062542.jpg,Bl122,0
9047.680241,9047.682241,1,voc,271430407,271430467,60,spec2/voc/Bl122_271430407.jpg,Bl122,0
13949.085911,13949.102911,1,voc,418472577,418473087,510,spec2/voc/Bl122_418472577.jpg,Bl122,0
10953.427807,10953.529807,1,voc,328602834,328605894,3060,spec2/voc/Bl122_328602834.jpg,Bl122,0
14795.032551,14795.047551,1,voc,443850976,443851426,450,spec2/voc/Bl122_443850976.jpg,Bl122,0
7955.649748,7955.657748,1,voc,238669492,238669732,240,spec2/voc/Bl122_238669492.jpg,Bl122,0
13159.542891,13159.755891,1,voc,394786286,394792676,6390,spec2/voc/Bl122_394786286.jpg,Bl122,0
3816.814649,3816.826649,1,voc,114504439,114504799,360,spec2/voc/Bl122_114504439.jpg,Bl122,0
6160.775349,6160.777349,1,voc,184823260,184823320,60,spec2/voc/Bl122_184823260.jpg,Bl122,0
13968.148352,13968.219352,1,voc,419044450,419046580,2130,spec2/voc/Bl122_419044450.jpg,Bl122,0
11186.87618,11186.88818,1,voc,335606285,335606645,360,spec2/voc/Bl122_335606285.jpg,Bl122,0
9051.522241,9051.536241,1,voc,271545667,271546087,420,spec2/voc/Bl122_271545667.jpg,Bl122,0
13188.104662,13188.118662,1,voc,395643139,395643559,420,spec2/voc/Bl122_395643139.jpg,Bl122,0
7798.168748,7798.173748,1,voc,233945062,233945212,150,spec2/voc/Bl122_233945062.jpg,Bl122,0
3897.941652,3898.162652,1,voc,116938249,116944879,6630,spec2/voc/Bl122_116938249.jpg,Bl122,0
8345.708566,8345.784566,1,voc,250371256,250373536,2280,spec2/voc/Bl122_250371256.jpg,Bl122,0
7989.333748,7989.345748,1,voc,239680012,239680372,360,spec2/voc/Bl122_239680012.jpg,Bl122,0
6172.810327,6172.891327,1,voc,185184309,185186739,2430,spec2/voc/Bl122_185184309.jpg,Bl122,0
7885.736748,7885.745748,1,voc,236572102,236572372,270,spec2/voc/Bl122_236572102.jpg,Bl122,0
6154.142349,6154.148349,1,voc,184624270,184624450,180,spec2/voc/Bl122_184624270.jpg,Bl122,0
14842.219682,14842.224682,1,voc,445266590,445266740,150,spec2/voc/Bl122_445266590.jpg,Bl122,0
11138.264955,11138.291955,1,voc,334147948,334148758,810,spec2/voc/Bl122_334147948.jpg,Bl122,0
5956.246256,5956.438256,1,voc,178687387,178693147,5760,spec2/voc/Bl122_178687387.jpg,Bl122,0
12591.611947,12591.637947,1,voc,377748358,377749138,780,spec2/voc/Bl122_377748358.jpg,Bl122,0
5939.694256,5939.732256,1,voc,178190827,178191967,1140,spec2/voc/Bl122_178190827.jpg,Bl122,0
6226.883295,6226.886295,1,voc,186806498,186806588,90,spec2/voc/Bl122_186806498.jpg,Bl122,0
13584.670236,13584.776236,1,voc,407540107,407543287,3180,spec2/voc/Bl122_407540107.jpg,Bl122,0
8038.302748,8038.318748,1,voc,241149082,241149562,480,spec2/voc/Bl122_241149082.jpg,Bl122,0
6109.489706,6109.510706,1,voc,183284691,183285321,630,spec2/voc/Bl122_183284691.jpg,Bl122,0
3846.265415,3846.460415,1,voc,115387962,115393812,5850,spec2/voc/Bl122_115387962.jpg,Bl122,0
13206.116389,13206.125389,1,voc,396183491,396183761,270,spec2/voc/Bl122_396183491.jpg,Bl122,0
6050.5712,6050.6082,1,voc,181517136,181518246,1110,spec2/voc/Bl122_181517136.jpg,Bl122,0
11193.26518,11193.45118,1,voc,335797955,335803535,5580,spec2/voc/Bl122_335797955.jpg,Bl122,0
11152.46118,11152.48518,1,voc,334573835,334574555,720,spec2/voc/Bl122_334573835.jpg,Bl122,0
9040.985241,9041.117241,1,voc,271229557,271233517,3960,spec2/voc/Bl122_271229557.jpg,Bl122,0
6038.052533,6038.118533,1,voc,181141575,181143555,1980,spec2/voc/Bl122_181141575.jpg,Bl122,0
3881.237062,3881.241062,1,voc,116437111,116437231,120,spec2/voc/Bl122_116437111.jpg,Bl122,0
10913.033807,10913.037807,1,voc,327391014,327391134,120,spec2/voc/Bl122_327391014.jpg,Bl122,0
12640.756849,12640.842849,1,voc,379222705,379225285,2580,spec2/voc/Bl122_379222705.jpg,Bl122,0
3813.282649,3813.289649,1,voc,114398479,114398689,210,spec2/voc/Bl122_114398479.jpg,Bl122,0
6047.6272,6047.6802,1,voc,181428816,181430406,1590,spec2/voc/Bl122_181428816.jpg,Bl122,0
11156.39118,11156.39818,1,voc,334691735,334691945,210,spec2/voc/Bl122_334691735.jpg,Bl122,0
7884.174748,7884.223748,1,voc,236525242,236526712,1470,spec2/voc/Bl122_236525242.jpg,Bl122,0
13574.691572,13574.723572,1,voc,407240747,407241707,960,spec2/voc/Bl122_407240747.jpg,Bl122,0
3827.687649,3827.693649,1,voc,114830629,114830809,180,spec2/voc/Bl122_114830629.jpg,Bl122,0
9021.827241,9021.902241,1,voc,270654817,270657067,2250,spec2/voc/Bl122_270654817.jpg,Bl122,0
7984.183748,7984.214748,1,voc,239525512,239526442,930,spec2/voc/Bl122_239525512.jpg,Bl122,0
9162.093057,9162.098057,1,voc,274862791,274862941,150,spec2/voc/Bl122_274862791.jpg,Bl122,0
10874.807466,10875.011466,1,voc,326244223,326250343,6120,spec2/voc/Bl122_326244223.jpg,Bl122,0
6077.001705,6077.044705,1,voc,182310051,182311341,1290,spec2/voc/Bl122_182310051.jpg,Bl122,0
3818.761649,3818.768649,1,voc,114562849,114563059,210,spec2/voc/Bl122_114562849.jpg,Bl122,0
3847.241415,3847.292415,1,voc,115417242,115418772,1530,spec2/voc/Bl122_115417242.jpg,Bl122,0
9142.816757,9142.822757,1,voc,274284502,274284682,180,spec2/voc/Bl122_274284502.jpg,Bl122,0
8990.256241,8990.311241,1,voc,269707687,269709337,1650,spec2/voc/Bl122_269707687.jpg,Bl122,0
7851.544748,7851.663748,1,voc,235546342,235549912,3570,spec2/voc/Bl122_235546342.jpg,Bl122,0
8927.970773,8927.977773,1,voc,267839123,267839333,210,spec2/voc/Bl122_267839123.jpg,Bl122,0
6131.835293,6131.855293,1,voc,183955058,183955658,600,spec2/voc/Bl122_183955058.jpg,Bl122,0
13547.485973,13547.598973,1,voc,406424579,406427969,3390,spec2/voc/Bl122_406424579.jpg,Bl122,0
7802.566748,7802.584748,1,voc,234077002,234077542,540,spec2/voc/Bl122_234077002.jpg,Bl122,0
14817.733551,14817.737551,1,voc,444532006,444532126,120,spec2/voc/Bl122_444532006.jpg,Bl122,0
13744.233896,13744.235896,1,voc,412327016,412327076,60,spec2/voc/Bl122_412327016.jpg,Bl122,0
6028.368533,6028.521533,1,voc,180851055,180855645,4590,spec2/voc/Bl122_180851055.jpg,Bl122,0
10937.327807,10937.345807,1,voc,328119834,328120374,540,spec2/voc/Bl122_328119834.jpg,Bl122,0
14810.278551,14810.421551,1,voc,444308356,444312646,4290,spec2/voc/Bl122_444308356.jpg,Bl122,0
13921.175981,13921.178981,1,voc,417635279,417635369,90,spec2/voc/Bl122_417635279.jpg,Bl122,0
8195.64375,8195.69675,1,voc,245869312,245870902,1590,spec2/voc/Bl122_245869312.jpg,Bl122,0
13966.093352,13966.143352,1,voc,418982800,418984300,1500,spec2/voc/Bl122_418982800.jpg,Bl122,0
6099.64615,6099.65415,1,voc,182989384,182989624,240,spec2/voc/Bl122_182989384.jpg,Bl122,0
7886.420748,7886.424748,1,voc,236592622,236592742,120,spec2/voc/Bl122_236592622.jpg,Bl122,0
9146.941342,9146.964342,1,voc,274408240,274408930,690,spec2/voc/Bl122_274408240.jpg,Bl122,0
7923.408748,7923.418748,1,voc,237702262,237702562,300,spec2/voc/Bl122_237702262.jpg,Bl122,0
13584.025236,13584.032236,1,voc,407520757,407520967,210,spec2/voc/Bl122_407520757.jpg,Bl122,0
13962.509384,13962.535384,1,voc,418875281,418876061,780,spec2/voc/Bl122_418875281.jpg,Bl122,0
9142.203757,9142.399757,1,voc,274266112,274271992,5880,spec2/voc/Bl122_274266112.jpg,Bl122,0
6056.746705,6056.785705,1,voc,181702401,181703571,1170,spec2/voc/Bl122_181702401.jpg,Bl122,0
10930.686807,10930.774807,1,voc,327920604,327923244,2640,spec2/voc/Bl122_327920604.jpg,Bl122,0
7822.795748,7822.812748,1,voc,234683872,234684382,510,spec2/voc/Bl122_234683872.jpg,Bl122,0
9044.212241,9044.216241,1,voc,271326367,271326487,120,spec2/voc/Bl122_271326367.jpg,Bl122,0
11143.359955,11143.388955,1,voc,334300798,334301668,870,spec2/voc/Bl122_334300798.jpg,Bl122,0
8952.199967,8952.299967,1,voc,268565999,268568999,3000,spec2/voc/Bl122_268565999.jpg,Bl122,0
9072.930241,9072.952241,1,voc,272187907,272188567,660,spec2/voc/Bl122_272187907.jpg,Bl122,0
14791.998551,14792.009551,1,voc,443759956,443760286,330,spec2/voc/Bl122_443759956.jpg,Bl122,0
3869.081367,3869.085367,1,voc,116072441,116072561,120,spec2/voc/Bl122_116072441.jpg,Bl122,0
13816.477617,13816.526617,1,voc,414494328,414495798,1470,spec2/voc/Bl122_414494328.jpg,Bl122,0
5980.514256,5980.773256,1,voc,179415427,179423197,7770,spec2/voc/Bl122_179415427.jpg,Bl122,0
11161.02418,11161.02718,1,voc,334830725,334830815,90,spec2/voc/Bl122_334830725.jpg,Bl122,0
13960.919384,13960.948384,1,voc,418827581,418828451,870,spec2/voc/Bl122_418827581.jpg,Bl122,0
11170.95818,11170.97418,1,voc,335128745,335129225,480,spec2/voc/Bl122_335128745.jpg,Bl122,0
3885.702062,3885.790062,1,voc,116571061,116573701,2640,spec2/voc/Bl122_116571061.jpg,Bl122,0
13222.569389,13222.575389,1,voc,396677081,396677261,180,spec2/voc/Bl122_396677081.jpg,Bl122,0
3889.639652,3889.653652,1,voc,116689189,116689609,420,spec2/voc/Bl122_116689189.jpg,Bl122,0
6046.2552,6046.3902,1,voc,181387656,181391706,4050,spec2/voc/Bl122_181387656.jpg,Bl122,0
13828.953664,13829.002664,1,voc,414868609,414870079,1470,spec2/voc/Bl122_414868609.jpg,Bl122,0
6060.597705,6060.660705,1,voc,181817931,181819821,1890,spec2/voc/Bl122_181817931.jpg,Bl122,0
10954.825807,10954.834807,1,voc,328644774,328645044,270,spec2/voc/Bl122_328644774.jpg,Bl122,0
5941.985256,5941.988256,1,voc,178259557,178259647,90,spec2/voc/Bl122_178259557.jpg,Bl122,0
3812.834649,3812.838649,1,voc,114385039,114385159,120,spec2/voc/Bl122_114385039.jpg,Bl122,0
5946.741256,5946.786256,1,voc,178402237,178403587,1350,spec2/voc/Bl122_178402237.jpg,Bl122,0
14838.939682,14838.951682,1,voc,445168190,445168550,360,spec2/voc/Bl122_445168190.jpg,Bl122,0
6044.0232,6044.0432,1,voc,181320696,181321296,600,spec2/voc/Bl122_181320696.jpg,Bl122,0
7989.446748,7989.453748,1,voc,239683402,239683612,210,spec2/voc/Bl122_239683402.jpg,Bl122,0
12596.685038,12596.693038,1,voc,377900551,377900791,240,spec2/voc/Bl122_377900551.jpg,Bl122,0
6097.45915,6097.46415,1,voc,182923774,182923924,150,spec2/voc/Bl122_182923774.jpg,Bl122,0
13959.293384,13959.355384,1,voc,418778801,418780661,1860,spec2/voc/Bl122_418778801.jpg,Bl122,0
13599.169736,13599.175736,1,voc,407975092,407975272,180,spec2/voc/Bl122_407975092.jpg,Bl122,0
7842.001748,7842.004748,1,voc,235260052,235260142,90,spec2/voc/Bl122_235260052.jpg,Bl122,0
13172.400701,13172.405701,1,voc,395172021,395172171,150,spec2/voc/Bl122_395172021.jpg,Bl122,0
3840.637415,3840.691415,1,voc,115219122,115220742,1620,spec2/voc/Bl122_115219122.jpg,Bl122,0
9081.143241,9081.317241,1,voc,272434297,272439517,5220,spec2/voc/Bl122_272434297.jpg,Bl122,0
6194.187327,6194.345327,1,voc,185825619,185830359,4740,spec2/voc/Bl122_185825619.jpg,Bl122,0
13177.158701,13177.172701,1,voc,395314761,395315181,420,spec2/voc/Bl122_395314761.jpg,Bl122,0
6084.31715,6084.53615,1,voc,182529514,182536084,6570,spec2/voc/Bl122_182529514.jpg,Bl122,0
6223.552295,6223.558295,1,voc,186706568,186706748,180,spec2/voc/Bl122_186706568.jpg,Bl122,0
10903.694825,10903.790825,1,voc,327110844,327113724,2880,spec2/voc/Bl122_327110844.jpg,Bl122,0
3820.965649,3820.990649,1,voc,114628969,114629719,750,spec2/voc/Bl122_114628969.jpg,Bl122,0
3841.570415,3841.603415,1,voc,115247112,115248102,990,spec2/voc/Bl122_115247112.jpg,Bl122,0
13826.57122,13826.58022,1,voc,414797136,414797406,270,spec2/voc/Bl122_414797136.jpg,Bl122,0
5983.074256,5983.132256,1,voc,179492227,179493967,1740,spec2/voc/Bl122_179492227.jpg,Bl122,0
11141.322955,11141.404955,1,voc,334239688,334242148,2460,spec2/voc/Bl122_334239688.jpg,Bl122,0
7810.328748,7810.341748,1,voc,234309862,234310252,390,spec2/voc/Bl122_234309862.jpg,Bl122,0
13599.180736,13599.193736,1,voc,407975422,407975812,390,spec2/voc/Bl122_407975422.jpg,Bl122,0
13812.807352,13812.910352,1,voc,414384220,414387310,3090,spec2/voc/Bl122_414384220.jpg,Bl122,0
5988.495256,5988.547256,1,voc,179654857,179656417,1560,spec2/voc/Bl122_179654857.jpg,Bl122,0
8965.561712,8965.630712,1,voc,268966851,268968921,2070,spec2/voc/Bl122_268966851.jpg,Bl122,0
13170.157701,13170.240701,1,voc,395104731,395107221,2490,spec2/voc/Bl122_395104731.jpg,Bl122,0
13818.859617,13818.866617,1,voc,414565788,414565998,210,spec2/voc/Bl122_414565788.jpg,Bl122,0
6143.933349,6143.940349,1,voc,184318000,184318210,210,spec2/voc/Bl122_184318000.jpg,Bl122,0
11977.340797,11977.365797,1,voc,359320223,359320973,750,spec2/voc/Bl122_359320223.jpg,Bl122,0
5945.863256,5946.057256,1,voc,178375897,178381717,5820,spec2/voc/Bl122_178375897.jpg,Bl122,0
7723.197941,7723.377941,1,voc,231695938,231701338,5400,spec2/voc/Bl122_231695938.jpg,Bl122,0
6033.285533,6033.380533,1,voc,180998565,181001415,2850,spec2/voc/Bl122_180998565.jpg,Bl122,0
6034.365533,6034.418533,1,voc,181030965,181032555,1590,spec2/voc/Bl122_181030965.jpg,Bl122,0
6144.833349,6144.842349,1,voc,184345000,184345270,270,spec2/voc/Bl122_184345000.jpg,Bl122,0
7941.848748,7941.857748,1,voc,238255462,238255732,270,spec2/voc/Bl122_238255462.jpg,Bl122,0
12639.938849,12640.016849,1,voc,379198165,379200505,2340,spec2/voc/Bl122_379198165.jpg,Bl122,0
7978.107748,7978.121748,1,voc,239343232,239343652,420,spec2/voc/Bl122_239343232.jpg,Bl122,0
5990.576256,5990.629256,1,voc,179717287,179718877,1590,spec2/voc/Bl122_179717287.jpg,Bl122,0
6205.468327,6205.489327,1,voc,186164049,186164679,630,spec2/voc/Bl122_186164049.jpg,Bl122,0
7964.432748,7964.435748,1,voc,238932982,238933072,90,spec2/voc/Bl122_238932982.jpg,Bl122,0
8032.423748,8032.444748,1,voc,240972712,240973342,630,spec2/voc/Bl122_240972712.jpg,Bl122,0
7976.012748,7976.028748,1,voc,239280382,239280862,480,spec2/voc/Bl122_239280382.jpg,Bl122,0
10934.559807,10934.564807,1,voc,328036794,328036944,150,spec2/voc/Bl122_328036794.jpg,Bl122,0
6144.554349,6144.563349,1,voc,184336630,184336900,270,spec2/voc/Bl122_184336630.jpg,Bl122,0
13930.038797,13930.144797,1,voc,417901163,417904343,3180,spec2/voc/Bl122_417901163.jpg,Bl122,0
3845.774415,3845.780415,1,voc,115373232,115373412,180,spec2/voc/Bl122_115373232.jpg,Bl122,0
8208.810882,8208.818882,1,voc,246264326,246264566,240,spec2/voc/Bl122_246264326.jpg,Bl122,0
5960.576256,5960.601256,1,voc,178817287,178818037,750,spec2/voc/Bl122_178817287.jpg,Bl122,0
8016.046748,8016.086748,1,voc,240481402,240482602,1200,spec2/voc/Bl122_240481402.jpg,Bl122,0
3830.578649,3830.582649,1,voc,114917359,114917479,120,spec2/voc/Bl122_114917359.jpg,Bl122,0
3051.228329,3051.389329,1,voc,91536849,91541679,4830,spec2/voc/Bl122_91536849.jpg,Bl122,0
9131.131981,9131.225981,1,voc,273933959,273936779,2820,spec2/voc/Bl122_273933959.jpg,Bl122,0
5977.278256,5977.289256,1,voc,179318347,179318677,330,spec2/voc/Bl122_179318347.jpg,Bl122,0
13949.025911,13949.031911,1,voc,418470777,418470957,180,spec2/voc/Bl122_418470777.jpg,Bl122,0
11211.719894,11211.750894,1,voc,336351596,336352526,930,spec2/voc/Bl122_336351596.jpg,Bl122,0
9099.607241,9099.646241,1,voc,272988217,272989387,1170,spec2/voc/Bl122_272988217.jpg,Bl122,0
8950.056967,8950.533967,1,voc,268501709,268516019,14310,spec2/voc/Bl122_268501709.jpg,Bl122,0
11150.63518,11150.65518,1,voc,334519055,334519655,600,spec2/voc/Bl122_334519055.jpg,Bl122,0
6121.513706,6121.543706,1,voc,183645411,183646311,900,spec2/voc/Bl122_183645411.jpg,Bl122,0
3836.447415,3836.454415,1,voc,115093422,115093632,210,spec2/voc/Bl122_115093422.jpg,Bl122,0
3852.986415,3853.167415,1,voc,115589592,115595022,5430,spec2/voc/Bl122_115589592.jpg,Bl122,0
3827.143649,3827.149649,1,voc,114814309,114814489,180,spec2/voc/Bl122_114814309.jpg,Bl122,0
5996.326256,5996.328256,1,voc,179889787,179889847,60,spec2/voc/Bl122_179889787.jpg,Bl122,0
10959.485807,10959.488807,1,voc,328784574,328784664,90,spec2/voc/Bl122_328784574.jpg,Bl122,0
5954.488256,5954.494256,1,voc,178634647,178634827,180,spec2/voc/Bl122_178634647.jpg,Bl122,0
9034.956241,9034.959241,1,voc,271048687,271048777,90,spec2/voc/Bl122_271048687.jpg,Bl122,0
5993.925256,5993.994256,1,voc,179817757,179819827,2070,spec2/voc/Bl122_179817757.jpg,Bl122,0
9094.570241,9094.694241,1,voc,272837107,272840827,3720,spec2/voc/Bl122_272837107.jpg,Bl122,0
8929.864773,8929.877773,1,voc,267895943,267896333,390,spec2/voc/Bl122_267895943.jpg,Bl122,0
7853.678748,7853.693748,1,voc,235610362,235610812,450,spec2/voc/Bl122_235610362.jpg,Bl122,0
11182.50918,11182.51618,1,voc,335475275,335475485,210,spec2/voc/Bl122_335475275.jpg,Bl122,0
11953.640309,11953.695309,1,voc,358609209,358610859,1650,spec2/voc/Bl122_358609209.jpg,Bl122,0
3813.183649,3813.231649,1,voc,114395509,114396949,1440,spec2/voc/Bl122_114395509.jpg,Bl122,0
13219.176389,13219.208389,1,voc,396575291,396576251,960,spec2/voc/Bl122_396575291.jpg,Bl122,0
12907.334862,12907.596862,1,voc,387220045,387227905,7860,spec2/voc/Bl122_387220045.jpg,Bl122,0
7875.122748,7875.149748,1,voc,236253682,236254492,810,spec2/voc/Bl122_236253682.jpg,Bl122,0
5986.680256,5986.723256,1,voc,179600407,179601697,1290,spec2/voc/Bl122_179600407.jpg,Bl122,0
6124.246706,6124.343706,1,voc,183727401,183730311,2910,spec2/voc/Bl122_183727401.jpg,Bl122,0
7844.251748,7844.259748,1,voc,235327552,235327792,240,spec2/voc/Bl122_235327552.jpg,Bl122,0
3861.725367,3861.728367,1,voc,115851761,115851851,90,spec2/voc/Bl122_115851761.jpg,Bl122,0
13969.099352,13969.569352,1,voc,419072980,419087080,14100,spec2/voc/Bl122_419072980.jpg,Bl122,0
5970.204256,5970.232256,1,voc,179106127,179106967,840,spec2/voc/Bl122_179106127.jpg,Bl122,0
8019.114748,8019.131748,1,voc,240573442,240573952,510,spec2/voc/Bl122_240573442.jpg,Bl122,0
9073.308241,9073.490241,1,voc,272199247,272204707,5460,spec2/voc/Bl122_272199247.jpg,Bl122,0
11046.013537,11046.182537,1,voc,331380406,331385476,5070,spec2/voc/Bl122_331380406.jpg,Bl122,0
11208.132894,11208.171894,1,voc,336243986,336245156,1170,spec2/voc/Bl122_336243986.jpg,Bl122,0
7892.194748,7892.214748,1,voc,236765842,236766442,600,spec2/voc/Bl122_236765842.jpg,Bl122,0
7994.683748,7994.695748,1,voc,239840512,239840872,360,spec2/voc/Bl122_239840512.jpg,Bl122,0
9036.789241,9036.794241,1,voc,271103677,271103827,150,spec2/voc/Bl122_271103677.jpg,Bl122,0
7969.231748,7969.248748,1,voc,239076952,239077462,510,spec2/voc/Bl122_239076952.jpg,Bl122,0
9029.412241,9029.464241,1,voc,270882367,270883927,1560,spec2/voc/Bl122_270882367.jpg,Bl122,0
6176.497327,6176.502327,1,voc,185294919,185295069,150,spec2/voc/Bl122_185294919.jpg,Bl122,0
11141.256955,11141.305955,1,voc,334237708,334239178,1470,spec2/voc/Bl122_334237708.jpg,Bl122,0
9099.229241,9099.234241,1,voc,272976877,272977027,150,spec2/voc/Bl122_272976877.jpg,Bl122,0
8992.208241,8992.212241,1,voc,269766247,269766367,120,spec2/voc/Bl122_269766247.jpg,Bl122,0
14837.912682,14838.169682,1,voc,445137380,445145090,7710,spec2/voc/Bl122_445137380.jpg,Bl122,0
3843.032415,3843.046415,1,voc,115290972,115291392,420,spec2/voc/Bl122_115290972.jpg,Bl122,0
6048.1682,6048.1792,1,voc,181445046,181445376,330,spec2/voc/Bl122_181445046.jpg,Bl122,0
13218.615389,13218.631389,1,voc,396558461,396558941,480,spec2/voc/Bl122_396558461.jpg,Bl122,0
13976.216117,13976.236117,1,voc,419286483,419287083,600,spec2/voc/Bl122_419286483.jpg,Bl122,0
5983.134256,5983.280256,1,voc,179494027,179498407,4380,spec2/voc/Bl122_179494027.jpg,Bl122,0
6104.015706,6104.075706,1,voc,183120471,183122271,1800,spec2/voc/Bl122_183120471.jpg,Bl122,0
6062.030705,6062.033705,1,voc,181860921,181861011,90,spec2/voc/Bl122_181860921.jpg,Bl122,0
7841.917748,7841.931748,1,voc,235257532,235257952,420,spec2/voc/Bl122_235257532.jpg,Bl122,0
9034.636241,9034.891241,1,voc,271039087,271046737,7650,spec2/voc/Bl122_271039087.jpg,Bl122,0
12604.41976,12604.47476,1,voc,378132592,378134242,1650,spec2/voc/Bl122_378132592.jpg,Bl122,0
3817.464649,3817.861649,1,voc,114523939,114535849,11910,spec2/voc/Bl122_114523939.jpg,Bl122,0
3843.961415,3843.967415,1,voc,115318842,115319022,180,spec2/voc/Bl122_115318842.jpg,Bl122,0
5948.973256,5948.986256,1,voc,178469197,178469587,390,spec2/voc/Bl122_178469197.jpg,Bl122,0
6056.558705,6056.594705,1,voc,181696761,181697841,1080,spec2/voc/Bl122_181696761.jpg,Bl122,0
10908.176825,10908.343825,1,voc,327245304,327250314,5010,spec2/voc/Bl122_327245304.jpg,Bl122,0
9079.172241,9079.413241,1,voc,272375167,272382397,7230,spec2/voc/Bl122_272375167.jpg,Bl122,0
6182.280327,6182.285327,1,voc,185468409,185468559,150,spec2/voc/Bl122_185468409.jpg,Bl122,0
11196.25418,11196.29618,1,voc,335887625,335888885,1260,spec2/voc/Bl122_335887625.jpg,Bl122,0
6147.058349,6147.068349,1,voc,184411750,184412050,300,spec2/voc/Bl122_184411750.jpg,Bl122,0
10922.914807,10922.983807,1,voc,327687444,327689514,2070,spec2/voc/Bl122_327687444.jpg,Bl122,0
11143.324955,11143.357955,1,voc,334299748,334300738,990,spec2/voc/Bl122_334299748.jpg,Bl122,0
9142.165757,9142.170757,1,voc,274264972,274265122,150,spec2/voc/Bl122_274264972.jpg,Bl122,0
3176.837448,3176.850448,1,voc,95305123,95305513,390,spec2/voc/Bl122_95305123.jpg,Bl122,0
11178.61518,11178.65118,1,voc,335358455,335359535,1080,spec2/voc/Bl122_335358455.jpg,Bl122,0
14822.071551,14822.085551,1,voc,444662146,444662566,420,spec2/voc/Bl122_444662146.jpg,Bl122,0
6150.381349,6150.385349,1,voc,184511440,184511560,120,spec2/voc/Bl122_184511440.jpg,Bl122,0
3869.680367,3869.698367,1,voc,116090411,116090951,540,spec2/voc/Bl122_116090411.jpg,Bl122,0
13588.092236,13588.385236,1,voc,407642767,407651557,8790,spec2/voc/Bl122_407642767.jpg,Bl122,0
8026.691748,8026.738748,1,voc,240800752,240802162,1410,spec2/voc/Bl122_240800752.jpg,Bl122,0
14817.530551,14817.604551,1,voc,444525916,444528136,2220,spec2/voc/Bl122_444525916.jpg,Bl122,0
11191.09818,11191.11218,1,voc,335732945,335733365,420,spec2/voc/Bl122_335732945.jpg,Bl122,0
8018.503748,8018.509748,1,voc,240555112,240555292,180,spec2/voc/Bl122_240555112.jpg,Bl122,0
7940.043748,7940.074748,1,voc,238201312,238202242,930,spec2/voc/Bl122_238201312.jpg,Bl122,0
10825.799452,10826.034452,1,voc,324773983,324781033,7050,spec2/voc/Bl122_324773983.jpg,Bl122,0
3886.853062,3886.857062,1,voc,116605591,116605711,120,spec2/voc/Bl122_116605591.jpg,Bl122,0
6044.3972,6044.4792,1,voc,181331916,181334376,2460,spec2/voc/Bl122_181331916.jpg,Bl122,0
6093.36015,6093.42415,1,voc,182800804,182802724,1920,spec2/voc/Bl122_182800804.jpg,Bl122,0
13959.522384,13959.682384,1,voc,418785671,418790471,4800,spec2/voc/Bl122_418785671.jpg,Bl122,0
7772.892748,7772.898748,1,voc,233186782,233186962,180,spec2/voc/Bl122_233186782.jpg,Bl122,0
14838.849682,14838.882682,1,voc,445165490,445166480,990,spec2/voc/Bl122_445165490.jpg,Bl122,0
7892.162748,7892.171748,1,voc,236764882,236765152,270,spec2/voc/Bl122_236764882.jpg,Bl122,0
11888.953845,11888.959845,1,voc,356668615,356668795,180,spec2/voc/Bl122_356668615.jpg,Bl122,0
7950.887748,7950.893748,1,voc,238526632,238526812,180,spec2/voc/Bl122_238526632.jpg,Bl122,0
5966.019256,5966.095256,1,voc,178980577,178982857,2280,spec2/voc/Bl122_178980577.jpg,Bl122,0
7948.905748,7948.953748,1,voc,238467172,238468612,1440,spec2/voc/Bl122_238467172.jpg,Bl122,0
5996.660256,5996.695256,1,voc,179899807,179900857,1050,spec2/voc/Bl122_179899807.jpg,Bl122,0
7867.906748,7867.909748,1,voc,236037202,236037292,90,spec2/voc/Bl122_236037202.jpg,Bl122,0
13826.01122,13826.02022,1,voc,414780336,414780606,270,spec2/voc/Bl122_414780336.jpg,Bl122,0
6023.785533,6023.791533,1,voc,180713565,180713745,180,spec2/voc/Bl122_180713565.jpg,Bl122,0
13570.263052,13570.410052,1,voc,407107891,407112301,4410,spec2/voc/Bl122_407107891.jpg,Bl122,0
6189.747327,6189.763327,1,voc,185692419,185692899,480,spec2/voc/Bl122_185692419.jpg,Bl122,0
9032.360241,9032.373241,1,voc,270970807,270971197,390,spec2/voc/Bl122_270970807.jpg,Bl122,0
11208.371894,11208.398894,1,voc,336251156,336251966,810,spec2/voc/Bl122_336251156.jpg,Bl122,0
8021.783748,8021.805748,1,voc,240653512,240654172,660,spec2/voc/Bl122_240653512.jpg,Bl122,0
3883.049062,3883.076062,1,voc,116491471,116492281,810,spec2/voc/Bl122_116491471.jpg,Bl122,0
7908.983748,7908.987748,1,voc,237269512,237269632,120,spec2/voc/Bl122_237269512.jpg,Bl122,0
5956.869256,5956.899256,1,voc,178706077,178706977,900,spec2/voc/Bl122_178706077.jpg,Bl122,0
6226.552295,6226.554295,1,voc,186796568,186796628,60,spec2/voc/Bl122_186796568.jpg,Bl122,0
11179.93018,11179.93518,1,voc,335397905,335398055,150,spec2/voc/Bl122_335397905.jpg,Bl122,0
6059.726705,6059.738705,1,voc,181791801,181792161,360,spec2/voc/Bl122_181791801.jpg,Bl122,0
13605.755736,13605.771736,1,voc,408172672,408173152,480,spec2/voc/Bl122_408172672.jpg,Bl122,0
14835.061682,14835.465682,1,voc,445051850,445063970,12120,spec2/voc/Bl122_445051850.jpg,Bl122,0
9029.867241,9029.876241,1,voc,270896017,270896287,270,spec2/voc/Bl122_270896017.jpg,Bl122,0
6090.32015,6090.37015,1,voc,182709604,182711104,1500,spec2/voc/Bl122_182709604.jpg,Bl122,0
6154.509349,6154.516349,1,voc,184635280,184635490,210,spec2/voc/Bl122_184635280.jpg,Bl122,0
13961.346384,13961.436384,1,voc,418840391,418843091,2700,spec2/voc/Bl122_418840391.jpg,Bl122,0
11167.01518,11167.05018,1,voc,335010455,335011505,1050,spec2/voc/Bl122_335010455.jpg,Bl122,0
3841.760415,3841.972415,1,voc,115252812,115259172,6360,spec2/voc/Bl122_115252812.jpg,Bl122,0
6082.86315,6083.13015,1,voc,182485894,182493904,8010,spec2/voc/Bl122_182485894.jpg,Bl122,0
9098.690241,9098.705241,1,voc,272960707,272961157,450,spec2/voc/Bl122_272960707.jpg,Bl122,0
6089.55415,6089.55815,1,voc,182686624,182686744,120,spec2/voc/Bl122_182686624.jpg,Bl122,0
9086.945241,9086.951241,1,voc,272608357,272608537,180,spec2/voc/Bl122_272608357.jpg,Bl122,0
6042.6662,6042.6752,1,voc,181279986,181280256,270,spec2/voc/Bl122_181279986.jpg,Bl122,0
13733.954497,13733.978497,1,voc,412018634,412019354,720,spec2/voc/Bl122_412018634.jpg,Bl122,0
6131.351293,6131.378293,1,voc,183940538,183941348,810,spec2/voc/Bl122_183940538.jpg,Bl122,0
10946.275807,10946.331807,1,voc,328388274,328389954,1680,spec2/voc/Bl122_328388274.jpg,Bl122,0
14154.850825,14154.856825,1,voc,424645524,424645704,180,spec2/voc/Bl122_424645524.jpg,Bl122,0
13939.2449,13939.2499,1,voc,418177347,418177497,150,spec2/voc/Bl122_418177347.jpg,Bl122,0
9081.756241,9082.100241,1,voc,272452687,272463007,10320,spec2/voc/Bl122_272452687.jpg,Bl122,0
9096.652241,9096.678241,1,voc,272899567,272900347,780,spec2/voc/Bl122_272899567.jpg,Bl122,0
6077.646705,6077.906705,1,voc,182329401,182337201,7800,spec2/voc/Bl122_182329401.jpg,Bl122,0
11156.54318,11156.70818,1,voc,334696295,334701245,4950,spec2/voc/Bl122_334696295.jpg,Bl122,0
11867.368011,11867.527011,1,voc,356021040,356025810,4770,spec2/voc/Bl122_356021040.jpg,Bl122,0
13177.391701,13177.463701,1,voc,395321751,395323911,2160,spec2/voc/Bl122_395321751.jpg,Bl122,0
9004.529241,9004.535241,1,voc,270135877,270136057,180,spec2/voc/Bl122_270135877.jpg,Bl122,0
10919.843807,10919.949807,1,voc,327595314,327598494,3180,spec2/voc/Bl122_327595314.jpg,Bl122,0
13826.52522,13826.54322,1,voc,414795756,414796296,540,spec2/voc/Bl122_414795756.jpg,Bl122,0
11134.156005,11134.230005,1,voc,334024680,334026900,2220,spec2/voc/Bl122_334024680.jpg,Bl122,0
10896.529557,10896.539557,1,voc,326895886,326896186,300,spec2/voc/Bl122_326895886.jpg,Bl122,0
9097.129241,9097.153241,1,voc,272913877,272914597,720,spec2/voc/Bl122_272913877.jpg,Bl122,0
5985.974256,5985.978256,1,voc,179579227,179579347,120,spec2/voc/Bl122_179579227.jpg,Bl122,0
9093.286241,9093.346241,1,voc,272798587,272800387,1800,spec2/voc/Bl122_272798587.jpg,Bl122,0
8013.121748,8013.126748,1,voc,240393652,240393802,150,spec2/voc/Bl122_240393652.jpg,Bl122,0
10910.805807,10910.824807,1,voc,327324174,327324744,570,spec2/voc/Bl122_327324174.jpg,Bl122,0
7872.055748,7872.064748,1,voc,236161672,236161942,270,spec2/voc/Bl122_236161672.jpg,Bl122,0
8915.251773,8915.264773,1,voc,267457553,267457943,390,spec2/voc/Bl122_267457553.jpg,Bl122,0
6058.417705,6058.456705,1,voc,181752531,181753701,1170,spec2/voc/Bl122_181752531.jpg,Bl122,0
6023.964533,6023.990533,1,voc,180718935,180719715,780,spec2/voc/Bl122_180718935.jpg,Bl122,0
3816.808649,3816.811649,1,voc,114504259,114504349,90,spec2/voc/Bl122_114504259.jpg,Bl122,0
11915.369799,11915.372799,1,voc,357461093,357461183,90,spec2/voc/Bl122_357461093.jpg,Bl122,0
8968.934712,8969.039712,1,voc,269068041,269071191,3150,spec2/voc/Bl122_269068041.jpg,Bl122,0
7798.160748,7798.165748,1,voc,233944822,233944972,150,spec2/voc/Bl122_233944822.jpg,Bl122,0
6011.589533,6011.593533,1,voc,180347685,180347805,120,spec2/voc/Bl122_180347685.jpg,Bl122,0
9013.181241,9013.267241,1,voc,270395437,270398017,2580,spec2/voc/Bl122_270395437.jpg,Bl122,0
5974.136256,5974.139256,1,voc,179224087,179224177,90,spec2/voc/Bl122_179224087.jpg,Bl122,0
6040.815065,6040.890065,1,voc,181224451,181226701,2250,spec2/voc/Bl122_181224451.jpg,Bl122,0
8981.758025,8981.888025,1,voc,269452740,269456640,3900,spec2/voc/Bl122_269452740.jpg,Bl122,0
11985.528611,11985.533611,1,voc,359565858,359566008,150,spec2/voc/Bl122_359565858.jpg,Bl122,0
5981.568256,5981.764256,1,voc,179447047,179452927,5880,spec2/voc/Bl122_179447047.jpg,Bl122,0
7723.187941,7723.194941,1,voc,231695638,231695848,210,spec2/voc/Bl122_231695638.jpg,Bl122,0
7968.506748,7968.522748,1,voc,239055202,239055682,480,spec2/voc/Bl122_239055202.jpg,Bl122,0
6094.59215,6094.69415,1,voc,182837764,182840824,3060,spec2/voc/Bl122_182837764.jpg,Bl122,0
5943.725256,5943.730256,1,voc,178311757,178311907,150,spec2/voc/Bl122_178311757.jpg,Bl122,0
13171.119701,13171.162701,1,voc,395133591,395134881,1290,spec2/voc/Bl122_395133591.jpg,Bl122,0
6071.581705,6071.584705,1,voc,182147451,182147541,90,spec2/voc/Bl122_182147451.jpg,Bl122,0
8947.015967,8947.040967,1,voc,268410479,268411229,750,spec2/voc/Bl122_268410479.jpg,Bl122,0
12615.492964,12615.555964,1,voc,378464788,378466678,1890,spec2/voc/Bl122_378464788.jpg,Bl122,0
3896.502652,3896.737652,1,voc,116895079,116902129,7050,spec2/voc/Bl122_116895079.jpg,Bl122,0
10948.287807,10948.827807,1,voc,328448634,328464834,16200,spec2/voc/Bl122_328448634.jpg,Bl122,0
9048.343241,9048.399241,1,voc,271450297,271451977,1680,spec2/voc/Bl122_271450297.jpg,Bl122,0
6089.17015,6089.38915,1,voc,182675104,182681674,6570,spec2/voc/Bl122_182675104.jpg,Bl122,0
6157.051349,6157.262349,1,voc,184711540,184717870,6330,spec2/voc/Bl122_184711540.jpg,Bl122,0
6012.720533,6012.763533,1,voc,180381615,180382905,1290,spec2/voc/Bl122_180381615.jpg,Bl122,0
14842.226682,14842.322682,1,voc,445266800,445269680,2880,spec2/voc/Bl122_445266800.jpg,Bl122,0
5971.627256,5971.630256,1,voc,179148817,179148907,90,spec2/voc/Bl122_179148817.jpg,Bl122,0
13824.05922,13824.19622,1,voc,414721776,414725886,4110,spec2/voc/Bl122_414721776.jpg,Bl122,0
13207.914389,13207.924389,1,voc,396237431,396237731,300,spec2/voc/Bl122_396237431.jpg,Bl122,0
3176.422448,3176.442448,1,voc,95292673,95293273,600,spec2/voc/Bl122_95292673.jpg,Bl122,0
11915.175799,11915.194799,1,voc,357455273,357455843,570,spec2/voc/Bl122_357455273.jpg,Bl122,0
5978.776256,5978.836256,1,voc,179363287,179365087,1800,spec2/voc/Bl122_179363287.jpg,Bl122,0
6099.97715,6099.98115,1,voc,182999314,182999434,120,spec2/voc/Bl122_182999314.jpg,Bl122,0
9193.07198,9193.08598,1,voc,275792159,275792579,420,spec2/voc/Bl122_275792159.jpg,Bl122,0
3854.425415,3854.572415,1,voc,115632762,115637172,4410,spec2/voc/Bl122_115632762.jpg,Bl122,0
6197.895327,6197.980327,1,voc,185936859,185939409,2550,spec2/voc/Bl122_185936859.jpg,Bl122,0
11194.11918,11194.14318,1,voc,335823575,335824295,720,spec2/voc/Bl122_335823575.jpg,Bl122,0
9022.355241,9022.382241,1,voc,270670657,270671467,810,spec2/voc/Bl122_270670657.jpg,Bl122,0
5983.943256,5983.964256,1,voc,179518297,179518927,630,spec2/voc/Bl122_179518297.jpg,Bl122,0
9069.220241,9069.317241,1,voc,272076607,272079517,2910,spec2/voc/Bl122_272076607.jpg,Bl122,0
5938.506256,5938.509256,1,voc,178155187,178155277,90,spec2/voc/Bl122_178155187.jpg,Bl122,0
9153.075842,9153.102842,1,voc,274592275,274593085,810,spec2/voc/Bl122_274592275.jpg,Bl122,0
11212.000894,11212.040894,1,voc,336360026,336361226,1200,spec2/voc/Bl122_336360026.jpg,Bl122,0
5954.881256,5955.153256,1,voc,178646437,178654597,8160,spec2/voc/Bl122_178646437.jpg,Bl122,0
9080.101241,9080.215241,1,voc,272403037,272406457,3420,spec2/voc/Bl122_272403037.jpg,Bl122,0
10939.944807,10939.950807,1,voc,328198344,328198524,180,spec2/voc/Bl122_328198344.jpg,Bl122,0
6169.680327,6169.686327,1,voc,185090409,185090589,180,spec2/voc/Bl122_185090409.jpg,Bl122,0
13605.941736,13605.946736,1,voc,408178252,408178402,150,spec2/voc/Bl122_408178252.jpg,Bl122,0
9099.688241,9099.711241,1,voc,272990647,272991337,690,spec2/voc/Bl122_272990647.jpg,Bl122,0
11157.45818,11157.54118,1,voc,334723745,334726235,2490,spec2/voc/Bl122_334723745.jpg,Bl122,0
6142.610349,6142.843349,1,voc,184278310,184285300,6990,spec2/voc/Bl122_184278310.jpg,Bl122,0
10943.366807,10943.390807,1,voc,328301004,328301724,720,spec2/voc/Bl122_328301004.jpg,Bl122,0
8916.709773,8916.923773,1,voc,267501293,267507713,6420,spec2/voc/Bl122_267501293.jpg,Bl122,0
7794.034748,7794.046748,1,voc,233821042,233821402,360,spec2/voc/Bl122_233821042.jpg,Bl122,0
3801.003649,3801.115649,1,voc,114030109,114033469,3360,spec2/voc/Bl122_114030109.jpg,Bl122,0
6087.50315,6087.57715,1,voc,182625094,182627314,2220,spec2/voc/Bl122_182625094.jpg,Bl122,0
14824.443551,14824.517551,1,voc,444733306,444735526,2220,spec2/voc/Bl122_444733306.jpg,Bl122,0
10920.089807,10920.094807,1,voc,327602694,327602844,150,spec2/voc/Bl122_327602694.jpg,Bl122,0
6059.797705,6059.801705,1,voc,181793931,181794051,120,spec2/voc/Bl122_181793931.jpg,Bl122,0
14826.168551,14826.188551,1,voc,444785056,444785656,600,spec2/voc/Bl122_444785056.jpg,Bl122,0
12667.615394,12667.717394,1,voc,380028461,380031521,3060,spec2/voc/Bl122_380028461.jpg,Bl122,0
9049.791241,9049.806241,1,voc,271493737,271494187,450,spec2/voc/Bl122_271493737.jpg,Bl122,0
3824.058649,3824.119649,1,voc,114721759,114723589,1830,spec2/voc/Bl122_114721759.jpg,Bl122,0
5978.132256,5978.136256,1,voc,179343967,179344087,120,spec2/voc/Bl122_179343967.jpg,Bl122,0
14814.210551,14814.212551,1,voc,444426316,444426376,60,spec2/voc/Bl122_444426316.jpg,Bl122,0
9001.362241,9001.374241,1,voc,270040867,270041227,360,spec2/voc/Bl122_270040867.jpg,Bl122,0
13174.820701,13174.891701,1,voc,395244621,395246751,2130,spec2/voc/Bl122_395244621.jpg,Bl122,0
3818.486649,3818.498649,1,voc,114554599,114554959,360,spec2/voc/Bl122_114554599.jpg,Bl122,0
3816.794649,3816.804649,1,voc,114503839,114504139,300,spec2/voc/Bl122_114503839.jpg,Bl122,0
8914.709773,8914.882773,1,voc,267441293,267446483,5190,spec2/voc/Bl122_267441293.jpg,Bl122,0
11141.310955,11141.319955,1,voc,334239328,334239598,270,spec2/voc/Bl122_334239328.jpg,Bl122,0
3807.899649,3807.909649,1,voc,114236989,114237289,300,spec2/voc/Bl122_114236989.jpg,Bl122,0
14147.364552,14147.537552,1,voc,424420936,424426126,5190,spec2/voc/Bl122_424420936.jpg,Bl122,0
8346.786566,8346.791566,1,voc,250403596,250403746,150,spec2/voc/Bl122_250403596.jpg,Bl122,0
8016.196748,8016.198748,1,voc,240485902,240485962,60,spec2/voc/Bl122_240485902.jpg,Bl122,0
5975.237256,5975.242256,1,voc,179257117,179257267,150,spec2/voc/Bl122_179257117.jpg,Bl122,0
11151.09418,11151.11018,1,voc,334532825,334533305,480,spec2/voc/Bl122_334532825.jpg,Bl122,0
11191.50518,11191.68018,1,voc,335745155,335750405,5250,spec2/voc/Bl122_335745155.jpg,Bl122,0
9015.855241,9015.972241,1,voc,270475657,270479167,3510,spec2/voc/Bl122_270475657.jpg,Bl122,0
9032.760241,9032.951241,1,voc,270982807,270988537,5730,spec2/voc/Bl122_270982807.jpg,Bl122,0
13156.016066,13156.019066,1,voc,394680481,394680571,90,spec2/voc/Bl122_394680481.jpg,Bl122,0
13599.199736,13599.203736,1,voc,407975992,407976112,120,spec2/voc/Bl122_407975992.jpg,Bl122,0
6014.920533,6014.947533,1,voc,180447615,180448425,810,spec2/voc/Bl122_180447615.jpg,Bl122,0
5977.938256,5977.983256,1,voc,179338147,179339497,1350,spec2/voc/Bl122_179338147.jpg,Bl122,0
13809.455653,13809.616653,1,voc,414283669,414288499,4830,spec2/voc/Bl122_414283669.jpg,Bl122,0
6050.0732,6050.1692,1,voc,181502196,181505076,2880,spec2/voc/Bl122_181502196.jpg,Bl122,0
6055.897705,6055.925705,1,voc,181676931,181677771,840,spec2/voc/Bl122_181676931.jpg,Bl122,0
6207.796327,6207.986327,1,voc,186233889,186239589,5700,spec2/voc/Bl122_186233889.jpg,Bl122,0
7979.017748,7979.021748,1,voc,239370532,239370652,120,spec2/voc/Bl122_239370532.jpg,Bl122,0
8360.479263,8360.679263,1,voc,250814377,250820377,6000,spec2/voc/Bl122_250814377.jpg,Bl122,0
9135.845255,9135.923255,1,voc,274075357,274077697,2340,spec2/voc/Bl122_274075357.jpg,Bl122,0
7833.249748,7833.280748,1,voc,234997492,234998422,930,spec2/voc/Bl122_234997492.jpg,Bl122,0
6097.64715,6097.65515,1,voc,182929414,182929654,240,spec2/voc/Bl122_182929414.jpg,Bl122,0
10916.034807,10916.115807,1,voc,327481044,327483474,2430,spec2/voc/Bl122_327481044.jpg,Bl122,0
3805.356649,3805.364649,1,voc,114160699,114160939,240,spec2/voc/Bl122_114160699.jpg,Bl122,0
7807.934748,7807.937748,1,voc,234238042,234238132,90,spec2/voc/Bl122_234238042.jpg,Bl122,0
3819.691649,3819.749649,1,voc,114590749,114592489,1740,spec2/voc/Bl122_114590749.jpg,Bl122,0
5981.945256,5981.947256,1,voc,179458357,179458417,60,spec2/voc/Bl122_179458357.jpg,Bl122,0
11099.911855,11099.955855,1,voc,332997355,332998675,1320,spec2/voc/Bl122_332997355.jpg,Bl122,0
7968.495748,7968.497748,1,voc,239054872,239054932,60,spec2/voc/Bl122_239054872.jpg,Bl122,0
9054.787241,9054.813241,1,voc,271643617,271644397,780,spec2/voc/Bl122_271643617.jpg,Bl122,0
13207.284389,13207.573389,1,voc,396218531,396227201,8670,spec2/voc/Bl122_396218531.jpg,Bl122,0
8963.220712,8963.286712,1,voc,268896621,268898601,1980,spec2/voc/Bl122_268896621.jpg,Bl122,0
13638.705962,13638.764962,1,voc,409161178,409162948,1770,spec2/voc/Bl122_409161178.jpg,Bl122,0
8956.035967,8956.062967,1,voc,268681079,268681889,810,spec2/voc/Bl122_268681079.jpg,Bl122,0
6064.116705,6064.119705,1,voc,181923501,181923591,90,spec2/voc/Bl122_181923501.jpg,Bl122,0
9014.651241,9014.673241,1,voc,270439537,270440197,660,spec2/voc/Bl122_270439537.jpg,Bl122,0
6083.41815,6083.58115,1,voc,182502544,182507434,4890,spec2/voc/Bl122_182502544.jpg,Bl122,0
3797.827649,3797.835649,1,voc,113934829,113935069,240,spec2/voc/Bl122_113934829.jpg,Bl122,0
10896.546557,10896.556557,1,voc,326896396,326896696,300,spec2/voc/Bl122_326896396.jpg,Bl122,0
8367.717166,8367.963166,1,voc,251031514,251038894,7380,spec2/voc/Bl122_251031514.jpg,Bl122,0
6125.921706,6125.953706,1,voc,183777651,183778611,960,spec2/voc/Bl122_183777651.jpg,Bl122,0
7872.033748,7872.041748,1,voc,236161012,236161252,240,spec2/voc/Bl122_236161012.jpg,Bl122,0
6065.058705,6065.145705,1,voc,181951761,181954371,2610,spec2/voc/Bl122_181951761.jpg,Bl122,0
13899.27363,13899.40063,1,voc,416978208,416982018,3810,spec2/voc/Bl122_416978208.jpg,Bl122,0
9050.209241,9050.231241,1,voc,271506277,271506937,660,spec2/voc/Bl122_271506277.jpg,Bl122,0
14803.792551,14803.802551,1,voc,444113776,444114076,300,spec2/voc/Bl122_444113776.jpg,Bl122,0
13826.27222,13826.29322,1,voc,414788166,414788796,630,spec2/voc/Bl122_414788166.jpg,Bl122,0
6028.108533,6028.116533,1,voc,180843255,180843495,240,spec2/voc/Bl122_180843255.jpg,Bl122,0
13176.629701,13176.642701,1,voc,395298891,395299281,390,spec2/voc/Bl122_395298891.jpg,Bl122,0
9048.867241,9048.890241,1,voc,271466017,271466707,690,spec2/voc/Bl122_271466017.jpg,Bl122,0
6143.363349,6143.373349,1,voc,184300900,184301200,300,spec2/voc/Bl122_184300900.jpg,Bl122,0
13773.764473,13773.957473,1,voc,413212934,413218724,5790,spec2/voc/Bl122_413212934.jpg,Bl122,0
9098.918241,9098.930241,1,voc,272967547,272967907,360,spec2/voc/Bl122_272967547.jpg,Bl122,0
11202.191894,11202.202894,1,voc,336065756,336066086,330,spec2/voc/Bl122_336065756.jpg,Bl122,0
6051.5972,6051.6212,1,voc,181547916,181548636,720,spec2/voc/Bl122_181547916.jpg,Bl122,0
5931.537256,5931.546256,1,voc,177946117,177946387,270,spec2/voc/Bl122_177946117.jpg,Bl122,0
11915.446799,11915.453799,1,voc,357463403,357463613,210,spec2/voc/Bl122_357463403.jpg,Bl122,0
3798.246649,3798.279649,1,voc,113947399,113948389,990,spec2/voc/Bl122_113947399.jpg,Bl122,0
3870.359367,3870.516367,1,voc,116110781,116115491,4710,spec2/voc/Bl122_116110781.jpg,Bl122,0
5995.992256,5995.998256,1,voc,179879767,179879947,180,spec2/voc/Bl122_179879767.jpg,Bl122,0
5929.673364,5929.677364,1,voc,177890200,177890320,120,spec2/voc/Bl122_177890200.jpg,Bl122,0
10910.308807,10910.354807,1,voc,327309264,327310644,1380,spec2/voc/Bl122_327309264.jpg,Bl122,0
8915.311773,8915.321773,1,voc,267459353,267459653,300,spec2/voc/Bl122_267459353.jpg,Bl122,0
6034.032533,6034.041533,1,voc,181020975,181021245,270,spec2/voc/Bl122_181020975.jpg,Bl122,0
7984.590748,7984.596748,1,voc,239537722,239537902,180,spec2/voc/Bl122_239537722.jpg,Bl122,0
9051.966241,9051.974241,1,voc,271558987,271559227,240,spec2/voc/Bl122_271558987.jpg,Bl122,0
6110.587706,6110.769706,1,voc,183317631,183323091,5460,spec2/voc/Bl122_183317631.jpg,Bl122,0
6056.373705,6056.385705,1,voc,181691211,181691571,360,spec2/voc/Bl122_181691211.jpg,Bl122,0
7912.389748,7912.421748,1,voc,237371692,237372652,960,spec2/voc/Bl122_237371692.jpg,Bl122,0
10963.285807,10963.394807,1,voc,328898574,328901844,3270,spec2/voc/Bl122_328898574.jpg,Bl122,0
9165.307604,9165.343604,1,voc,274959228,274960308,1080,spec2/voc/Bl122_274959228.jpg,Bl122,0
6131.593293,6131.642293,1,voc,183947798,183949268,1470,spec2/voc/Bl122_183947798.jpg,Bl122,0
8018.511748,8018.518748,1,voc,240555352,240555562,210,spec2/voc/Bl122_240555352.jpg,Bl122,0
9038.540241,9038.642241,1,voc,271156207,271159267,3060,spec2/voc/Bl122_271156207.jpg,Bl122,0
8996.234241,8996.282241,1,voc,269887027,269888467,1440,spec2/voc/Bl122_269887027.jpg,Bl122,0
12598.404308,12598.455308,1,voc,377952129,377953659,1530,spec2/voc/Bl122_377952129.jpg,Bl122,0
6184.124327,6184.131327,1,voc,185523729,185523939,210,spec2/voc/Bl122_185523729.jpg,Bl122,0
13191.523662,13191.530662,1,voc,395745709,395745919,210,spec2/voc/Bl122_395745709.jpg,Bl122,0
10929.773807,10929.856807,1,voc,327893214,327895704,2490,spec2/voc/Bl122_327893214.jpg,Bl122,0
6146.981349,6147.013349,1,voc,184409440,184410400,960,spec2/voc/Bl122_184409440.jpg,Bl122,0
14196.936109,14197.038109,1,voc,425908083,425911143,3060,spec2/voc/Bl122_425908083.jpg,Bl122,0
5973.780256,5973.785256,1,voc,179213407,179213557,150,spec2/voc/Bl122_179213407.jpg,Bl122,0
5998.855256,5998.929256,1,voc,179965657,179967877,2220,spec2/voc/Bl122_179965657.jpg,Bl122,0
11141.174955,11141.249955,1,voc,334235248,334237498,2250,spec2/voc/Bl122_334235248.jpg,Bl122,0
13208.665389,13208.678389,1,voc,396259961,396260351,390,spec2/voc/Bl122_396259961.jpg,Bl122,0
7796.890748,7796.935748,1,voc,233906722,233908072,1350,spec2/voc/Bl122_233906722.jpg,Bl122,0
5975.035256,5975.040256,1,voc,179251057,179251207,150,spec2/voc/Bl122_179251057.jpg,Bl122,0
9048.923241,9048.936241,1,voc,271467697,271468087,390,spec2/voc/Bl122_271467697.jpg,Bl122,0
6183.352327,6183.362327,1,voc,185500569,185500869,300,spec2/voc/Bl122_185500569.jpg,Bl122,0
14837.812682,14837.865682,1,voc,445134380,445135970,1590,spec2/voc/Bl122_445134380.jpg,Bl122,0
9076.319241,9076.356241,1,voc,272289577,272290687,1110,spec2/voc/Bl122_272289577.jpg,Bl122,0
3824.598649,3824.606649,1,voc,114737959,114738199,240,spec2/voc/Bl122_114737959.jpg,Bl122,0
9040.518241,9040.556241,1,voc,271215547,271216687,1140,spec2/voc/Bl122_271215547.jpg,Bl122,0
8041.064748,8041.077748,1,voc,241231942,241232332,390,spec2/voc/Bl122_241231942.jpg,Bl122,0
3819.250649,3819.273649,1,voc,114577519,114578209,690,spec2/voc/Bl122_114577519.jpg,Bl122,0
10882.181609,10882.184609,1,voc,326465448,326465538,90,spec2/voc/Bl122_326465448.jpg,Bl122,0
6096.90115,6096.92015,1,voc,182907034,182907604,570,spec2/voc/Bl122_182907034.jpg,Bl122,0
13743.958896,13744.068896,1,voc,412318766,412322066,3300,spec2/voc/Bl122_412318766.jpg,Bl122,0
13188.124662,13188.126662,1,voc,395643739,395643799,60,spec2/voc/Bl122_395643739.jpg,Bl122,0
5931.360256,5931.386256,1,voc,177940807,177941587,780,spec2/voc/Bl122_177940807.jpg,Bl122,0
10920.009807,10920.012807,1,voc,327600294,327600384,90,spec2/voc/Bl122_327600294.jpg,Bl122,0
6064.133705,6064.158705,1,voc,181924011,181924761,750,spec2/voc/Bl122_181924011.jpg,Bl122,0
9048.302241,9048.310241,1,voc,271449067,271449307,240,spec2/voc/Bl122_271449067.jpg,Bl122,0
6024.574533,6024.580533,1,voc,180737235,180737415,180,spec2/voc/Bl122_180737235.jpg,Bl122,0
10955.715807,10955.718807,1,voc,328671474,328671564,90,spec2/voc/Bl122_328671474.jpg,Bl122,0
9044.395241,9044.397241,1,voc,271331857,271331917,60,spec2/voc/Bl122_271331857.jpg,Bl122,0
8984.115025,8984.234025,1,voc,269523450,269527020,3570,spec2/voc/Bl122_269523450.jpg,Bl122,0
13604.759736,13604.765736,1,voc,408142792,408142972,180,spec2/voc/Bl122_408142792.jpg,Bl122,0
9148.472842,9148.625842,1,voc,274454185,274458775,4590,spec2/voc/Bl122_274454185.jpg,Bl122,0
11858.073698,11858.329698,1,voc,355742210,355749890,7680,spec2/voc/Bl122_355742210.jpg,Bl122,0
9038.467241,9038.483241,1,voc,271154017,271154497,480,spec2/voc/Bl122_271154017.jpg,Bl122,0
7972.293748,7972.295748,1,voc,239168812,239168872,60,spec2/voc/Bl122_239168812.jpg,Bl122,0
7845.149748,7845.198748,1,voc,235354492,235355962,1470,spec2/voc/Bl122_235354492.jpg,Bl122,0
10911.491807,10911.959807,1,voc,327344754,327358794,14040,spec2/voc/Bl122_327344754.jpg,Bl122,0
7998.508748,7998.536748,1,voc,239955262,239956102,840,spec2/voc/Bl122_239955262.jpg,Bl122,0
7833.745748,7833.763748,1,voc,235012372,235012912,540,spec2/voc/Bl122_235012372.jpg,Bl122,0
6227.428295,6227.485295,1,voc,186822848,186824558,1710,spec2/voc/Bl122_186822848.jpg,Bl122,0
7802.669748,7802.675748,1,voc,234080092,234080272,180,spec2/voc/Bl122_234080092.jpg,Bl122,0
6202.390327,6202.496327,1,voc,186071709,186074889,3180,spec2/voc/Bl122_186071709.jpg,Bl122,0
6152.406349,6152.613349,1,voc,184572190,184578400,6210,spec2/voc/Bl122_184572190.jpg,Bl122,0
6023.906533,6023.929533,1,voc,180717195,180717885,690,spec2/voc/Bl122_180717195.jpg,Bl122,0
7883.607748,7883.612748,1,voc,236508232,236508382,150,spec2/voc/Bl122_236508232.jpg,Bl122,0
10936.440807,10936.618807,1,voc,328093224,328098564,5340,spec2/voc/Bl122_328093224.jpg,Bl122,0
3797.261649,3797.322649,1,voc,113917849,113919679,1830,spec2/voc/Bl122_113917849.jpg,Bl122,0
5984.603256,5984.609256,1,voc,179538097,179538277,180,spec2/voc/Bl122_179538097.jpg,Bl122,0
13816.892617,13817.171617,1,voc,414506778,414515148,8370,spec2/voc/Bl122_414506778.jpg,Bl122,0
3264.252086,3264.455086,1,voc,97927562,97933652,6090,spec2/voc/Bl122_97927562.jpg,Bl122,0
6108.235706,6108.508706,1,voc,183247071,183255261,8190,spec2/voc/Bl122_183247071.jpg,Bl122,0
13177.274701,13177.279701,1,voc,395318241,395318391,150,spec2/voc/Bl122_395318241.jpg,Bl122,0
5942.425256,5942.581256,1,voc,178272757,178277437,4680,spec2/voc/Bl122_178272757.jpg,Bl122,0
9065.290241,9065.293241,1,voc,271958707,271958797,90,spec2/voc/Bl122_271958707.jpg,Bl122,0
9025.455241,9025.467241,1,voc,270763657,270764017,360,spec2/voc/Bl122_270763657.jpg,Bl122,0
5952.273256,5952.277256,1,voc,178568197,178568317,120,spec2/voc/Bl122_178568197.jpg,Bl122,0
3895.485652,3895.499652,1,voc,116864569,116864989,420,spec2/voc/Bl122_116864569.jpg,Bl122,0
11194.41018,11194.44018,1,voc,335832305,335833205,900,spec2/voc/Bl122_335832305.jpg,Bl122,0
10922.868807,10922.882807,1,voc,327686064,327686484,420,spec2/voc/Bl122_327686064.jpg,Bl122,0
9174.569287,9174.720287,1,voc,275237078,275241608,4530,spec2/voc/Bl122_275237078.jpg,Bl122,0
3885.379062,3885.488062,1,voc,116561371,116564641,3270,spec2/voc/Bl122_116561371.jpg,Bl122,0
3837.256415,3837.285415,1,voc,115117692,115118562,870,spec2/voc/Bl122_115117692.jpg,Bl122,0
6150.551349,6150.553349,1,voc,184516540,184516600,60,spec2/voc/Bl122_184516540.jpg,Bl122,0
14839.646682,14839.851682,1,voc,445189400,445195550,6150,spec2/voc/Bl122_445189400.jpg,Bl122,0
6109.513706,6109.604706,1,voc,183285411,183288141,2730,spec2/voc/Bl122_183285411.jpg,Bl122,0
5972.584256,5972.587256,1,voc,179177527,179177617,90,spec2/voc/Bl122_179177527.jpg,Bl122,0
13203.504389,13203.511389,1,voc,396105131,396105341,210,spec2/voc/Bl122_396105131.jpg,Bl122,0
9092.532241,9092.538241,1,voc,272775967,272776147,180,spec2/voc/Bl122_272775967.jpg,Bl122,0
5959.498256,5959.501256,1,voc,178784947,178785037,90,spec2/voc/Bl122_178784947.jpg,Bl122,0
6144.477349,6144.489349,1,voc,184334320,184334680,360,spec2/voc/Bl122_184334320.jpg,Bl122,0
13956.447384,13956.631384,1,voc,418693421,418698941,5520,spec2/voc/Bl122_418693421.jpg,Bl122,0
14826.163551,14826.165551,1,voc,444784906,444784966,60,spec2/voc/Bl122_444784906.jpg,Bl122,0
12673.324513,12673.414513,1,voc,380199735,380202435,2700,spec2/voc/Bl122_380199735.jpg,Bl122,0
8920.809773,8920.964773,1,voc,267624293,267628943,4650,spec2/voc/Bl122_267624293.jpg,Bl122,0
3810.258649,3810.379649,1,voc,114307759,114311389,3630,spec2/voc/Bl122_114307759.jpg,Bl122,0
6104.416706,6104.713706,1,voc,183132501,183141411,8910,spec2/voc/Bl122_183132501.jpg,Bl122,0
11207.613894,11207.619894,1,voc,336228416,336228596,180,spec2/voc/Bl122_336228416.jpg,Bl122,0
8982.010025,8982.100025,1,voc,269460300,269463000,2700,spec2/voc/Bl122_269460300.jpg,Bl122,0
7955.600748,7955.608748,1,voc,238668022,238668262,240,spec2/voc/Bl122_238668022.jpg,Bl122,0
3890.207652,3890.287652,1,voc,116706229,116708629,2400,spec2/voc/Bl122_116706229.jpg,Bl122,0
3850.081415,3850.086415,1,voc,115502442,115502592,150,spec2/voc/Bl122_115502442.jpg,Bl122,0
13822.44622,13822.44822,1,voc,414673386,414673446,60,spec2/voc/Bl122_414673386.jpg,Bl122,0
9151.677842,9151.691842,1,voc,274550335,274550755,420,spec2/voc/Bl122_274550335.jpg,Bl122,0
12666.975394,12666.980394,1,voc,380009261,380009411,150,spec2/voc/Bl122_380009261.jpg,Bl122,0
9007.175241,9007.330241,1,voc,270215257,270219907,4650,spec2/voc/Bl122_270215257.jpg,Bl122,0
9055.051241,9055.056241,1,voc,271651537,271651687,150,spec2/voc/Bl122_271651537.jpg,Bl122,0
13586.935236,13586.957236,1,voc,407608057,407608717,660,spec2/voc/Bl122_407608057.jpg,Bl122,0
6051.6532,6051.6612,1,voc,181549596,181549836,240,spec2/voc/Bl122_181549596.jpg,Bl122,0
12671.510513,12671.513513,1,voc,380145315,380145405,90,spec2/voc/Bl122_380145315.jpg,Bl122,0
14792.023551,14792.319551,1,voc,443760706,443769586,8880,spec2/voc/Bl122_443760706.jpg,Bl122,0
7845.123748,7845.131748,1,voc,235353712,235353952,240,spec2/voc/Bl122_235353712.jpg,Bl122,0
7984.294748,7984.352748,1,voc,239528842,239530582,1740,spec2/voc/Bl122_239528842.jpg,Bl122,0
14794.267551,14794.276551,1,voc,443828026,443828296,270,spec2/voc/Bl122_443828026.jpg,Bl122,0
14837.215682,14837.243682,1,voc,445116470,445117310,840,spec2/voc/Bl122_445116470.jpg,Bl122,0
14796.240551,14796.436551,1,voc,443887216,443893096,5880,spec2/voc/Bl122_443887216.jpg,Bl122,0
6042.7772,6042.7862,1,voc,181283316,181283586,270,spec2/voc/Bl122_181283316.jpg,Bl122,0
5980.366256,5980.373256,1,voc,179410987,179411197,210,spec2/voc/Bl122_179410987.jpg,Bl122,0
10935.421807,10935.525807,1,voc,328062654,328065774,3120,spec2/voc/Bl122_328062654.jpg,Bl122,0
10934.423807,10934.541807,1,voc,328032714,328036254,3540,spec2/voc/Bl122_328032714.jpg,Bl122,0
13921.032981,13921.095981,1,voc,417630989,417632879,1890,spec2/voc/Bl122_417630989.jpg,Bl122,0
12673.064513,12673.091513,1,voc,380191935,380192745,810,spec2/voc/Bl122_380191935.jpg,Bl122,0
13723.2029,13723.2099,1,voc,411696087,411696297,210,spec2/voc/Bl122_411696087.jpg,Bl122,0
13212.430389,13212.488389,1,voc,396372911,396374651,1740,spec2/voc/Bl122_396372911.jpg,Bl122,0
13582.185236,13582.209236,1,voc,407465557,407466277,720,spec2/voc/Bl122_407465557.jpg,Bl122,0
3812.696649,3812.727649,1,voc,114380899,114381829,930,spec2/voc/Bl122_114380899.jpg,Bl122,0
6002.586256,6002.825256,1,voc,180077587,180084757,7170,spec2/voc/Bl122_180077587.jpg,Bl122,0
5937.471256,5937.485256,1,voc,178124137,178124557,420,spec2/voc/Bl122_178124137.jpg,Bl122,0
7907.645748,7907.651748,1,voc,237229372,237229552,180,spec2/voc/Bl122_237229372.jpg,Bl122,0
11185.30018,11185.34218,1,voc,335559005,335560265,1260,spec2/voc/Bl122_335559005.jpg,Bl122,0
6081.063511,6081.121511,1,voc,182431905,182433645,1740,spec2/voc/Bl122_182431905.jpg,Bl122,0
11156.18418,11156.20018,1,voc,334685525,334686005,480,spec2/voc/Bl122_334685525.jpg,Bl122,0
14816.855551,14816.897551,1,voc,444505666,444506926,1260,spec2/voc/Bl122_444505666.jpg,Bl122,0
6086.98415,6087.23515,1,voc,182609524,182617054,7530,spec2/voc/Bl122_182609524.jpg,Bl122,0
5948.590256,5948.597256,1,voc,178457707,178457917,210,spec2/voc/Bl122_178457707.jpg,Bl122,0
8943.513967,8943.518967,1,voc,268305419,268305569,150,spec2/voc/Bl122_268305419.jpg,Bl122,0
13962.178384,13962.185384,1,voc,418865351,418865561,210,spec2/voc/Bl122_418865351.jpg,Bl122,0
13774.080473,13774.133473,1,voc,413222414,413224004,1590,spec2/voc/Bl122_413222414.jpg,Bl122,0
5943.752256,5943.786256,1,voc,178312567,178313587,1020,spec2/voc/Bl122_178312567.jpg,Bl122,0
7841.982748,7841.987748,1,voc,235259482,235259632,150,spec2/voc/Bl122_235259482.jpg,Bl122,0
3860.028367,3860.151367,1,voc,115800851,115804541,3690,spec2/voc/Bl122_115800851.jpg,Bl122,0
3865.097367,3865.100367,1,voc,115952921,115953011,90,spec2/voc/Bl122_115952921.jpg,Bl122,0
9113.754184,9113.780184,1,voc,273412625,273413405,780,spec2/voc/Bl122_273412625.jpg,Bl122,0
6133.052293,6133.104293,1,voc,183991568,183993128,1560,spec2/voc/Bl122_183991568.jpg,Bl122,0
6032.904533,6032.921533,1,voc,180987135,180987645,510,spec2/voc/Bl122_180987135.jpg,Bl122,0
14808.632551,14808.635551,1,voc,444258976,444259066,90,spec2/voc/Bl122_444258976.jpg,Bl122,0
13212.574389,13212.630389,1,voc,396377231,396378911,1680,spec2/voc/Bl122_396377231.jpg,Bl122,0
14816.487551,14816.563551,1,voc,444494626,444496906,2280,spec2/voc/Bl122_444494626.jpg,Bl122,0
6044.1872,6044.3872,1,voc,181325616,181331616,6000,spec2/voc/Bl122_181325616.jpg,Bl122,0
8922.067773,8922.110773,1,voc,267662033,267663323,1290,spec2/voc/Bl122_267662033.jpg,Bl122,0
10898.47656,10898.56656,1,voc,326954296,326956996,2700,spec2/voc/Bl122_326954296.jpg,Bl122,0
5938.988256,5939.009256,1,voc,178169647,178170277,630,spec2/voc/Bl122_178169647.jpg,Bl122,0
7999.937748,8000.020748,1,voc,239998132,240000622,2490,spec2/voc/Bl122_239998132.jpg,Bl122,0
13648.219941,13648.344941,1,voc,409446598,409450348,3750,spec2/voc/Bl122_409446598.jpg,Bl122,0
9095.017241,9095.061241,1,voc,272850517,272851837,1320,spec2/voc/Bl122_272850517.jpg,Bl122,0
3837.070415,3837.254415,1,voc,115112112,115117632,5520,spec2/voc/Bl122_115112112.jpg,Bl122,0
10930.777807,10930.796807,1,voc,327923334,327923904,570,spec2/voc/Bl122_327923334.jpg,Bl122,0
9109.019935,9109.203935,1,voc,273270598,273276118,5520,spec2/voc/Bl122_273270598.jpg,Bl122,0
3876.328848,3876.332848,1,voc,116289865,116289985,120,spec2/voc/Bl122_116289865.jpg,Bl122,0
6108.671706,6108.698706,1,voc,183260151,183260961,810,spec2/voc/Bl122_183260151.jpg,Bl122,0
9077.632241,9077.692241,1,voc,272328967,272330767,1800,spec2/voc/Bl122_272328967.jpg,Bl122,0
13151.154756,13151.179756,1,voc,394534642,394535392,750,spec2/voc/Bl122_394534642.jpg,Bl122,0
7853.229748,7853.235748,1,voc,235596892,235597072,180,spec2/voc/Bl122_235596892.jpg,Bl122,0
6228.052295,6228.066295,1,voc,186841568,186841988,420,spec2/voc/Bl122_186841568.jpg,Bl122,0
9101.292241,9101.312241,1,voc,273038767,273039367,600,spec2/voc/Bl122_273038767.jpg,Bl122,0
14812.143551,14812.153551,1,voc,444364306,444364606,300,spec2/voc/Bl122_444364306.jpg,Bl122,0
6192.417327,6192.423327,1,voc,185772519,185772699,180,spec2/voc/Bl122_185772519.jpg,Bl122,0
9016.117241,9016.164241,1,voc,270483517,270484927,1410,spec2/voc/Bl122_270483517.jpg,Bl122,0
3797.862649,3797.886649,1,voc,113935879,113936599,720,spec2/voc/Bl122_113935879.jpg,Bl122,0
13163.794891,13163.798891,1,voc,394913846,394913966,120,spec2/voc/Bl122_394913846.jpg,Bl122,0
6071.402705,6071.419705,1,voc,182142081,182142591,510,spec2/voc/Bl122_182142081.jpg,Bl122,0
7961.761748,7961.802748,1,voc,238852852,238854082,1230,spec2/voc/Bl122_238852852.jpg,Bl122,0
14790.212551,14790.215551,1,voc,443706376,443706466,90,spec2/voc/Bl122_443706376.jpg,Bl122,0
13814.512617,13814.583617,1,voc,414435378,414437508,2130,spec2/voc/Bl122_414435378.jpg,Bl122,0
7990.000748,7990.032748,1,voc,239700022,239700982,960,spec2/voc/Bl122_239700022.jpg,Bl122,0
11158.34718,11158.39718,1,voc,334750415,334751915,1500,spec2/voc/Bl122_334750415.jpg,Bl122,0
9067.469241,9067.721241,1,voc,272024077,272031637,7560,spec2/voc/Bl122_272024077.jpg,Bl122,0
3885.113062,3885.233062,1,voc,116553391,116556991,3600,spec2/voc/Bl122_116553391.jpg,Bl122,0
9096.173241,9096.181241,1,voc,272885197,272885437,240,spec2/voc/Bl122_272885197.jpg,Bl122,0
10960.585807,10960.626807,1,voc,328817574,328818804,1230,spec2/voc/Bl122_328817574.jpg,Bl122,0
9051.296241,9051.301241,1,voc,271538887,271539037,150,spec2/voc/Bl122_271538887.jpg,Bl122,0
11180.58218,11180.62218,1,voc,335417465,335418665,1200,spec2/voc/Bl122_335417465.jpg,Bl122,0
5960.146256,5960.159256,1,voc,178804387,178804777,390,spec2/voc/Bl122_178804387.jpg,Bl122,0
14843.566682,14843.621682,1,voc,445307000,445308650,1650,spec2/voc/Bl122_445307000.jpg,Bl122,0
13172.414701,13172.430701,1,voc,395172441,395172921,480,spec2/voc/Bl122_395172441.jpg,Bl122,0
6136.822293,6136.995293,1,voc,184104668,184109858,5190,spec2/voc/Bl122_184104668.jpg,Bl122,0
7768.160748,7768.193748,1,voc,233044822,233045812,990,spec2/voc/Bl122_233044822.jpg,Bl122,0
6110.936706,6110.945706,1,voc,183328101,183328371,270,spec2/voc/Bl122_183328101.jpg,Bl122,0
11855.193769,11855.340769,1,voc,355655813,355660223,4410,spec2/voc/Bl122_355655813.jpg,Bl122,0
5953.145256,5953.159256,1,voc,178594357,178594777,420,spec2/voc/Bl122_178594357.jpg,Bl122,0
6018.655533,6018.660533,1,voc,180559665,180559815,150,spec2/voc/Bl122_180559665.jpg,Bl122,0
6122.896706,6122.904706,1,voc,183686901,183687141,240,spec2/voc/Bl122_183686901.jpg,Bl122,0
6064.412705,6064.643705,1,voc,181932381,181939311,6930,spec2/voc/Bl122_181932381.jpg,Bl122,0
10950.060807,10950.195807,1,voc,328501824,328505874,4050,spec2/voc/Bl122_328501824.jpg,Bl122,0
8335.143758,8335.205758,1,voc,250054312,250056172,1860,spec2/voc/Bl122_250054312.jpg,Bl122,0
6220.758295,6220.764295,1,voc,186622748,186622928,180,spec2/voc/Bl122_186622748.jpg,Bl122,0
14797.770551,14797.803551,1,voc,443933116,443934106,990,spec2/voc/Bl122_443933116.jpg,Bl122,0
6004.936256,6004.962256,1,voc,180148087,180148867,780,spec2/voc/Bl122_180148087.jpg,Bl122,0
8022.598748,8022.602748,1,voc,240677962,240678082,120,spec2/voc/Bl122_240677962.jpg,Bl122,0
10898.12156,10898.37756,1,voc,326943646,326951326,7680,spec2/voc/Bl122_326943646.jpg,Bl122,0
10907.209825,10907.244825,1,voc,327216294,327217344,1050,spec2/voc/Bl122_327216294.jpg,Bl122,0
3815.713649,3815.716649,1,voc,114471409,114471499,90,spec2/voc/Bl122_114471409.jpg,Bl122,0
5991.712256,5991.724256,1,voc,179751367,179751727,360,spec2/voc/Bl122_179751367.jpg,Bl122,0
5958.004256,5958.028256,1,voc,178740127,178740847,720,spec2/voc/Bl122_178740127.jpg,Bl122,0
11195.08718,11195.12218,1,voc,335852615,335853665,1050,spec2/voc/Bl122_335852615.jpg,Bl122,0
3855.075415,3855.138415,1,voc,115652262,115654152,1890,spec2/voc/Bl122_115652262.jpg,Bl122,0
7994.536748,7994.580748,1,voc,239836102,239837422,1320,spec2/voc/Bl122_239836102.jpg,Bl122,0
6076.027705,6076.152705,1,voc,182280831,182284581,3750,spec2/voc/Bl122_182280831.jpg,Bl122,0
13659.920334,13659.923334,1,voc,409797610,409797700,90,spec2/voc/Bl122_409797610.jpg,Bl122,0
6076.907705,6076.910705,1,voc,182307231,182307321,90,spec2/voc/Bl122_182307231.jpg,Bl122,0
13162.046891,13162.051891,1,voc,394861406,394861556,150,spec2/voc/Bl122_394861406.jpg,Bl122,0
11175.25418,11175.27418,1,voc,335257625,335258225,600,spec2/voc/Bl122_335257625.jpg,Bl122,0
9004.583241,9004.609241,1,voc,270137497,270138277,780,spec2/voc/Bl122_270137497.jpg,Bl122,0
5952.824256,5952.988256,1,voc,178584727,178589647,4920,spec2/voc/Bl122_178584727.jpg,Bl122,0
13586.308236,13586.312236,1,voc,407589247,407589367,120,spec2/voc/Bl122_407589247.jpg,Bl122,0
3855.326415,3855.444415,1,voc,115659792,115663332,3540,spec2/voc/Bl122_115659792.jpg,Bl122,0
14842.372682,14842.578682,1,voc,445271180,445277360,6180,spec2/voc/Bl122_445271180.jpg,Bl122,0
14806.019551,14806.048551,1,voc,444180586,444181456,870,spec2/voc/Bl122_444180586.jpg,Bl122,0
6058.269705,6058.292705,1,voc,181748091,181748781,690,spec2/voc/Bl122_181748091.jpg,Bl122,0
9050.119241,9050.149241,1,voc,271503577,271504477,900,spec2/voc/Bl122_271503577.jpg,Bl122,0
13605.897736,13605.900736,1,voc,408176932,408177022,90,spec2/voc/Bl122_408176932.jpg,Bl122,0
8026.442748,8026.531748,1,voc,240793282,240795952,2670,spec2/voc/Bl122_240793282.jpg,Bl122,0
5256.334475,5256.531475,1,voc,157690034,157695944,5910,spec2/voc/Bl122_157690034.jpg,Bl122,0
8017.535748,8017.553748,1,voc,240526072,240526612,540,spec2/voc/Bl122_240526072.jpg,Bl122,0
9076.086241,9076.261241,1,voc,272282587,272287837,5250,spec2/voc/Bl122_272282587.jpg,Bl122,0
6097.00515,6097.01615,1,voc,182910154,182910484,330,spec2/voc/Bl122_182910154.jpg,Bl122,0
6131.514293,6131.546293,1,voc,183945428,183946388,960,spec2/voc/Bl122_183945428.jpg,Bl122,0
7993.697748,7993.703748,1,voc,239810932,239811112,180,spec2/voc/Bl122_239810932.jpg,Bl122,0
8013.042748,8013.045748,1,voc,240391282,240391372,90,spec2/voc/Bl122_240391282.jpg,Bl122,0
7933.122748,7933.128748,1,voc,237993682,237993862,180,spec2/voc/Bl122_237993682.jpg,Bl122,0
11174.37118,11174.38018,1,voc,335231135,335231405,270,spec2/voc/Bl122_335231135.jpg,Bl122,0
10915.549807,10915.629807,1,voc,327466494,327468894,2400,spec2/voc/Bl122_327466494.jpg,Bl122,0
11033.344132,11033.446132,1,voc,331000323,331003383,3060,spec2/voc/Bl122_331000323.jpg,Bl122,0
14811.449551,14811.529551,1,voc,444343486,444345886,2400,spec2/voc/Bl122_444343486.jpg,Bl122,0
14818.160551,14818.328551,1,voc,444544816,444549856,5040,spec2/voc/Bl122_444544816.jpg,Bl122,0
3057.679192,3057.775192,1,voc,91730375,91733255,2880,spec2/voc/Bl122_91730375.jpg,Bl122,0
7857.190748,7857.203748,1,voc,235715722,235716112,390,spec2/voc/Bl122_235715722.jpg,Bl122,0
6189.241327,6189.280327,1,voc,185677239,185678409,1170,spec2/voc/Bl122_185677239.jpg,Bl122,0
7969.447748,7969.453748,1,voc,239083432,239083612,180,spec2/voc/Bl122_239083432.jpg,Bl122,0
7926.104748,7926.123748,1,voc,237783142,237783712,570,spec2/voc/Bl122_237783142.jpg,Bl122,0
9092.630241,9092.708241,1,voc,272778907,272781247,2340,spec2/voc/Bl122_272778907.jpg,Bl122,0
7972.100748,7972.123748,1,voc,239163022,239163712,690,spec2/voc/Bl122_239163022.jpg,Bl122,0
9092.129241,9092.282241,1,voc,272763877,272768467,4590,spec2/voc/Bl122_272763877.jpg,Bl122,0
12672.648513,12672.660513,1,voc,380179455,380179815,360,spec2/voc/Bl122_380179455.jpg,Bl122,0
13762.971895,13763.183895,1,voc,412889156,412895516,6360,spec2/voc/Bl122_412889156.jpg,Bl122,0
6169.741327,6169.745327,1,voc,185092239,185092359,120,spec2/voc/Bl122_185092239.jpg,Bl122,0
6013.036533,6013.194533,1,voc,180391095,180395835,4740,spec2/voc/Bl122_180391095.jpg,Bl122,0
6176.663327,6176.755327,1,voc,185299899,185302659,2760,spec2/voc/Bl122_185299899.jpg,Bl122,0
13212.891389,13212.906389,1,voc,396386741,396387191,450,spec2/voc/Bl122_396386741.jpg,Bl122,0
6124.562706,6124.568706,1,voc,183736881,183737061,180,spec2/voc/Bl122_183736881.jpg,Bl122,0
5967.699256,5967.701256,1,voc,179030977,179031037,60,spec2/voc/Bl122_179030977.jpg,Bl122,0
9003.858241,9003.868241,1,voc,270115747,270116047,300,spec2/voc/Bl122_270115747.jpg,Bl122,0
11132.429005,11132.498005,1,voc,333972870,333974940,2070,spec2/voc/Bl122_333972870.jpg,Bl122,0
5961.264256,5961.273256,1,voc,178837927,178838197,270,spec2/voc/Bl122_178837927.jpg,Bl122,0
6082.80115,6082.86115,1,voc,182484034,182485834,1800,spec2/voc/Bl122_182484034.jpg,Bl122,0
10939.582807,10939.588807,1,voc,328187484,328187664,180,spec2/voc/Bl122_328187484.jpg,Bl122,0
9096.127241,9096.131241,1,voc,272883817,272883937,120,spec2/voc/Bl122_272883817.jpg,Bl122,0
6047.8402,6047.8732,1,voc,181435206,181436196,990,spec2/voc/Bl122_181435206.jpg,Bl122,0
5973.421256,5973.436256,1,voc,179202637,179203087,450,spec2/voc/Bl122_179202637.jpg,Bl122,0
9043.673241,9043.678241,1,voc,271310197,271310347,150,spec2/voc/Bl122_271310197.jpg,Bl122,0
8915.898773,8915.915773,1,voc,267476963,267477473,510,spec2/voc/Bl122_267476963.jpg,Bl122,0
10954.024807,10954.066807,1,voc,328620744,328622004,1260,spec2/voc/Bl122_328620744.jpg,Bl122,0
10921.603807,10921.658807,1,voc,327648114,327649764,1650,spec2/voc/Bl122_327648114.jpg,Bl122,0
13818.874617,13818.876617,1,voc,414566238,414566298,60,spec2/voc/Bl122_414566238.jpg,Bl122,0
3818.780649,3818.787649,1,voc,114563419,114563629,210,spec2/voc/Bl122_114563419.jpg,Bl122,0
3885.963062,3886.104062,1,voc,116578891,116583121,4230,spec2/voc/Bl122_116578891.jpg,Bl122,0
10942.885807,10942.903807,1,voc,328286574,328287114,540,spec2/voc/Bl122_328286574.jpg,Bl122,0
8962.856712,8962.997712,1,voc,268885701,268889931,4230,spec2/voc/Bl122_268885701.jpg,Bl122,0
14841.905682,14841.910682,1,voc,445257170,445257320,150,spec2/voc/Bl122_445257170.jpg,Bl122,0
5950.315256,5950.341256,1,voc,178509457,178510237,780,spec2/voc/Bl122_178509457.jpg,Bl122,0
10939.509807,10939.534807,1,voc,328185294,328186044,750,spec2/voc/Bl122_328185294.jpg,Bl122,0
3798.925649,3799.068649,1,voc,113967769,113972059,4290,spec2/voc/Bl122_113967769.jpg,Bl122,0
7986.343748,7986.356748,1,voc,239590312,239590702,390,spec2/voc/Bl122_239590312.jpg,Bl122,0
5978.550256,5978.556256,1,voc,179356507,179356687,180,spec2/voc/Bl122_179356507.jpg,Bl122,0
9013.385241,9013.422241,1,voc,270401557,270402667,1110,spec2/voc/Bl122_270401557.jpg,Bl122,0
6077.248705,6077.297705,1,voc,182317461,182318931,1470,spec2/voc/Bl122_182317461.jpg,Bl122,0
14732.572703,14732.630703,1,voc,441977181,441978921,1740,spec2/voc/Bl122_441977181.jpg,Bl122,0
6067.548705,6067.704705,1,voc,182026461,182031141,4680,spec2/voc/Bl122_182026461.jpg,Bl122,0
14822.055551,14822.062551,1,voc,444661666,444661876,210,spec2/voc/Bl122_444661666.jpg,Bl122,0
9108.552935,9108.562935,1,voc,273256588,273256888,300,spec2/voc/Bl122_273256588.jpg,Bl122,0
9076.784241,9076.792241,1,voc,272303527,272303767,240,spec2/voc/Bl122_272303527.jpg,Bl122,0
6169.578327,6169.653327,1,voc,185087349,185089599,2250,spec2/voc/Bl122_185087349.jpg,Bl122,0
7911.698748,7911.703748,1,voc,237350962,237351112,150,spec2/voc/Bl122_237350962.jpg,Bl122,0
13207.805389,13207.822389,1,voc,396234161,396234671,510,spec2/voc/Bl122_396234161.jpg,Bl122,0
10931.091807,10931.100807,1,voc,327932754,327933024,270,spec2/voc/Bl122_327932754.jpg,Bl122,0
9152.064842,9152.075842,1,voc,274561945,274562275,330,spec2/voc/Bl122_274561945.jpg,Bl122,0
7974.333748,7974.336748,1,voc,239230012,239230102,90,spec2/voc/Bl122_239230012.jpg,Bl122,0
8919.165773,8919.193773,1,voc,267574973,267575813,840,spec2/voc/Bl122_267574973.jpg,Bl122,0
8004.393748,8004.433748,1,voc,240131812,240133012,1200,spec2/voc/Bl122_240131812.jpg,Bl122,0
7907.694748,7907.699748,1,voc,237230842,237230992,150,spec2/voc/Bl122_237230842.jpg,Bl122,0
11188.44918,11188.51918,1,voc,335653475,335655575,2100,spec2/voc/Bl122_335653475.jpg,Bl122,0
7845.283748,7845.347748,1,voc,235358512,235360432,1920,spec2/voc/Bl122_235358512.jpg,Bl122,0
9023.727241,9023.758241,1,voc,270711817,270712747,930,spec2/voc/Bl122_270711817.jpg,Bl122,0
5944.535256,5944.566256,1,voc,178336057,178336987,930,spec2/voc/Bl122_178336057.jpg,Bl122,0
6205.113327,6205.224327,1,voc,186153399,186156729,3330,spec2/voc/Bl122_186153399.jpg,Bl122,0
5970.634256,5970.664256,1,voc,179119027,179119927,900,spec2/voc/Bl122_179119027.jpg,Bl122,0
7879.277748,7879.281748,1,voc,236378332,236378452,120,spec2/voc/Bl122_236378332.jpg,Bl122,0
10925.633807,10925.658807,1,voc,327769014,327769764,750,spec2/voc/Bl122_327769014.jpg,Bl122,0
5987.232256,5987.422256,1,voc,179616967,179622667,5700,spec2/voc/Bl122_179616967.jpg,Bl122,0
6090.15415,6090.16615,1,voc,182704624,182704984,360,spec2/voc/Bl122_182704624.jpg,Bl122,0
11148.43518,11148.44218,1,voc,334453055,334453265,210,spec2/voc/Bl122_334453055.jpg,Bl122,0
7976.522748,7976.529748,1,voc,239295682,239295892,210,spec2/voc/Bl122_239295682.jpg,Bl122,0
8913.190773,8913.217773,1,voc,267395723,267396533,810,spec2/voc/Bl122_267395723.jpg,Bl122,0
13946.109911,13946.230911,1,voc,418383297,418386927,3630,spec2/voc/Bl122_418383297.jpg,Bl122,0
14844.071682,14844.252682,1,voc,445322150,445327580,5430,spec2/voc/Bl122_445322150.jpg,Bl122,0
8964.346712,8964.472712,1,voc,268930401,268934181,3780,spec2/voc/Bl122_268930401.jpg,Bl122,0
7919.877748,7919.888748,1,voc,237596332,237596662,330,spec2/voc/Bl122_237596332.jpg,Bl122,0
7865.552748,7865.583748,1,voc,235966582,235967512,930,spec2/voc/Bl122_235966582.jpg,Bl122,0
14330.677456,14330.682456,1,voc,429920323,429920473,150,spec2/voc/Bl122_429920323.jpg,Bl122,0
7871.931748,7872.014748,1,voc,236157952,236160442,2490,spec2/voc/Bl122_236157952.jpg,Bl122,0
10885.647162,10886.062162,1,voc,326569414,326581864,12450,spec2/voc/Bl122_326569414.jpg,Bl122,0
10959.336807,10959.379807,1,voc,328780104,328781394,1290,spec2/voc/Bl122_328780104.jpg,Bl122,0
11898.461298,11898.465298,1,voc,356953838,356953958,120,spec2/voc/Bl122_356953838.jpg,Bl122,0
10963.985807,10963.996807,1,voc,328919574,328919904,330,spec2/voc/Bl122_328919574.jpg,Bl122,0
9091.204241,9091.388241,1,voc,272736127,272741647,5520,spec2/voc/Bl122_272736127.jpg,Bl122,0
7876.021748,7876.034748,1,voc,236280652,236281042,390,spec2/voc/Bl122_236280652.jpg,Bl122,0
3851.002415,3851.013415,1,voc,115530072,115530402,330,spec2/voc/Bl122_115530072.jpg,Bl122,0
6087.58115,6087.58815,1,voc,182627434,182627644,210,spec2/voc/Bl122_182627434.jpg,Bl122,0
8966.620712,8966.670712,1,voc,268998621,269000121,1500,spec2/voc/Bl122_268998621.jpg,Bl122,0
6148.630349,6148.667349,1,voc,184458910,184460020,1110,spec2/voc/Bl122_184458910.jpg,Bl122,0
13170.121701,13170.123701,1,voc,395103651,395103711,60,spec2/voc/Bl122_395103651.jpg,Bl122,0
9004.613241,9004.616241,1,voc,270138397,270138487,90,spec2/voc/Bl122_270138397.jpg,Bl122,0
14795.496551,14795.517551,1,voc,443864896,443865526,630,spec2/voc/Bl122_443864896.jpg,Bl122,0
6032.437533,6032.442533,1,voc,180973125,180973275,150,spec2/voc/Bl122_180973125.jpg,Bl122,0
8015.219748,8015.226748,1,voc,240456592,240456802,210,spec2/voc/Bl122_240456592.jpg,Bl122,0
9063.428241,9063.471241,1,voc,271902847,271904137,1290,spec2/voc/Bl122_271902847.jpg,Bl122,0
3839.621415,3839.650415,1,voc,115188642,115189512,870,spec2/voc/Bl122_115188642.jpg,Bl122,0
3811.227649,3811.242649,1,voc,114336829,114337279,450,spec2/voc/Bl122_114336829.jpg,Bl122,0
13826.65522,13826.65922,1,voc,414799656,414799776,120,spec2/voc/Bl122_414799656.jpg,Bl122,0
10939.665807,10939.667807,1,voc,328189974,328190034,60,spec2/voc/Bl122_328189974.jpg,Bl122,0
13172.332701,13172.345701,1,voc,395169981,395170371,390,spec2/voc/Bl122_395169981.jpg,Bl122,0
13639.018962,13639.349962,1,voc,409170568,409180498,9930,spec2/voc/Bl122_409170568.jpg,Bl122,0
9064.554241,9064.559241,1,voc,271936627,271936777,150,spec2/voc/Bl122_271936627.jpg,Bl122,0
6017.234533,6017.389533,1,voc,180517035,180521685,4650,spec2/voc/Bl122_180517035.jpg,Bl122,0
13823.69822,13823.71722,1,voc,414710946,414711516,570,spec2/voc/Bl122_414710946.jpg,Bl122,0
6012.345533,6012.486533,1,voc,180370365,180374595,4230,spec2/voc/Bl122_180370365.jpg,Bl122,0
8365.212015,8365.242015,1,voc,250956360,250957260,900,spec2/voc/Bl122_250956360.jpg,Bl122,0
6138.683293,6138.687293,1,voc,184160498,184160618,120,spec2/voc/Bl122_184160498.jpg,Bl122,0
8952.432967,8952.438967,1,voc,268572989,268573169,180,spec2/voc/Bl122_268572989.jpg,Bl122,0
8020.083748,8020.093748,1,voc,240602512,240602812,300,spec2/voc/Bl122_240602512.jpg,Bl122,0
6026.063533,6026.082533,1,voc,180781905,180782475,570,spec2/voc/Bl122_180781905.jpg,Bl122,0
5994.089256,5994.144256,1,voc,179822677,179824327,1650,spec2/voc/Bl122_179822677.jpg,Bl122,0
10875.383466,10875.447466,1,voc,326261503,326263423,1920,spec2/voc/Bl122_326261503.jpg,Bl122,0
7973.830748,7973.858748,1,voc,239214922,239215762,840,spec2/voc/Bl122_239214922.jpg,Bl122,0
12642.750333,12642.905333,1,voc,379282509,379287159,4650,spec2/voc/Bl122_379282509.jpg,Bl122,0
13169.986701,13169.999701,1,voc,395099601,395099991,390,spec2/voc/Bl122_395099601.jpg,Bl122,0
9026.083241,9026.090241,1,voc,270782497,270782707,210,spec2/voc/Bl122_270782497.jpg,Bl122,0
3814.650649,3814.778649,1,voc,114439519,114443359,3840,spec2/voc/Bl122_114439519.jpg,Bl122,0
11167.22518,11167.23918,1,voc,335016755,335017175,420,spec2/voc/Bl122_335016755.jpg,Bl122,0
11851.69973,11851.85973,1,voc,355550991,355555791,4800,spec2/voc/Bl122_355550991.jpg,Bl122,0
14004.345779,14004.348779,1,voc,420130373,420130463,90,spec2/voc/Bl122_420130373.jpg,Bl122,0
6188.729327,6188.775327,1,voc,185661879,185663259,1380,spec2/voc/Bl122_185661879.jpg,Bl122,0
9093.363241,9093.481241,1,voc,272800897,272804437,3540,spec2/voc/Bl122_272800897.jpg,Bl122,0
12640.571849,12640.645849,1,voc,379217155,379219375,2220,spec2/voc/Bl122_379217155.jpg,Bl122,0
8201.844005,8201.891005,1,voc,246055320,246056730,1410,spec2/voc/Bl122_246055320.jpg,Bl122,0
3864.461367,3864.471367,1,voc,115933841,115934141,300,spec2/voc/Bl122_115933841.jpg,Bl122,0
14838.225682,14838.231682,1,voc,445146770,445146950,180,spec2/voc/Bl122_445146770.jpg,Bl122,0
3865.165367,3865.170367,1,voc,115954961,115955111,150,spec2/voc/Bl122_115954961.jpg,Bl122,0
6050.3142,6050.3372,1,voc,181509426,181510116,690,spec2/voc/Bl122_181509426.jpg,Bl122,0
6042.4332,6042.4742,1,voc,181272996,181274226,1230,spec2/voc/Bl122_181272996.jpg,Bl122,0
14816.591551,14816.597551,1,voc,444497746,444497926,180,spec2/voc/Bl122_444497746.jpg,Bl122,0
11167.98118,11168.00518,1,voc,335039435,335040155,720,spec2/voc/Bl122_335039435.jpg,Bl122,0
7986.371748,7986.377748,1,voc,239591152,239591332,180,spec2/voc/Bl122_239591152.jpg,Bl122,0
11175.31118,11175.32318,1,voc,335259335,335259695,360,spec2/voc/Bl122_335259335.jpg,Bl122,0
7885.869748,7885.877748,1,voc,236576092,236576332,240,spec2/voc/Bl122_236576092.jpg,Bl122,0
6194.522327,6194.531327,1,voc,185835669,185835939,270,spec2/voc/Bl122_185835669.jpg,Bl122,0
6123.926706,6124.001706,1,voc,183717801,183720051,2250,spec2/voc/Bl122_183717801.jpg,Bl122,0
6118.427706,6118.433706,1,voc,183552831,183553011,180,spec2/voc/Bl122_183552831.jpg,Bl122,0
3896.283652,3896.356652,1,voc,116888509,116890699,2190,spec2/voc/Bl122_116888509.jpg,Bl122,0
8916.660773,8916.681773,1,voc,267499823,267500453,630,spec2/voc/Bl122_267499823.jpg,Bl122,0
13541.822816,13541.841816,1,voc,406254684,406255254,570,spec2/voc/Bl122_406254684.jpg,Bl122,0
12640.377849,12640.484849,1,voc,379211335,379214545,3210,spec2/voc/Bl122_379211335.jpg,Bl122,0
14841.649682,14841.720682,1,voc,445249490,445251620,2130,spec2/voc/Bl122_445249490.jpg,Bl122,0
13948.986911,13948.990911,1,voc,418469607,418469727,120,spec2/voc/Bl122_418469607.jpg,Bl122,0
8965.420712,8965.511712,1,voc,268962621,268965351,2730,spec2/voc/Bl122_268962621.jpg,Bl122,0
14805.763551,14805.796551,1,voc,444172906,444173896,990,spec2/voc/Bl122_444172906.jpg,Bl122,0
7912.275748,7912.330748,1,voc,237368272,237369922,1650,spec2/voc/Bl122_237368272.jpg,Bl122,0
5948.741256,5948.773256,1,voc,178462237,178463197,960,spec2/voc/Bl122_178462237.jpg,Bl122,0
3862.014367,3862.052367,1,voc,115860431,115861571,1140,spec2/voc/Bl122_115860431.jpg,Bl122,0
6060.701705,6060.713705,1,voc,181821051,181821411,360,spec2/voc/Bl122_181821051.jpg,Bl122,0
6119.845706,6120.082706,1,voc,183595371,183602481,7110,spec2/voc/Bl122_183595371.jpg,Bl122,0
3806.949649,3806.967649,1,voc,114208489,114209029,540,spec2/voc/Bl122_114208489.jpg,Bl122,0
8924.924773,8925.328773,1,voc,267747743,267759863,12120,spec2/voc/Bl122_267747743.jpg,Bl122,0
10945.625807,10945.665807,1,voc,328368774,328369974,1200,spec2/voc/Bl122_328368774.jpg,Bl122,0
13723.0849,13723.1169,1,voc,411692547,411693507,960,spec2/voc/Bl122_411692547.jpg,Bl122,0
7833.283748,7833.366748,1,voc,234998512,235001002,2490,spec2/voc/Bl122_234998512.jpg,Bl122,0
7901.843481,7901.918481,1,voc,237055304,237057554,2250,spec2/voc/Bl122_237055304.jpg,Bl122,0
5947.060256,5947.084256,1,voc,178411807,178412527,720,spec2/voc/Bl122_178411807.jpg,Bl122,0
13601.083736,13601.138736,1,voc,408032512,408034162,1650,spec2/voc/Bl122_408032512.jpg,Bl122,0
3821.123649,3821.220649,1,voc,114633709,114636619,2910,spec2/voc/Bl122_114633709.jpg,Bl122,0
3810.144649,3810.154649,1,voc,114304339,114304639,300,spec2/voc/Bl122_114304339.jpg,Bl122,0
11186.61418,11186.62718,1,voc,335598425,335598815,390,spec2/voc/Bl122_335598425.jpg,Bl122,0
10937.519807,10937.533807,1,voc,328125594,328126014,420,spec2/voc/Bl122_328125594.jpg,Bl122,0
5979.994256,5980.035256,1,voc,179399827,179401057,1230,spec2/voc/Bl122_179399827.jpg,Bl122,0
13808.925653,13809.015653,1,voc,414267769,414270469,2700,spec2/voc/Bl122_414267769.jpg,Bl122,0
9079.465241,9079.474241,1,voc,272383957,272384227,270,spec2/voc/Bl122_272383957.jpg,Bl122,0
10842.205842,10842.227842,1,voc,325266175,325266835,660,spec2/voc/Bl122_325266175.jpg,Bl122,0
7869.186748,7869.190748,1,voc,236075602,236075722,120,spec2/voc/Bl122_236075602.jpg,Bl122,0
11186.90318,11186.91618,1,voc,335607095,335607485,390,spec2/voc/Bl122_335607095.jpg,Bl122,0
6197.255327,6197.577327,1,voc,185917659,185927319,9660,spec2/voc/Bl122_185917659.jpg,Bl122,0
7844.173748,7844.210748,1,voc,235325212,235326322,1110,spec2/voc/Bl122_235325212.jpg,Bl122,0
13945.805911,13945.812911,1,voc,418374177,418374387,210,spec2/voc/Bl122_418374177.jpg,Bl122,0
3817.912649,3817.918649,1,voc,114537379,114537559,180,spec2/voc/Bl122_114537379.jpg,Bl122,0
13938.6889,13938.7629,1,voc,418160667,418162887,2220,spec2/voc/Bl122_418160667.jpg,Bl122,0
8997.368241,8997.394241,1,voc,269921047,269921827,780,spec2/voc/Bl122_269921047.jpg,Bl122,0
9053.826241,9054.139241,1,voc,271614787,271624177,9390,spec2/voc/Bl122_271614787.jpg,Bl122,0
14811.666551,14811.922551,1,voc,444349996,444357676,7680,spec2/voc/Bl122_444349996.jpg,Bl122,0
12598.379308,12598.382308,1,voc,377951379,377951469,90,spec2/voc/Bl122_377951379.jpg,Bl122,0
11211.416894,11211.423894,1,voc,336342506,336342716,210,spec2/voc/Bl122_336342506.jpg,Bl122,0
8993.696241,8993.703241,1,voc,269810887,269811097,210,spec2/voc/Bl122_269810887.jpg,Bl122,0
6027.192533,6027.234533,1,voc,180815775,180817035,1260,spec2/voc/Bl122_180815775.jpg,Bl122,0
9070.161241,9070.286241,1,voc,272104837,272108587,3750,spec2/voc/Bl122_272104837.jpg,Bl122,0
13966.759352,13966.913352,1,voc,419002780,419007400,4620,spec2/voc/Bl122_419002780.jpg,Bl122,0
11130.963005,11131.163005,1,voc,333928890,333934890,6000,spec2/voc/Bl122_333928890.jpg,Bl122,0
11130.954005,11130.961005,1,voc,333928620,333928830,210,spec2/voc/Bl122_333928620.jpg,Bl122,0
9033.310241,9033.334241,1,voc,270999307,271000027,720,spec2/voc/Bl122_270999307.jpg,Bl122,0
7990.335748,7990.342748,1,voc,239710072,239710282,210,spec2/voc/Bl122_239710072.jpg,Bl122,0
5982.379256,5982.681256,1,voc,179471377,179480437,9060,spec2/voc/Bl122_179471377.jpg,Bl122,0
6173.996327,6174.033327,1,voc,185219889,185220999,1110,spec2/voc/Bl122_185219889.jpg,Bl122,0
7860.773748,7860.793748,1,voc,235823212,235823812,600,spec2/voc/Bl122_235823212.jpg,Bl122,0
6222.136295,6222.157295,1,voc,186664088,186664718,630,spec2/voc/Bl122_186664088.jpg,Bl122,0
10917.198807,10917.313807,1,voc,327515964,327519414,3450,spec2/voc/Bl122_327515964.jpg,Bl122,0
9128.322981,9128.326981,1,voc,273849689,273849809,120,spec2/voc/Bl122_273849689.jpg,Bl122,0
9027.759241,9027.816241,1,voc,270832777,270834487,1710,spec2/voc/Bl122_270832777.jpg,Bl122,0
11174.68318,11174.90018,1,voc,335240495,335247005,6510,spec2/voc/Bl122_335240495.jpg,Bl122,0
3840.938415,3841.003415,1,voc,115228152,115230102,1950,spec2/voc/Bl122_115228152.jpg,Bl122,0
10932.071807,10932.100807,1,voc,327962154,327963024,870,spec2/voc/Bl122_327962154.jpg,Bl122,0
6141.303349,6141.372349,1,voc,184239100,184241170,2070,spec2/voc/Bl122_184239100.jpg,Bl122,0
11167.05518,11167.12318,1,voc,335011655,335013695,2040,spec2/voc/Bl122_335011655.jpg,Bl122,0
9036.540241,9036.545241,1,voc,271096207,271096357,150,spec2/voc/Bl122_271096207.jpg,Bl122,0
6224.664295,6224.720295,1,voc,186739928,186741608,1680,spec2/voc/Bl122_186739928.jpg,Bl122,0
13817.441617,13817.445617,1,voc,414523248,414523368,120,spec2/voc/Bl122_414523248.jpg,Bl122,0
14321.812978,14321.816978,1,voc,429654389,429654509,120,spec2/voc/Bl122_429654389.jpg,Bl122,0
14801.989551,14802.009551,1,voc,444059686,444060286,600,spec2/voc/Bl122_444059686.jpg,Bl122,0
10917.939807,10917.961807,1,voc,327538194,327538854,660,spec2/voc/Bl122_327538194.jpg,Bl122,0
3803.105649,3803.171649,1,voc,114093169,114095149,1980,spec2/voc/Bl122_114093169.jpg,Bl122,0
7908.998748,7909.003748,1,voc,237269962,237270112,150,spec2/voc/Bl122_237269962.jpg,Bl122,0
11189.39018,11189.41918,1,voc,335681705,335682575,870,spec2/voc/Bl122_335681705.jpg,Bl122,0
7820.822748,7820.830748,1,voc,234624682,234624922,240,spec2/voc/Bl122_234624682.jpg,Bl122,0
11193.45618,11193.56018,1,voc,335803685,335806805,3120,spec2/voc/Bl122_335803685.jpg,Bl122,0
11130.300005,11130.324005,1,voc,333909000,333909720,720,spec2/voc/Bl122_333909000.jpg,Bl122,0
10930.440807,10930.449807,1,voc,327913224,327913494,270,spec2/voc/Bl122_327913224.jpg,Bl122,0
5972.036256,5972.039256,1,voc,179161087,179161177,90,spec2/voc/Bl122_179161087.jpg,Bl122,0
9141.847757,9142.062757,1,voc,274255432,274261882,6450,spec2/voc/Bl122_274255432.jpg,Bl122,0
13723.1419,13723.1969,1,voc,411694257,411695907,1650,spec2/voc/Bl122_411694257.jpg,Bl122,0
13192.005662,13192.062662,1,voc,395760169,395761879,1710,spec2/voc/Bl122_395760169.jpg,Bl122,0
8208.244882,8208.246882,1,voc,246247346,246247406,60,spec2/voc/Bl122_246247346.jpg,Bl122,0
11155.43618,11155.66418,1,voc,334663085,334669925,6840,spec2/voc/Bl122_334663085.jpg,Bl122,0
3822.236649,3822.242649,1,voc,114667099,114667279,180,spec2/voc/Bl122_114667099.jpg,Bl122,0
7920.091748,7920.094748,1,voc,237602752,237602842,90,spec2/voc/Bl122_237602752.jpg,Bl122,0
6049.3752,6049.4802,1,voc,181481256,181484406,3150,spec2/voc/Bl122_181481256.jpg,Bl122,0
6033.565533,6033.571533,1,voc,181006965,181007145,180,spec2/voc/Bl122_181006965.jpg,Bl122,0
3791.609649,3791.863649,1,voc,113748289,113755909,7620,spec2/voc/Bl122_113748289.jpg,Bl122,0
13209.046389,13209.246389,1,voc,396271391,396277391,6000,spec2/voc/Bl122_396271391.jpg,Bl122,0
13938.3479,13938.5179,1,voc,418150437,418155537,5100,spec2/voc/Bl122_418150437.jpg,Bl122,0
5995.376256,5995.712256,1,voc,179861287,179871367,10080,spec2/voc/Bl122_179861287.jpg,Bl122,0
10913.080807,10913.237807,1,voc,327392424,327397134,4710,spec2/voc/Bl122_327392424.jpg,Bl122,0
6011.021533,6011.029533,1,voc,180330645,180330885,240,spec2/voc/Bl122_180330645.jpg,Bl122,0
3892.344652,3892.706652,1,voc,116770339,116781199,10860,spec2/voc/Bl122_116770339.jpg,Bl122,0
8025.925748,8025.930748,1,voc,240777772,240777922,150,spec2/voc/Bl122_240777772.jpg,Bl122,0
13218.880389,13219.030389,1,voc,396566411,396570911,4500,spec2/voc/Bl122_396566411.jpg,Bl122,0
14183.933102,14183.992102,1,voc,425517993,425519763,1770,spec2/voc/Bl122_425517993.jpg,Bl122,0
8978.876025,8979.143025,1,voc,269366280,269374290,8010,spec2/voc/Bl122_269366280.jpg,Bl122,0
7908.835748,7908.843748,1,voc,237265072,237265312,240,spec2/voc/Bl122_237265072.jpg,Bl122,0
5954.826256,5954.831256,1,voc,178644787,178644937,150,spec2/voc/Bl122_178644787.jpg,Bl122,0
11867.584011,11867.590011,1,voc,356027520,356027700,180,spec2/voc/Bl122_356027520.jpg,Bl122,0
9071.977241,9072.192241,1,voc,272159317,272165767,6450,spec2/voc/Bl122_272159317.jpg,Bl122,0
3881.462062,3881.548062,1,voc,116443861,116446441,2580,spec2/voc/Bl122_116443861.jpg,Bl122,0
10963.969807,10963.977807,1,voc,328919094,328919334,240,spec2/voc/Bl122_328919094.jpg,Bl122,0
8040.817748,8040.832748,1,voc,241224532,241224982,450,spec2/voc/Bl122_241224532.jpg,Bl122,0
13581.997236,13582.037236,1,voc,407459917,407461117,1200,spec2/voc/Bl122_407459917.jpg,Bl122,0
6208.389327,6208.414327,1,voc,186251679,186252429,750,spec2/voc/Bl122_186251679.jpg,Bl122,0
14841.929682,14842.016682,1,voc,445257890,445260500,2610,spec2/voc/Bl122_445257890.jpg,Bl122,0
5956.198256,5956.219256,1,voc,178685947,178686577,630,spec2/voc/Bl122_178685947.jpg,Bl122,0
9099.021241,9099.046241,1,voc,272970637,272971387,750,spec2/voc/Bl122_272970637.jpg,Bl122,0
9094.030241,9094.099241,1,voc,272820907,272822977,2070,spec2/voc/Bl122_272820907.jpg,Bl122,0
6150.103349,6150.371349,1,voc,184503100,184511140,8040,spec2/voc/Bl122_184503100.jpg,Bl122,0
10914.834807,10914.887807,1,voc,327445044,327446634,1590,spec2/voc/Bl122_327445044.jpg,Bl122,0
6097.02315,6097.03215,1,voc,182910694,182910964,270,spec2/voc/Bl122_182910694.jpg,Bl122,0
6087.91315,6087.97915,1,voc,182637394,182639374,1980,spec2/voc/Bl122_182637394.jpg,Bl122,0
5978.918256,5978.920256,1,voc,179367547,179367607,60,spec2/voc/Bl122_179367547.jpg,Bl122,0
5964.343256,5964.350256,1,voc,178930297,178930507,210,spec2/voc/Bl122_178930297.jpg,Bl122,0
6047.4662,6047.4702,1,voc,181423986,181424106,120,spec2/voc/Bl122_181423986.jpg,Bl122,0
6205.644327,6205.851327,1,voc,186169329,186175539,6210,spec2/voc/Bl122_186169329.jpg,Bl122,0
6083.26615,6083.30515,1,voc,182497984,182499154,1170,spec2/voc/Bl122_182497984.jpg,Bl122,0
8361.128263,8361.218263,1,voc,250833847,250836547,2700,spec2/voc/Bl122_250833847.jpg,Bl122,0
11033.043132,11033.102132,1,voc,330991293,330993063,1770,spec2/voc/Bl122_330991293.jpg,Bl122,0
13968.139352,13968.146352,1,voc,419044180,419044390,210,spec2/voc/Bl122_419044180.jpg,Bl122,0
6195.368327,6195.475327,1,voc,185861049,185864259,3210,spec2/voc/Bl122_185861049.jpg,Bl122,0
13541.843816,13541.849816,1,voc,406255314,406255494,180,spec2/voc/Bl122_406255314.jpg,Bl122,0
7988.511748,7988.540748,1,voc,239655352,239656222,870,spec2/voc/Bl122_239655352.jpg,Bl122,0
13180.050701,13180.072701,1,voc,395401521,395402181,660,spec2/voc/Bl122_395401521.jpg,Bl122,0
10862.955845,10863.047845,1,voc,325888675,325891435,2760,spec2/voc/Bl122_325888675.jpg,Bl122,0
6083.19815,6083.20615,1,voc,182495944,182496184,240,spec2/voc/Bl122_182495944.jpg,Bl122,0
8015.700748,8015.712748,1,voc,240471022,240471382,360,spec2/voc/Bl122_240471022.jpg,Bl122,0
13171.112701,13171.114701,1,voc,395133381,395133441,60,spec2/voc/Bl122_395133381.jpg,Bl122,0
7785.785748,7785.791748,1,voc,233573572,233573752,180,spec2/voc/Bl122_233573572.jpg,Bl122,0
5959.638256,5959.669256,1,voc,178789147,178790077,930,spec2/voc/Bl122_178789147.jpg,Bl122,0
8966.529712,8966.555712,1,voc,268995891,268996671,780,spec2/voc/Bl122_268995891.jpg,Bl122,0
14791.875551,14791.939551,1,voc,443756266,443758186,1920,spec2/voc/Bl122_443756266.jpg,Bl122,0
9085.250241,9085.484241,1,voc,272557507,272564527,7020,spec2/voc/Bl122_272557507.jpg,Bl122,0
11205.423894,11205.477894,1,voc,336162716,336164336,1620,spec2/voc/Bl122_336162716.jpg,Bl122,0
5961.914256,5961.921256,1,voc,178857427,178857637,210,spec2/voc/Bl122_178857427.jpg,Bl122,0
14703.523546,14703.663546,1,voc,441105706,441109906,4200,spec2/voc/Bl122_441105706.jpg,Bl122,0
6133.826293,6133.897293,1,voc,184014788,184016918,2130,spec2/voc/Bl122_184014788.jpg,Bl122,0
6190.301327,6190.537327,1,voc,185709039,185716119,7080,spec2/voc/Bl122_185709039.jpg,Bl122,0
11164.37518,11164.41418,1,voc,334931255,334932425,1170,spec2/voc/Bl122_334931255.jpg,Bl122,0
6020.420533,6020.540533,1,voc,180612615,180616215,3600,spec2/voc/Bl122_180612615.jpg,Bl122,0
5941.621256,5941.633256,1,voc,178248637,178248997,360,spec2/voc/Bl122_178248637.jpg,Bl122,0
3796.733649,3796.760649,1,voc,113902009,113902819,810,spec2/voc/Bl122_113902009.jpg,Bl122,0
10885.080162,10885.159162,1,voc,326552404,326554774,2370,spec2/voc/Bl122_326552404.jpg,Bl122,0
6063.519705,6063.523705,1,voc,181905591,181905711,120,spec2/voc/Bl122_181905591.jpg,Bl122,0
3814.443649,3814.563649,1,voc,114433309,114436909,3600,spec2/voc/Bl122_114433309.jpg,Bl122,0
7912.065748,7912.073748,1,voc,237361972,237362212,240,spec2/voc/Bl122_237361972.jpg,Bl122,0
6023.036533,6023.043533,1,voc,180691095,180691305,210,spec2/voc/Bl122_180691095.jpg,Bl122,0
7952.222748,7952.266748,1,voc,238566682,238568002,1320,spec2/voc/Bl122_238566682.jpg,Bl122,0
10919.573807,10919.581807,1,voc,327587214,327587454,240,spec2/voc/Bl122_327587214.jpg,Bl122,0
8304.578054,8304.929054,1,voc,249137341,249147871,10530,spec2/voc/Bl122_249137341.jpg,Bl122,0
11142.050955,11142.210955,1,voc,334261528,334266328,4800,spec2/voc/Bl122_334261528.jpg,Bl122,0
9057.519241,9057.531241,1,voc,271725577,271725937,360,spec2/voc/Bl122_271725577.jpg,Bl122,0
3047.927903,3048.089903,1,voc,91437837,91442697,4860,spec2/voc/Bl122_91437837.jpg,Bl122,0
11125.595005,11125.667005,1,voc,333767850,333770010,2160,spec2/voc/Bl122_333767850.jpg,Bl122,0
6176.890327,6176.986327,1,voc,185306709,185309589,2880,spec2/voc/Bl122_185306709.jpg,Bl122,0
9107.826935,9108.070935,1,voc,273234808,273242128,7320,spec2/voc/Bl122_273234808.jpg,Bl122,0
6045.4722,6045.4852,1,voc,181364166,181364556,390,spec2/voc/Bl122_181364166.jpg,Bl122,0
13191.504662,13191.512662,1,voc,395745139,395745379,240,spec2/voc/Bl122_395745139.jpg,Bl122,0
11208.024894,11208.062894,1,voc,336240746,336241886,1140,spec2/voc/Bl122_336240746.jpg,Bl122,0
6051.7992,6051.8112,1,voc,181553976,181554336,360,spec2/voc/Bl122_181553976.jpg,Bl122,0
3831.204649,3831.208649,1,voc,114936139,114936259,120,spec2/voc/Bl122_114936139.jpg,Bl122,0
9098.433241,9098.436241,1,voc,272952997,272953087,90,spec2/voc/Bl122_272952997.jpg,Bl122,0
13927.717536,13927.746536,1,voc,417831526,417832396,870,spec2/voc/Bl122_417831526.jpg,Bl122,0
6102.006706,6102.013706,1,voc,183060201,183060411,210,spec2/voc/Bl122_183060201.jpg,Bl122,0
13824.33322,13824.44022,1,voc,414729996,414733206,3210,spec2/voc/Bl122_414729996.jpg,Bl122,0
13580.516236,13580.526236,1,voc,407415487,407415787,300,spec2/voc/Bl122_407415487.jpg,Bl122,0
8924.373773,8924.418773,1,voc,267731213,267732563,1350,spec2/voc/Bl122_267731213.jpg,Bl122,0
11178.01318,11178.11418,1,voc,335340395,335343425,3030,spec2/voc/Bl122_335340395.jpg,Bl122,0
6043.6472,6043.6802,1,voc,181309416,181310406,990,spec2/voc/Bl122_181309416.jpg,Bl122,0
9089.267241,9089.280241,1,voc,272678017,272678407,390,spec2/voc/Bl122_272678017.jpg,Bl122,0
6228.144295,6228.164295,1,voc,186844328,186844928,600,spec2/voc/Bl122_186844328.jpg,Bl122,0
5943.806256,5944.022256,1,voc,178314187,178320667,6480,spec2/voc/Bl122_178314187.jpg,Bl122,0
3846.559415,3846.592415,1,voc,115396782,115397772,990,spec2/voc/Bl122_115396782.jpg,Bl122,0
9097.880241,9097.917241,1,voc,272936407,272937517,1110,spec2/voc/Bl122_272936407.jpg,Bl122,0
3852.429415,3852.434415,1,voc,115572882,115573032,150,spec2/voc/Bl122_115572882.jpg,Bl122,0
13218.833389,13218.846389,1,voc,396565001,396565391,390,spec2/voc/Bl122_396565001.jpg,Bl122,0
12678.54817,12678.55217,1,voc,380356445,380356565,120,spec2/voc/Bl122_380356445.jpg,Bl122,0
5971.417256,5971.420256,1,voc,179142517,179142607,90,spec2/voc/Bl122_179142517.jpg,Bl122,0
7968.412748,7968.417748,1,voc,239052382,239052532,150,spec2/voc/Bl122_239052382.jpg,Bl122,0
6124.871706,6124.875706,1,voc,183746151,183746271,120,spec2/voc/Bl122_183746151.jpg,Bl122,0
6004.461256,6004.516256,1,voc,180133837,180135487,1650,spec2/voc/Bl122_180133837.jpg,Bl122,0
11160.14218,11160.37618,1,voc,334804265,334811285,7020,spec2/voc/Bl122_334804265.jpg,Bl122,0
7879.992748,7879.999748,1,voc,236399782,236399992,210,spec2/voc/Bl122_236399782.jpg,Bl122,0
13967.346352,13967.350352,1,voc,419020390,419020510,120,spec2/voc/Bl122_419020390.jpg,Bl122,0
5997.831256,5997.836256,1,voc,179934937,179935087,150,spec2/voc/Bl122_179934937.jpg,Bl122,0
6068.548705,6068.606705,1,voc,182056461,182058201,1740,spec2/voc/Bl122_182056461.jpg,Bl122,0
11179.18218,11179.18718,1,voc,335375465,335375615,150,spec2/voc/Bl122_335375465.jpg,Bl122,0
10936.380807,10936.395807,1,voc,328091424,328091874,450,spec2/voc/Bl122_328091424.jpg,Bl122,0
14803.539551,14803.633551,1,voc,444106186,444109006,2820,spec2/voc/Bl122_444106186.jpg,Bl122,0
13163.802891,13163.809891,1,voc,394914086,394914296,210,spec2/voc/Bl122_394914086.jpg,Bl122,0
8937.017967,8937.113967,1,voc,268110539,268113419,2880,spec2/voc/Bl122_268110539.jpg,Bl122,0
13580.529236,13580.541236,1,voc,407415877,407416237,360,spec2/voc/Bl122_407415877.jpg,Bl122,0
5946.963256,5946.969256,1,voc,178408897,178409077,180,spec2/voc/Bl122_178408897.jpg,Bl122,0
9192.91398,9192.91898,1,voc,275787419,275787569,150,spec2/voc/Bl122_275787419.jpg,Bl122,0
13206.251389,13206.281389,1,voc,396187541,396188441,900,spec2/voc/Bl122_396187541.jpg,Bl122,0
7968.304748,7968.320748,1,voc,239049142,239049622,480,spec2/voc/Bl122_239049142.jpg,Bl122,0
9003.793241,9003.827241,1,voc,270113797,270114817,1020,spec2/voc/Bl122_270113797.jpg,Bl122,0
9151.109842,9151.191842,1,voc,274533295,274535755,2460,spec2/voc/Bl122_274533295.jpg,Bl122,0
3045.063066,3045.066066,1,voc,91351891,91351981,90,spec2/voc/Bl122_91351891.jpg,Bl122,0
12939.382352,12939.407352,1,voc,388181470,388182220,750,spec2/voc/Bl122_388181470.jpg,Bl122,0
7871.282748,7871.316748,1,voc,236138482,236139502,1020,spec2/voc/Bl122_236138482.jpg,Bl122,0
6061.300705,6061.314705,1,voc,181839021,181839441,420,spec2/voc/Bl122_181839021.jpg,Bl122,0
13207.877389,13207.891389,1,voc,396236321,396236741,420,spec2/voc/Bl122_396236321.jpg,Bl122,0
9096.189241,9096.194241,1,voc,272885677,272885827,150,spec2/voc/Bl122_272885677.jpg,Bl122,0
12678.83617,12678.89117,1,voc,380365085,380366735,1650,spec2/voc/Bl122_380365085.jpg,Bl122,0
8015.373748,8015.387748,1,voc,240461212,240461632,420,spec2/voc/Bl122_240461212.jpg,Bl122,0
6169.479327,6169.482327,1,voc,185084379,185084469,90,spec2/voc/Bl122_185084379.jpg,Bl122,0
10921.949807,10922.458807,1,voc,327658494,327673764,15270,spec2/voc/Bl122_327658494.jpg,Bl122,0
6029.533533,6029.536533,1,voc,180886005,180886095,90,spec2/voc/Bl122_180886005.jpg,Bl122,0
3797.849649,3797.856649,1,voc,113935489,113935699,210,spec2/voc/Bl122_113935489.jpg,Bl122,0
8367.525166,8367.565166,1,voc,251025754,251026954,1200,spec2/voc/Bl122_251025754.jpg,Bl122,0
3875.370848,3875.604848,1,voc,116261125,116268145,7020,spec2/voc/Bl122_116261125.jpg,Bl122,0
9001.073241,9001.084241,1,voc,270032197,270032527,330,spec2/voc/Bl122_270032197.jpg,Bl122,0
6035.399533,6035.402533,1,voc,181061985,181062075,90,spec2/voc/Bl122_181061985.jpg,Bl122,0
13818.475617,13818.506617,1,voc,414554268,414555198,930,spec2/voc/Bl122_414554268.jpg,Bl122,0
6096.81515,6096.82015,1,voc,182904454,182904604,150,spec2/voc/Bl122_182904454.jpg,Bl122,0
10949.335807,10949.479807,1,voc,328480074,328484394,4320,spec2/voc/Bl122_328480074.jpg,Bl122,0
9045.784241,9045.790241,1,voc,271373527,271373707,180,spec2/voc/Bl122_271373527.jpg,Bl122,0
11209.058894,11209.063894,1,voc,336271766,336271916,150,spec2/voc/Bl122_336271766.jpg,Bl122,0
5950.783256,5950.790256,1,voc,178523497,178523707,210,spec2/voc/Bl122_178523497.jpg,Bl122,0
12673.015513,12673.030513,1,voc,380190465,380190915,450,spec2/voc/Bl122_380190465.jpg,Bl122,0
9054.633241,9054.669241,1,voc,271638997,271640077,1080,spec2/voc/Bl122_271638997.jpg,Bl122,0
7854.299748,7854.305748,1,voc,235628992,235629172,180,spec2/voc/Bl122_235628992.jpg,Bl122,0
5997.069256,5997.091256,1,voc,179912077,179912737,660,spec2/voc/Bl122_179912077.jpg,Bl122,0
6047.7012,6047.7272,1,voc,181431036,181431816,780,spec2/voc/Bl122_181431036.jpg,Bl122,0
7842.171748,7842.174748,1,voc,235265152,235265242,90,spec2/voc/Bl122_235265152.jpg,Bl122,0
5972.816256,5972.820256,1,voc,179184487,179184607,120,spec2/voc/Bl122_179184487.jpg,Bl122,0
5986.023256,5986.054256,1,voc,179580697,179581627,930,spec2/voc/Bl122_179580697.jpg,Bl122,0
6092.75015,6092.77715,1,voc,182782504,182783314,810,spec2/voc/Bl122_182782504.jpg,Bl122,0
5950.286256,5950.298256,1,voc,178508587,178508947,360,spec2/voc/Bl122_178508587.jpg,Bl122,0
7940.813748,7940.817748,1,voc,238224412,238224532,120,spec2/voc/Bl122_238224412.jpg,Bl122,0
7973.542748,7973.546748,1,voc,239206282,239206402,120,spec2/voc/Bl122_239206282.jpg,Bl122,0
7945.512748,7945.535748,1,voc,238365382,238366072,690,spec2/voc/Bl122_238365382.jpg,Bl122,0
5989.105256,5989.119256,1,voc,179673157,179673577,420,spec2/voc/Bl122_179673157.jpg,Bl122,0
11147.91418,11148.01718,1,voc,334437425,334440515,3090,spec2/voc/Bl122_334437425.jpg,Bl122,0
10880.278609,10880.409609,1,voc,326408358,326412288,3930,spec2/voc/Bl122_326408358.jpg,Bl122,0
6071.381705,6071.387705,1,voc,182141451,182141631,180,spec2/voc/Bl122_182141451.jpg,Bl122,0
9064.585241,9064.598241,1,voc,271937557,271937947,390,spec2/voc/Bl122_271937557.jpg,Bl122,0
13946.845911,13946.862911,1,voc,418405377,418405887,510,spec2/voc/Bl122_418405377.jpg,Bl122,0
8213.870724,8213.942724,1,voc,246416121,246418281,2160,spec2/voc/Bl122_246416121.jpg,Bl122,0
7983.498748,7983.507748,1,voc,239504962,239505232,270,spec2/voc/Bl122_239504962.jpg,Bl122,0
5978.344256,5978.426256,1,voc,179350327,179352787,2460,spec2/voc/Bl122_179350327.jpg,Bl122,0
7779.727748,7779.731748,1,voc,233391832,233391952,120,spec2/voc/Bl122_233391832.jpg,Bl122,0
13220.984389,13221.000389,1,voc,396629531,396630011,480,spec2/voc/Bl122_396629531.jpg,Bl122,0
11127.814005,11127.851005,1,voc,333834420,333835530,1110,spec2/voc/Bl122_333834420.jpg,Bl122,0
10959.009807,10959.023807,1,voc,328770294,328770714,420,spec2/voc/Bl122_328770294.jpg,Bl122,0
11169.93018,11169.96018,1,voc,335097905,335098805,900,spec2/voc/Bl122_335097905.jpg,Bl122,0
5956.094256,5956.104256,1,voc,178682827,178683127,300,spec2/voc/Bl122_178682827.jpg,Bl122,0
13221.251389,13221.255389,1,voc,396637541,396637661,120,spec2/voc/Bl122_396637541.jpg,Bl122,0
9095.189241,9095.206241,1,voc,272855677,272856187,510,spec2/voc/Bl122_272855677.jpg,Bl122,0
7994.673748,7994.677748,1,voc,239840212,239840332,120,spec2/voc/Bl122_239840212.jpg,Bl122,0
5944.150256,5944.156256,1,voc,178324507,178324687,180,spec2/voc/Bl122_178324507.jpg,Bl122,0
6078.213705,6078.216705,1,voc,182346411,182346501,90,spec2/voc/Bl122_182346411.jpg,Bl122,0
6051.3722,6051.3942,1,voc,181541166,181541826,660,spec2/voc/Bl122_181541166.jpg,Bl122,0
3799.148649,3799.385649,1,voc,113974459,113981569,7110,spec2/voc/Bl122_113974459.jpg,Bl122,0
6160.636349,6160.639349,1,voc,184819090,184819180,90,spec2/voc/Bl122_184819090.jpg,Bl122,0
14782.104844,14782.184844,1,voc,443463145,443465545,2400,spec2/voc/Bl122_443463145.jpg,Bl122,0
9021.284241,9021.434241,1,voc,270638527,270643027,4500,spec2/voc/Bl122_270638527.jpg,Bl122,0
9057.722241,9057.726241,1,voc,271731667,271731787,120,spec2/voc/Bl122_271731667.jpg,Bl122,0
10935.747807,10935.768807,1,voc,328072434,328073064,630,spec2/voc/Bl122_328072434.jpg,Bl122,0
9062.791241,9062.794241,1,voc,271883737,271883827,90,spec2/voc/Bl122_271883737.jpg,Bl122,0
7922.518748,7922.532748,1,voc,237675562,237675982,420,spec2/voc/Bl122_237675562.jpg,Bl122,0
13816.734617,13816.740617,1,voc,414502038,414502218,180,spec2/voc/Bl122_414502038.jpg,Bl122,0
14816.611551,14816.789551,1,voc,444498346,444503686,5340,spec2/voc/Bl122_444498346.jpg,Bl122,0
6047.5162,6047.6002,1,voc,181425486,181428006,2520,spec2/voc/Bl122_181425486.jpg,Bl122,0
9087.433241,9087.697241,1,voc,272622997,272630917,7920,spec2/voc/Bl122_272622997.jpg,Bl122,0
8916.223773,8916.242773,1,voc,267486713,267487283,570,spec2/voc/Bl122_267486713.jpg,Bl122,0
5972.203256,5972.207256,1,voc,179166097,179166217,120,spec2/voc/Bl122_179166097.jpg,Bl122,0
9020.871241,9020.883241,1,voc,270626137,270626497,360,spec2/voc/Bl122_270626137.jpg,Bl122,0
6144.406349,6144.413349,1,voc,184332190,184332400,210,spec2/voc/Bl122_184332190.jpg,Bl122,0
10940.874807,10941.070807,1,voc,328226244,328232124,5880,spec2/voc/Bl122_328226244.jpg,Bl122,0
6146.285349,6146.342349,1,voc,184388560,184390270,1710,spec2/voc/Bl122_184388560.jpg,Bl122,0
13789.93946,13789.94546,1,voc,413698183,413698363,180,spec2/voc/Bl122_413698183.jpg,Bl122,0
6108.774706,6108.783706,1,voc,183263241,183263511,270,spec2/voc/Bl122_183263241.jpg,Bl122,0
11173.14618,11173.18318,1,voc,335194385,335195495,1110,spec2/voc/Bl122_335194385.jpg,Bl122,0
6144.394349,6144.398349,1,voc,184331830,184331950,120,spec2/voc/Bl122_184331830.jpg,Bl122,0
9024.004241,9024.254241,1,voc,270720127,270727627,7500,spec2/voc/Bl122_270720127.jpg,Bl122,0
11979.219586,11979.443586,1,voc,359376587,359383307,6720,spec2/voc/Bl122_359376587.jpg,Bl122,0
11151.64418,11151.65618,1,voc,334549325,334549685,360,spec2/voc/Bl122_334549325.jpg,Bl122,0
13580.328236,13580.330236,1,voc,407409847,407409907,60,spec2/voc/Bl122_407409847.jpg,Bl122,0
10909.552807,10909.674807,1,voc,327286584,327290244,3660,spec2/voc/Bl122_327286584.jpg,Bl122,0
11201.767894,11201.850894,1,voc,336053036,336055526,2490,spec2/voc/Bl122_336053036.jpg,Bl122,0
6147.092349,6147.128349,1,voc,184412770,184413850,1080,spec2/voc/Bl122_184412770.jpg,Bl122,0
3796.464649,3796.569649,1,voc,113893939,113897089,3150,spec2/voc/Bl122_113893939.jpg,Bl122,0
9058.571241,9058.574241,1,voc,271757137,271757227,90,spec2/voc/Bl122_271757137.jpg,Bl122,0
13960.415384,13960.440384,1,voc,418812461,418813211,750,spec2/voc/Bl122_418812461.jpg,Bl122,0
13939.2579,13939.2619,1,voc,418177737,418177857,120,spec2/voc/Bl122_418177737.jpg,Bl122,0
3053.390288,3053.518288,1,voc,91601708,91605548,3840,spec2/voc/Bl122_91601708.jpg,Bl122,0
14166.676536,14166.897536,1,voc,425000296,425006926,6630,spec2/voc/Bl122_425000296.jpg,Bl122,0
5973.350256,5973.359256,1,voc,179200507,179200777,270,spec2/voc/Bl122_179200507.jpg,Bl122,0
8019.589748,8019.591748,1,voc,240587692,240587752,60,spec2/voc/Bl122_240587692.jpg,Bl122,0
10953.831807,10953.873807,1,voc,328614954,328616214,1260,spec2/voc/Bl122_328614954.jpg,Bl122,0
11157.33618,11157.34018,1,voc,334720085,334720205,120,spec2/voc/Bl122_334720085.jpg,Bl122,0
14201.542387,14201.549387,1,voc,426046271,426046481,210,spec2/voc/Bl122_426046271.jpg,Bl122,0
14183.925102,14183.930102,1,voc,425517753,425517903,150,spec2/voc/Bl122_425517753.jpg,Bl122,0
11162.43518,11162.47118,1,voc,334873055,334874135,1080,spec2/voc/Bl122_334873055.jpg,Bl122,0
7983.775748,7983.777748,1,voc,239513272,239513332,60,spec2/voc/Bl122_239513272.jpg,Bl122,0
3850.117415,3850.122415,1,voc,115503522,115503672,150,spec2/voc/Bl122_115503522.jpg,Bl122,0
11152.49718,11152.51118,1,voc,334574915,334575335,420,spec2/voc/Bl122_334574915.jpg,Bl122,0
6010.797533,6010.850533,1,voc,180323925,180325515,1590,spec2/voc/Bl122_180323925.jpg,Bl122,0
14149.630855,14149.637855,1,voc,424488925,424489135,210,spec2/voc/Bl122_424488925.jpg,Bl122,0
7842.638748,7842.668748,1,voc,235279162,235280062,900,spec2/voc/Bl122_235279162.jpg,Bl122,0
10928.566807,10928.568807,1,voc,327857004,327857064,60,spec2/voc/Bl122_327857004.jpg,Bl122,0
6001.096256,6001.348256,1,voc,180032887,180040447,7560,spec2/voc/Bl122_180032887.jpg,Bl122,0
3045.239066,3045.293066,1,voc,91357171,91358791,1620,spec2/voc/Bl122_91357171.jpg,Bl122,0
9092.111241,9092.117241,1,voc,272763337,272763517,180,spec2/voc/Bl122_272763337.jpg,Bl122,0
8025.999748,8026.001748,1,voc,240779992,240780052,60,spec2/voc/Bl122_240779992.jpg,Bl122,0
14802.082551,14802.106551,1,voc,444062476,444063196,720,spec2/voc/Bl122_444062476.jpg,Bl122,0
6002.916256,6002.942256,1,voc,180087487,180088267,780,spec2/voc/Bl122_180087487.jpg,Bl122,0
7919.415748,7919.434748,1,voc,237582472,237583042,570,spec2/voc/Bl122_237582472.jpg,Bl122,0
7911.787748,7911.791748,1,voc,237353632,237353752,120,spec2/voc/Bl122_237353632.jpg,Bl122,0
6189.138327,6189.197327,1,voc,185674149,185675919,1770,spec2/voc/Bl122_185674149.jpg,Bl122,0
9107.818935,9107.821935,1,voc,273234568,273234658,90,spec2/voc/Bl122_273234568.jpg,Bl122,0
10945.326807,10945.335807,1,voc,328359804,328360074,270,spec2/voc/Bl122_328359804.jpg,Bl122,0
11163.51218,11163.51718,1,voc,334905365,334905515,150,spec2/voc/Bl122_334905365.jpg,Bl122,0
5969.253256,5969.307256,1,voc,179077597,179079217,1620,spec2/voc/Bl122_179077597.jpg,Bl122,0
8944.466967,8944.488967,1,voc,268334009,268334669,660,spec2/voc/Bl122_268334009.jpg,Bl122,0
3883.285062,3883.322062,1,voc,116498551,116499661,1110,spec2/voc/Bl122_116498551.jpg,Bl122,0
11915.612799,11915.667799,1,voc,357468383,357470033,1650,spec2/voc/Bl122_357468383.jpg,Bl122,0
7881.239748,7881.253748,1,voc,236437192,236437612,420,spec2/voc/Bl122_236437192.jpg,Bl122,0
9043.378241,9043.600241,1,voc,271301347,271308007,6660,spec2/voc/Bl122_271301347.jpg,Bl122,0
10935.690807,10935.697807,1,voc,328070724,328070934,210,spec2/voc/Bl122_328070724.jpg,Bl122,0
3843.095415,3843.101415,1,voc,115292862,115293042,180,spec2/voc/Bl122_115292862.jpg,Bl122,0
9114.678184,9114.734184,1,voc,273440345,273442025,1680,spec2/voc/Bl122_273440345.jpg,Bl122,0
3798.373649,3798.460649,1,voc,113951209,113953819,2610,spec2/voc/Bl122_113951209.jpg,Bl122,0
9152.806842,9152.836842,1,voc,274584205,274585105,900,spec2/voc/Bl122_274584205.jpg,Bl122,0
9043.327241,9043.334241,1,voc,271299817,271300027,210,spec2/voc/Bl122_271299817.jpg,Bl122,0
11210.004894,11210.039894,1,voc,336300146,336301196,1050,spec2/voc/Bl122_336300146.jpg,Bl122,0
3855.611415,3855.614415,1,voc,115668342,115668432,90,spec2/voc/Bl122_115668342.jpg,Bl122,0
13172.476701,13172.573701,1,voc,395174301,395177211,2910,spec2/voc/Bl122_395174301.jpg,Bl122,0
11203.358894,11203.380894,1,voc,336100766,336101426,660,spec2/voc/Bl122_336100766.jpg,Bl122,0
3847.013415,3847.037415,1,voc,115410402,115411122,720,spec2/voc/Bl122_115410402.jpg,Bl122,0
7899.233748,7899.237748,1,voc,236977012,236977132,120,spec2/voc/Bl122_236977012.jpg,Bl122,0
6080.996511,6081.061511,1,voc,182429895,182431845,1950,spec2/voc/Bl122_182429895.jpg,Bl122,0
9057.565241,9057.567241,1,voc,271726957,271727017,60,spec2/voc/Bl122_271726957.jpg,Bl122,0
7928.581748,7928.588748,1,voc,237857452,237857662,210,spec2/voc/Bl122_237857452.jpg,Bl122,0
10879.109609,10879.249609,1,voc,326373288,326377488,4200,spec2/voc/Bl122_326373288.jpg,Bl122,0
10933.988807,10933.994807,1,voc,328019664,328019844,180,spec2/voc/Bl122_328019664.jpg,Bl122,0
9038.220241,9038.253241,1,voc,271146607,271147597,990,spec2/voc/Bl122_271146607.jpg,Bl122,0
13171.049701,13171.078701,1,voc,395131491,395132361,870,spec2/voc/Bl122_395131491.jpg,Bl122,0
10888.282136,10888.285136,1,voc,326648464,326648554,90,spec2/voc/Bl122_326648464.jpg,Bl122,0
6088.45115,6088.46315,1,voc,182653534,182653894,360,spec2/voc/Bl122_182653534.jpg,Bl122,0
6176.655327,6176.660327,1,voc,185299659,185299809,150,spec2/voc/Bl122_185299659.jpg,Bl122,0
7881.333748,7881.336748,1,voc,236440012,236440102,90,spec2/voc/Bl122_236440012.jpg,Bl122,0
6026.014533,6026.018533,1,voc,180780435,180780555,120,spec2/voc/Bl122_180780435.jpg,Bl122,0
13208.265389,13208.400389,1,voc,396247961,396252011,4050,spec2/voc/Bl122_396247961.jpg,Bl122,0
6155.838349,6155.861349,1,voc,184675150,184675840,690,spec2/voc/Bl122_184675150.jpg,Bl122,0
9068.832241,9068.894241,1,voc,272064967,272066827,1860,spec2/voc/Bl122_272064967.jpg,Bl122,0
8966.608712,8966.610712,1,voc,268998261,268998321,60,spec2/voc/Bl122_268998261.jpg,Bl122,0
13988.698864,13988.700864,1,voc,419660965,419661025,60,spec2/voc/Bl122_419660965.jpg,Bl122,0
6125.414706,6125.446706,1,voc,183762441,183763401,960,spec2/voc/Bl122_183762441.jpg,Bl122,0
9025.746241,9025.751241,1,voc,270772387,270772537,150,spec2/voc/Bl122_270772387.jpg,Bl122,0
5935.145256,5935.158256,1,voc,178054357,178054747,390,spec2/voc/Bl122_178054357.jpg,Bl122,0
6017.992533,6018.037533,1,voc,180539775,180541125,1350,spec2/voc/Bl122_180539775.jpg,Bl122,0
14815.093551,14815.103551,1,voc,444452806,444453106,300,spec2/voc/Bl122_444452806.jpg,Bl122,0
8016.696748,8016.767748,1,voc,240500902,240503032,2130,spec2/voc/Bl122_240500902.jpg,Bl122,0
10902.710825,10902.746825,1,voc,327081324,327082404,1080,spec2/voc/Bl122_327081324.jpg,Bl122,0
6040.032065,6040.150065,1,voc,181200961,181204501,3540,spec2/voc/Bl122_181200961.jpg,Bl122,0
10946.856807,10947.069807,1,voc,328405704,328412094,6390,spec2/voc/Bl122_328405704.jpg,Bl122,0
9030.857241,9031.010241,1,voc,270925717,270930307,4590,spec2/voc/Bl122_270925717.jpg,Bl122,0
6136.801293,6136.805293,1,voc,184104038,184104158,120,spec2/voc/Bl122_184104038.jpg,Bl122,0
9165.908604,9165.965604,1,voc,274977258,274978968,1710,spec2/voc/Bl122_274977258.jpg,Bl122,0
3831.353649,3831.566649,1,voc,114940609,114946999,6390,spec2/voc/Bl122_114940609.jpg,Bl122,0
13221.976389,13221.984389,1,voc,396659291,396659531,240,spec2/voc/Bl122_396659291.jpg,Bl122,0
13156.128066,13156.147066,1,voc,394683841,394684411,570,spec2/voc/Bl122_394683841.jpg,Bl122,0
6028.173533,6028.212533,1,voc,180845205,180846375,1170,spec2/voc/Bl122_180845205.jpg,Bl122,0
13244.102606,13244.147606,1,voc,397323078,397324428,1350,spec2/voc/Bl122_397323078.jpg,Bl122,0
8947.679967,8947.780967,1,voc,268430399,268433429,3030,spec2/voc/Bl122_268430399.jpg,Bl122,0
6199.731327,6199.754327,1,voc,185991939,185992629,690,spec2/voc/Bl122_185991939.jpg,Bl122,0
7962.650748,7962.660748,1,voc,238879522,238879822,300,spec2/voc/Bl122_238879522.jpg,Bl122,0
5978.145256,5978.150256,1,voc,179344357,179344507,150,spec2/voc/Bl122_179344357.jpg,Bl122,0
7866.863748,7866.875748,1,voc,236005912,236006272,360,spec2/voc/Bl122_236005912.jpg,Bl122,0
9010.947241,9010.967241,1,voc,270328417,270329017,600,spec2/voc/Bl122_270328417.jpg,Bl122,0
8993.643241,8993.654241,1,voc,269809297,269809627,330,spec2/voc/Bl122_269809297.jpg,Bl122,0
8351.777705,8351.903705,1,voc,250553331,250557111,3780,spec2/voc/Bl122_250553331.jpg,Bl122,0
14843.873682,14843.916682,1,voc,445316210,445317500,1290,spec2/voc/Bl122_445316210.jpg,Bl122,0
14023.03105,14023.19905,1,voc,420690931,420695971,5040,spec2/voc/Bl122_420690931.jpg,Bl122,0
6109.115706,6109.118706,1,voc,183273471,183273561,90,spec2/voc/Bl122_183273471.jpg,Bl122,0
14334.977707,14334.981707,1,voc,430049331,430049451,120,spec2/voc/Bl122_430049331.jpg,Bl122,0
3802.788649,3802.828649,1,voc,114083659,114084859,1200,spec2/voc/Bl122_114083659.jpg,Bl122,0
3848.363415,3848.371415,1,voc,115450902,115451142,240,spec2/voc/Bl122_115450902.jpg,Bl122,0
11157.54318,11157.76218,1,voc,334726295,334732865,6570,spec2/voc/Bl122_334726295.jpg,Bl122,0
7974.763748,7974.766748,1,voc,239242912,239243002,90,spec2/voc/Bl122_239242912.jpg,Bl122,0
5971.980256,5971.986256,1,voc,179159407,179159587,180,spec2/voc/Bl122_179159407.jpg,Bl122,0
8993.908241,8993.916241,1,voc,269817247,269817487,240,spec2/voc/Bl122_269817247.jpg,Bl122,0
7842.072748,7842.077748,1,voc,235262182,235262332,150,spec2/voc/Bl122_235262182.jpg,Bl122,0
11186.47318,11186.51018,1,voc,335594195,335595305,1110,spec2/voc/Bl122_335594195.jpg,Bl122,0
5992.274256,5992.286256,1,voc,179768227,179768587,360,spec2/voc/Bl122_179768227.jpg,Bl122,0
3176.543448,3176.558448,1,voc,95296303,95296753,450,spec2/voc/Bl122_95296303.jpg,Bl122,0
8981.207025,8981.209025,1,voc,269436210,269436270,60,spec2/voc/Bl122_269436210.jpg,Bl122,0
14808.868551,14808.870551,1,voc,444266056,444266116,60,spec2/voc/Bl122_444266056.jpg,Bl122,0
7885.747748,7885.757748,1,voc,236572432,236572732,300,spec2/voc/Bl122_236572432.jpg,Bl122,0
14801.281551,14801.307551,1,voc,444038446,444039226,780,spec2/voc/Bl122_444038446.jpg,Bl122,0
13564.971867,13565.019867,1,voc,406949156,406950596,1440,spec2/voc/Bl122_406949156.jpg,Bl122,0
9009.502241,9009.637241,1,voc,270285067,270289117,4050,spec2/voc/Bl122_270285067.jpg,Bl122,0
7937.062748,7937.067748,1,voc,238111882,238112032,150,spec2/voc/Bl122_238111882.jpg,Bl122,0
8196.08575,8196.31375,1,voc,245882572,245889412,6840,spec2/voc/Bl122_245882572.jpg,Bl122,0
11157.27818,11157.32918,1,voc,334718345,334719875,1530,spec2/voc/Bl122_334718345.jpg,Bl122,0
9087.738241,9087.743241,1,voc,272632147,272632297,150,spec2/voc/Bl122_272632147.jpg,Bl122,0
5996.549256,5996.580256,1,voc,179896477,179897407,930,spec2/voc/Bl122_179896477.jpg,Bl122,0
8964.744712,8964.890712,1,voc,268942341,268946721,4380,spec2/voc/Bl122_268942341.jpg,Bl122,0
6142.475349,6142.489349,1,voc,184274260,184274680,420,spec2/voc/Bl122_184274260.jpg,Bl122,0
11151.56918,11151.59918,1,voc,334547075,334547975,900,spec2/voc/Bl122_334547075.jpg,Bl122,0
9069.614241,9069.624241,1,voc,272088427,272088727,300,spec2/voc/Bl122_272088427.jpg,Bl122,0
7962.136748,7962.142748,1,voc,238864102,238864282,180,spec2/voc/Bl122_238864102.jpg,Bl122,0
5275.974726,5276.238726,1,voc,158279241,158287161,7920,spec2/voc/Bl122_158279241.jpg,Bl122,0
6072.091705,6072.114705,1,voc,182162751,182163441,690,spec2/voc/Bl122_182162751.jpg,Bl122,0
9072.358241,9072.527241,1,voc,272170747,272175817,5070,spec2/voc/Bl122_272170747.jpg,Bl122,0
5958.087256,5958.167256,1,voc,178742617,178745017,2400,spec2/voc/Bl122_178742617.jpg,Bl122,0
11190.67818,11190.70518,1,voc,335720345,335721155,810,spec2/voc/Bl122_335720345.jpg,Bl122,0
12939.615352,12939.627352,1,voc,388188460,388188820,360,spec2/voc/Bl122_388188460.jpg,Bl122,0
7813.542748,7813.546748,1,voc,234406282,234406402,120,spec2/voc/Bl122_234406282.jpg,Bl122,0
6055.704705,6055.752705,1,voc,181671141,181672581,1440,spec2/voc/Bl122_181671141.jpg,Bl122,0
9009.047241,9009.173241,1,voc,270271417,270275197,3780,spec2/voc/Bl122_270271417.jpg,Bl122,0
8985.380025,8985.575025,1,voc,269561400,269567250,5850,spec2/voc/Bl122_269561400.jpg,Bl122,0
6132.351293,6132.442293,1,voc,183970538,183973268,2730,spec2/voc/Bl122_183970538.jpg,Bl122,0
7937.435748,7937.446748,1,voc,238123072,238123402,330,spec2/voc/Bl122_238123072.jpg,Bl122,0
13191.179662,13191.206662,1,voc,395735389,395736199,810,spec2/voc/Bl122_395735389.jpg,Bl122,0
8980.038025,8980.044025,1,voc,269401140,269401320,180,spec2/voc/Bl122_269401140.jpg,Bl122,0
9060.747241,9060.919241,1,voc,271822417,271827577,5160,spec2/voc/Bl122_271822417.jpg,Bl122,0
8035.797748,8035.809748,1,voc,241073932,241074292,360,spec2/voc/Bl122_241073932.jpg,Bl122,0
6071.963705,6072.053705,1,voc,182158911,182161611,2700,spec2/voc/Bl122_182158911.jpg,Bl122,0
6169.827327,6169.849327,1,voc,185094819,185095479,660,spec2/voc/Bl122_185094819.jpg,Bl122,0
5956.920256,5956.925256,1,voc,178707607,178707757,150,spec2/voc/Bl122_178707607.jpg,Bl122,0
9071.931241,9071.933241,1,voc,272157937,272157997,60,spec2/voc/Bl122_272157937.jpg,Bl122,0
5983.401256,5983.406256,1,voc,179502037,179502187,150,spec2/voc/Bl122_179502037.jpg,Bl122,0
11040.719892,11040.726892,1,voc,331221596,331221806,210,spec2/voc/Bl122_331221596.jpg,Bl122,0
6120.566706,6120.638706,1,voc,183617001,183619161,2160,spec2/voc/Bl122_183617001.jpg,Bl122,0
9146.511342,9146.520342,1,voc,274395340,274395610,270,spec2/voc/Bl122_274395340.jpg,Bl122,0
7845.400748,7845.406748,1,voc,235362022,235362202,180,spec2/voc/Bl122_235362022.jpg,Bl122,0
14710.777469,14710.780469,1,voc,441323324,441323414,90,spec2/voc/Bl122_441323324.jpg,Bl122,0
13603.014736,13603.018736,1,voc,408090442,408090562,120,spec2/voc/Bl122_408090442.jpg,Bl122,0
6155.895349,6155.902349,1,voc,184676860,184677070,210,spec2/voc/Bl122_184676860.jpg,Bl122,0
3855.710415,3855.713415,1,voc,115671312,115671402,90,spec2/voc/Bl122_115671312.jpg,Bl122,0
5952.422256,5952.427256,1,voc,178572667,178572817,150,spec2/voc/Bl122_178572667.jpg,Bl122,0
11204.294894,11204.296894,1,voc,336128846,336128906,60,spec2/voc/Bl122_336128846.jpg,Bl122,0
9032.251241,9032.289241,1,voc,270967537,270968677,1140,spec2/voc/Bl122_270967537.jpg,Bl122,0
9015.668241,9015.836241,1,voc,270470047,270475087,5040,spec2/voc/Bl122_270470047.jpg,Bl122,0
13218.113389,13218.133389,1,voc,396543401,396544001,600,spec2/voc/Bl122_396543401.jpg,Bl122,0
6105.479706,6105.579706,1,voc,183164391,183167391,3000,spec2/voc/Bl122_183164391.jpg,Bl122,0
8946.358967,8946.643967,1,voc,268390769,268399319,8550,spec2/voc/Bl122_268390769.jpg,Bl122,0
7963.130748,7963.171748,1,voc,238893922,238895152,1230,spec2/voc/Bl122_238893922.jpg,Bl122,0
9078.263241,9078.298241,1,voc,272347897,272348947,1050,spec2/voc/Bl122_272347897.jpg,Bl122,0
8986.882025,8986.902025,1,voc,269606460,269607060,600,spec2/voc/Bl122_269606460.jpg,Bl122,0
13195.692662,13195.701662,1,voc,395870779,395871049,270,spec2/voc/Bl122_395870779.jpg,Bl122,0
14840.085682,14840.089682,1,voc,445202570,445202690,120,spec2/voc/Bl122_445202570.jpg,Bl122,0
6201.693327,6201.702327,1,voc,186050799,186051069,270,spec2/voc/Bl122_186050799.jpg,Bl122,0
6220.771295,6220.930295,1,voc,186623138,186627908,4770,spec2/voc/Bl122_186623138.jpg,Bl122,0
9146.991342,9147.007342,1,voc,274409740,274410220,480,spec2/voc/Bl122_274409740.jpg,Bl122,0
6021.921533,6021.937533,1,voc,180657645,180658125,480,spec2/voc/Bl122_180657645.jpg,Bl122,0
7918.261748,7918.267748,1,voc,237547852,237548032,180,spec2/voc/Bl122_237547852.jpg,Bl122,0
8031.853748,8031.867748,1,voc,240955612,240956032,420,spec2/voc/Bl122_240955612.jpg,Bl122,0
9054.728241,9054.737241,1,voc,271641847,271642117,270,spec2/voc/Bl122_271641847.jpg,Bl122,0
7798.644748,7798.655748,1,voc,233959342,233959672,330,spec2/voc/Bl122_233959342.jpg,Bl122,0
3822.009649,3822.014649,1,voc,114660289,114660439,150,spec2/voc/Bl122_114660289.jpg,Bl122,0
6111.114706,6111.121706,1,voc,183333441,183333651,210,spec2/voc/Bl122_183333441.jpg,Bl122,0
14821.826551,14821.834551,1,voc,444654796,444655036,240,spec2/voc/Bl122_444654796.jpg,Bl122,0
8964.098712,8964.166712,1,voc,268922961,268925001,2040,spec2/voc/Bl122_268922961.jpg,Bl122,0
10914.919807,10914.940807,1,voc,327447594,327448224,630,spec2/voc/Bl122_327447594.jpg,Bl122,0
9161.458057,9161.472057,1,voc,274843741,274844161,420,spec2/voc/Bl122_274843741.jpg,Bl122,0
7843.471748,7843.474748,1,voc,235304152,235304242,90,spec2/voc/Bl122_235304152.jpg,Bl122,0
13950.058911,13950.063911,1,voc,418501767,418501917,150,spec2/voc/Bl122_418501767.jpg,Bl122,0
11194.48718,11194.51318,1,voc,335834615,335835395,780,spec2/voc/Bl122_335834615.jpg,Bl122,0
9049.418241,9049.437241,1,voc,271482547,271483117,570,spec2/voc/Bl122_271482547.jpg,Bl122,0
6037.538533,6037.542533,1,voc,181126155,181126275,120,spec2/voc/Bl122_181126155.jpg,Bl122,0
9078.205241,9078.220241,1,voc,272346157,272346607,450,spec2/voc/Bl122_272346157.jpg,Bl122,0
6067.803705,6067.805705,1,voc,182034111,182034171,60,spec2/voc/Bl122_182034111.jpg,Bl122,0
6201.706327,6201.708327,1,voc,186051189,186051249,60,spec2/voc/Bl122_186051189.jpg,Bl122,0
6042.4832,6042.6062,1,voc,181274496,181278186,3690,spec2/voc/Bl122_181274496.jpg,Bl122,0
13960.365384,13960.405384,1,voc,418810961,418812161,1200,spec2/voc/Bl122_418810961.jpg,Bl122,0
3055.144464,3055.162464,1,voc,91654333,91654873,540,spec2/voc/Bl122_91654333.jpg,Bl122,0
6201.859327,6201.865327,1,voc,186055779,186055959,180,spec2/voc/Bl122_186055779.jpg,Bl122,0
8035.964748,8035.979748,1,voc,241078942,241079392,450,spec2/voc/Bl122_241078942.jpg,Bl122,0
8921.449773,8921.473773,1,voc,267643493,267644213,720,spec2/voc/Bl122_267643493.jpg,Bl122,0
6188.516327,6188.528327,1,voc,185655489,185655849,360,spec2/voc/Bl122_185655489.jpg,Bl122,0
12896.18146,12896.36846,1,voc,386885443,386891053,5610,spec2/voc/Bl122_386885443.jpg,Bl122,0
7843.495748,7843.554748,1,voc,235304872,235306642,1770,spec2/voc/Bl122_235304872.jpg,Bl122,0
6221.728295,6221.779295,1,voc,186651848,186653378,1530,spec2/voc/Bl122_186651848.jpg,Bl122,0
10901.027004,10901.129004,1,voc,327030810,327033870,3060,spec2/voc/Bl122_327030810.jpg,Bl122,0
6033.518533,6033.559533,1,voc,181005555,181006785,1230,spec2/voc/Bl122_181005555.jpg,Bl122,0
6050.3682,6050.3832,1,voc,181511046,181511496,450,spec2/voc/Bl122_181511046.jpg,Bl122,0
7908.969748,7908.979748,1,voc,237269092,237269392,300,spec2/voc/Bl122_237269092.jpg,Bl122,0
12640.263849,12640.279849,1,voc,379207915,379208395,480,spec2/voc/Bl122_379207915.jpg,Bl122,0
13586.902236,13586.933236,1,voc,407607067,407607997,930,spec2/voc/Bl122_407607067.jpg,Bl122,0
7789.459748,7789.475748,1,voc,233683792,233684272,480,spec2/voc/Bl122_233683792.jpg,Bl122,0
14806.769551,14806.982551,1,voc,444203086,444209476,6390,spec2/voc/Bl122_444203086.jpg,Bl122,0
8915.724773,8915.844773,1,voc,267471743,267475343,3600,spec2/voc/Bl122_267471743.jpg,Bl122,0
7856.316748,7856.333748,1,voc,235689502,235690012,510,spec2/voc/Bl122_235689502.jpg,Bl122,0
6048.2472,6048.2532,1,voc,181447416,181447596,180,spec2/voc/Bl122_181447416.jpg,Bl122,0
13160.114891,13160.118891,1,voc,394803446,394803566,120,spec2/voc/Bl122_394803446.jpg,Bl122,0
13208.565389,13208.568389,1,voc,396256961,396257051,90,spec2/voc/Bl122_396256961.jpg,Bl122,0
9161.181057,9161.187057,1,voc,274835431,274835611,180,spec2/voc/Bl122_274835431.jpg,Bl122,0
7901.717481,7901.784481,1,voc,237051524,237053534,2010,spec2/voc/Bl122_237051524.jpg,Bl122,0
8021.363748,8021.374748,1,voc,240640912,240641242,330,spec2/voc/Bl122_240640912.jpg,Bl122,0
8213.959724,8214.154724,1,voc,246418791,246424641,5850,spec2/voc/Bl122_246418791.jpg,Bl122,0
11896.671631,11896.720631,1,voc,356900148,356901618,1470,spec2/voc/Bl122_356900148.jpg,Bl122,0
7919.902748,7919.907748,1,voc,237597082,237597232,150,spec2/voc/Bl122_237597082.jpg,Bl122,0
11143.778955,11143.937955,1,voc,334313368,334318138,4770,spec2/voc/Bl122_334313368.jpg,Bl122,0
6096.29815,6096.41615,1,voc,182888944,182892484,3540,spec2/voc/Bl122_182888944.jpg,Bl122,0
5939.741256,5939.753256,1,voc,178192237,178192597,360,spec2/voc/Bl122_178192237.jpg,Bl122,0
6164.430343,6164.482343,1,voc,184932910,184934470,1560,spec2/voc/Bl122_184932910.jpg,Bl122,0
6149.623349,6149.632349,1,voc,184488700,184488970,270,spec2/voc/Bl122_184488700.jpg,Bl122,0
6182.892327,6182.946327,1,voc,185486769,185488389,1620,spec2/voc/Bl122_185486769.jpg,Bl122,0
5986.884256,5987.089256,1,voc,179606527,179612677,6150,spec2/voc/Bl122_179606527.jpg,Bl122,0
6088.47615,6088.68415,1,voc,182654284,182660524,6240,spec2/voc/Bl122_182654284.jpg,Bl122,0
5990.917256,5990.937256,1,voc,179727517,179728117,600,spec2/voc/Bl122_179727517.jpg,Bl122,0
10945.366807,10945.497807,1,voc,328361004,328364934,3930,spec2/voc/Bl122_328361004.jpg,Bl122,0
7828.522748,7828.548748,1,voc,234855682,234856462,780,spec2/voc/Bl122_234855682.jpg,Bl122,0
7854.351748,7854.354748,1,voc,235630552,235630642,90,spec2/voc/Bl122_235630552.jpg,Bl122,0
6009.406533,6009.590533,1,voc,180282195,180287715,5520,spec2/voc/Bl122_180282195.jpg,Bl122,0
7937.537748,7937.620748,1,voc,238126132,238128622,2490,spec2/voc/Bl122_238126132.jpg,Bl122,0
6185.182327,6185.191327,1,voc,185555469,185555739,270,spec2/voc/Bl122_185555469.jpg,Bl122,0
9055.627241,9055.737241,1,voc,271668817,271672117,3300,spec2/voc/Bl122_271668817.jpg,Bl122,0
9080.993241,9080.999241,1,voc,272429797,272429977,180,spec2/voc/Bl122_272429797.jpg,Bl122,0
11921.431615,11921.597615,1,voc,357642948,357647928,4980,spec2/voc/Bl122_357642948.jpg,Bl122,0
9006.010241,9006.038241,1,voc,270180307,270181147,840,spec2/voc/Bl122_270180307.jpg,Bl122,0
7897.474748,7897.479748,1,voc,236924242,236924392,150,spec2/voc/Bl122_236924242.jpg,Bl122,0
12622.644161,12622.730161,1,voc,378679324,378681904,2580,spec2/voc/Bl122_378679324.jpg,Bl122,0
5966.790256,5966.797256,1,voc,179003707,179003917,210,spec2/voc/Bl122_179003707.jpg,Bl122,0
11854.957769,11855.056769,1,voc,355648733,355651703,2970,spec2/voc/Bl122_355648733.jpg,Bl122,0
10903.810825,10903.814825,1,voc,327114324,327114444,120,spec2/voc/Bl122_327114324.jpg,Bl122,0
14201.196387,14201.200387,1,voc,426035891,426036011,120,spec2/voc/Bl122_426035891.jpg,Bl122,0
7856.930748,7856.938748,1,voc,235707922,235708162,240,spec2/voc/Bl122_235707922.jpg,Bl122,0
12591.119947,12591.374947,1,voc,377733598,377741248,7650,spec2/voc/Bl122_377733598.jpg,Bl122,0
8195.69975,8195.71075,1,voc,245870992,245871322,330,spec2/voc/Bl122_245870992.jpg,Bl122,0
8032.231748,8032.239748,1,voc,240966952,240967192,240,spec2/voc/Bl122_240966952.jpg,Bl122,0
7841.605748,7841.622748,1,voc,235248172,235248682,510,spec2/voc/Bl122_235248172.jpg,Bl122,0
3828.849649,3828.917649,1,voc,114865489,114867529,2040,spec2/voc/Bl122_114865489.jpg,Bl122,0
10954.008807,10954.013807,1,voc,328620264,328620414,150,spec2/voc/Bl122_328620264.jpg,Bl122,0
8026.619748,8026.626748,1,voc,240798592,240798802,210,spec2/voc/Bl122_240798592.jpg,Bl122,0
5937.135256,5937.207256,1,voc,178114057,178116217,2160,spec2/voc/Bl122_178114057.jpg,Bl122,0
3865.982367,3866.074367,1,voc,115979471,115982231,2760,spec2/voc/Bl122_115979471.jpg,Bl122,0
13188.078662,13188.088662,1,voc,395642359,395642659,300,spec2/voc/Bl122_395642359.jpg,Bl122,0
3850.597415,3850.602415,1,voc,115517922,115518072,150,spec2/voc/Bl122_115517922.jpg,Bl122,0
9039.053241,9039.279241,1,voc,271171597,271178377,6780,spec2/voc/Bl122_271171597.jpg,Bl122,0
5947.539256,5947.567256,1,voc,178426177,178427017,840,spec2/voc/Bl122_178426177.jpg,Bl122,0
13582.057236,13582.082236,1,voc,407461717,407462467,750,spec2/voc/Bl122_407461717.jpg,Bl122,0
5963.073256,5963.077256,1,voc,178892197,178892317,120,spec2/voc/Bl122_178892197.jpg,Bl122,0
6150.569349,6150.680349,1,voc,184517080,184520410,3330,spec2/voc/Bl122_184517080.jpg,Bl122,0
8195.87375,8195.95975,1,voc,245876212,245878792,2580,spec2/voc/Bl122_245876212.jpg,Bl122,0
14791.101551,14791.274551,1,voc,443733046,443738236,5190,spec2/voc/Bl122_443733046.jpg,Bl122,0
6125.362706,6125.366706,1,voc,183760881,183761001,120,spec2/voc/Bl122_183760881.jpg,Bl122,0
3849.478415,3849.532415,1,voc,115484352,115485972,1620,spec2/voc/Bl122_115484352.jpg,Bl122,0
9089.919241,9089.947241,1,voc,272697577,272698417,840,spec2/voc/Bl122_272697577.jpg,Bl122,0
6013.609533,6013.634533,1,voc,180408285,180409035,750,spec2/voc/Bl122_180408285.jpg,Bl122,0
8938.678967,8938.855967,1,voc,268160369,268165679,5310,spec2/voc/Bl122_268160369.jpg,Bl122,0
7975.175748,7975.200748,1,voc,239255272,239256022,750,spec2/voc/Bl122_239255272.jpg,Bl122,0
7999.278748,7999.285748,1,voc,239978362,239978572,210,spec2/voc/Bl122_239978362.jpg,Bl122,0
13950.326911,13950.347911,1,voc,418509807,418510437,630,spec2/voc/Bl122_418509807.jpg,Bl122,0
3823.860649,3823.865649,1,voc,114715819,114715969,150,spec2/voc/Bl122_114715819.jpg,Bl122,0
3883.081062,3883.108062,1,voc,116492431,116493241,810,spec2/voc/Bl122_116492431.jpg,Bl122,0
9158.392796,9158.402796,1,voc,274751783,274752083,300,spec2/voc/Bl122_274751783.jpg,Bl122,0
3814.108649,3814.128649,1,voc,114423259,114423859,600,spec2/voc/Bl122_114423259.jpg,Bl122,0
10932.685807,10932.688807,1,voc,327980574,327980664,90,spec2/voc/Bl122_327980574.jpg,Bl122,0
3870.963367,3871.014367,1,voc,116128901,116130431,1530,spec2/voc/Bl122_116128901.jpg,Bl122,0
9016.921241,9016.926241,1,voc,270507637,270507787,150,spec2/voc/Bl122_270507637.jpg,Bl122,0
14369.639363,14369.695363,1,voc,431089180,431090860,1680,spec2/voc/Bl122_431089180.jpg,Bl122,0
3820.138649,3820.153649,1,voc,114604159,114604609,450,spec2/voc/Bl122_114604159.jpg,Bl122,0
9100.957241,9101.230241,1,voc,273028717,273036907,8190,spec2/voc/Bl122_273028717.jpg,Bl122,0
10880.143609,10880.181609,1,voc,326404308,326405448,1140,spec2/voc/Bl122_326404308.jpg,Bl122,0
13976.623117,13976.856117,1,voc,419298693,419305683,6990,spec2/voc/Bl122_419298693.jpg,Bl122,0
12667.917394,12668.005394,1,voc,380037521,380040161,2640,spec2/voc/Bl122_380037521.jpg,Bl122,0
10932.699807,10932.723807,1,voc,327980994,327981714,720,spec2/voc/Bl122_327980994.jpg,Bl122,0
6199.012327,6199.110327,1,voc,185970369,185973309,2940,spec2/voc/Bl122_185970369.jpg,Bl122,0
13948.511911,13948.814911,1,voc,418455357,418464447,9090,spec2/voc/Bl122_418455357.jpg,Bl122,0
13945.815911,13946.060911,1,voc,418374477,418381827,7350,spec2/voc/Bl122_418374477.jpg,Bl122,0
5985.364256,5985.371256,1,voc,179560927,179561137,210,spec2/voc/Bl122_179560927.jpg,Bl122,0
5955.623256,5955.710256,1,voc,178668697,178671307,2610,spec2/voc/Bl122_178668697.jpg,Bl122,0
6012.798533,6012.810533,1,voc,180383955,180384315,360,spec2/voc/Bl122_180383955.jpg,Bl122,0
9161.553057,9161.570057,1,voc,274846591,274847101,510,spec2/voc/Bl122_274846591.jpg,Bl122,0
6222.162295,6222.186295,1,voc,186664868,186665588,720,spec2/voc/Bl122_186664868.jpg,Bl122,0
3799.553649,3799.661649,1,voc,113986609,113989849,3240,spec2/voc/Bl122_113986609.jpg,Bl122,0
11154.00918,11154.01218,1,voc,334620275,334620365,90,spec2/voc/Bl122_334620275.jpg,Bl122,0
3824.734649,3825.015649,1,voc,114742039,114750469,8430,spec2/voc/Bl122_114742039.jpg,Bl122,0
3862.090367,3862.107367,1,voc,115862711,115863221,510,spec2/voc/Bl122_115862711.jpg,Bl122,0
3176.617448,3176.834448,1,voc,95298523,95305033,6510,spec2/voc/Bl122_95298523.jpg,Bl122,0
5938.762256,5938.764256,1,voc,178162867,178162927,60,spec2/voc/Bl122_178162867.jpg,Bl122,0
9077.891241,9077.893241,1,voc,272336737,272336797,60,spec2/voc/Bl122_272336737.jpg,Bl122,0
5988.726256,5988.999256,1,voc,179661787,179669977,8190,spec2/voc/Bl122_179661787.jpg,Bl122,0
13206.485389,13206.489389,1,voc,396194561,396194681,120,spec2/voc/Bl122_396194561.jpg,Bl122,0
14799.880551,14799.887551,1,voc,443996416,443996626,210,spec2/voc/Bl122_443996416.jpg,Bl122,0
3039.308317,3039.533317,1,voc,91179249,91185999,6750,spec2/voc/Bl122_91179249.jpg,Bl122,0
6208.418327,6208.545327,1,voc,186252549,186256359,3810,spec2/voc/Bl122_186252549.jpg,Bl122,0
9151.701842,9151.721842,1,voc,274551055,274551655,600,spec2/voc/Bl122_274551055.jpg,Bl122,0
3855.617415,3855.706415,1,voc,115668522,115671192,2670,spec2/voc/Bl122_115668522.jpg,Bl122,0
7912.181748,7912.227748,1,voc,237365452,237366832,1380,spec2/voc/Bl122_237365452.jpg,Bl122,0
12678.07017,12678.08017,1,voc,380342105,380342405,300,spec2/voc/Bl122_380342105.jpg,Bl122,0
13952.201911,13952.263911,1,voc,418566057,418567917,1860,spec2/voc/Bl122_418566057.jpg,Bl122,0
7998.791748,7998.798748,1,voc,239963752,239963962,210,spec2/voc/Bl122_239963752.jpg,Bl122,0
6016.265533,6016.272533,1,voc,180487965,180488175,210,spec2/voc/Bl122_180487965.jpg,Bl122,0
14817.091551,14817.145551,1,voc,444512746,444514366,1620,spec2/voc/Bl122_444512746.jpg,Bl122,0
5957.963256,5957.969256,1,voc,178738897,178739077,180,spec2/voc/Bl122_178738897.jpg,Bl122,0
10917.129807,10917.155807,1,voc,327513894,327514674,780,spec2/voc/Bl122_327513894.jpg,Bl122,0
6025.512533,6025.542533,1,voc,180765375,180766275,900,spec2/voc/Bl122_180765375.jpg,Bl122,0
6037.383533,6037.389533,1,voc,181121505,181121685,180,spec2/voc/Bl122_181121505.jpg,Bl122,0
7915.758748,7916.032748,1,voc,237472762,237480982,8220,spec2/voc/Bl122_237472762.jpg,Bl122,0
6132.795293,6132.820293,1,voc,183983858,183984608,750,spec2/voc/Bl122_183983858.jpg,Bl122,0
11180.62518,11180.63018,1,voc,335418755,335418905,150,spec2/voc/Bl122_335418755.jpg,Bl122,0
7977.301748,7977.305748,1,voc,239319052,239319172,120,spec2/voc/Bl122_239319052.jpg,Bl122,0
8993.674241,8993.688241,1,voc,269810227,269810647,420,spec2/voc/Bl122_269810227.jpg,Bl122,0
12671.680513,12671.702513,1,voc,380150415,380151075,660,spec2/voc/Bl122_380150415.jpg,Bl122,0
13947.163911,13947.166911,1,voc,418414917,418415007,90,spec2/voc/Bl122_418414917.jpg,Bl122,0
3881.042062,3881.097062,1,voc,116431261,116432911,1650,spec2/voc/Bl122_116431261.jpg,Bl122,0
11172.19718,11172.38718,1,voc,335165915,335171615,5700,spec2/voc/Bl122_335165915.jpg,Bl122,0
8107.399516,8107.406516,1,voc,243221985,243222195,210,spec2/voc/Bl122_243221985.jpg,Bl122,0
9158.163796,9158.281796,1,voc,274744913,274748453,3540,spec2/voc/Bl122_274744913.jpg,Bl122,0
14149.288855,14149.296855,1,voc,424478665,424478905,240,spec2/voc/Bl122_424478665.jpg,Bl122,0
7860.643748,7860.647748,1,voc,235819312,235819432,120,spec2/voc/Bl122_235819312.jpg,Bl122,0
13733.473497,13733.476497,1,voc,412004204,412004294,90,spec2/voc/Bl122_412004204.jpg,Bl122,0
7886.432748,7886.435748,1,voc,236592982,236593072,90,spec2/voc/Bl122_236592982.jpg,Bl122,0
8950.849967,8950.853967,1,voc,268525499,268525619,120,spec2/voc/Bl122_268525499.jpg,Bl122,0
7851.350748,7851.355748,1,voc,235540522,235540672,150,spec2/voc/Bl122_235540522.jpg,Bl122,0
13955.995384,13956.061384,1,voc,418679861,418681841,1980,spec2/voc/Bl122_418679861.jpg,Bl122,0
8040.654748,8040.660748,1,voc,241219642,241219822,180,spec2/voc/Bl122_241219642.jpg,Bl122,0
11193.65018,11193.67218,1,voc,335809505,335810165,660,spec2/voc/Bl122_335809505.jpg,Bl122,0
11172.48918,11172.65918,1,voc,335174675,335179775,5100,spec2/voc/Bl122_335174675.jpg,Bl122,0
3850.463415,3850.468415,1,voc,115513902,115514052,150,spec2/voc/Bl122_115513902.jpg,Bl122,0
10946.421807,10946.482807,1,voc,328392654,328394484,1830,spec2/voc/Bl122_328392654.jpg,Bl122,0
8967.716712,8967.725712,1,voc,269031501,269031771,270,spec2/voc/Bl122_269031501.jpg,Bl122,0
3829.613649,3829.741649,1,voc,114888409,114892249,3840,spec2/voc/Bl122_114888409.jpg,Bl122,0
11193.84118,11193.86718,1,voc,335815235,335816015,780,spec2/voc/Bl122_335815235.jpg,Bl122,0
13907.799611,13908.022611,1,voc,417233988,417240678,6690,spec2/voc/Bl122_417233988.jpg,Bl122,0
9137.258255,9137.260255,1,voc,274117747,274117807,60,spec2/voc/Bl122_274117747.jpg,Bl122,0
10935.199807,10935.203807,1,voc,328055994,328056114,120,spec2/voc/Bl122_328055994.jpg,Bl122,0
14817.608551,14817.631551,1,voc,444528256,444528946,690,spec2/voc/Bl122_444528256.jpg,Bl122,0
10961.074807,10961.080807,1,voc,328832244,328832424,180,spec2/voc/Bl122_328832244.jpg,Bl122,0
13827.53422,13827.56122,1,voc,414826026,414826836,810,spec2/voc/Bl122_414826026.jpg,Bl122,0
12645.712825,12645.714825,1,voc,379371384,379371444,60,spec2/voc/Bl122_379371384.jpg,Bl122,0
13169.813701,13169.943701,1,voc,395094411,395098311,3900,spec2/voc/Bl122_395094411.jpg,Bl122,0
3850.553415,3850.558415,1,voc,115516602,115516752,150,spec2/voc/Bl122_115516602.jpg,Bl122,0
5960.132256,5960.136256,1,voc,178803967,178804087,120,spec2/voc/Bl122_178803967.jpg,Bl122,0
6060.683705,6060.697705,1,voc,181820511,181820931,420,spec2/voc/Bl122_181820511.jpg,Bl122,0
10915.645807,10915.653807,1,voc,327469374,327469614,240,spec2/voc/Bl122_327469374.jpg,Bl122,0
6057.090705,6057.102705,1,voc,181712721,181713081,360,spec2/voc/Bl122_181712721.jpg,Bl122,0
5970.871256,5970.889256,1,voc,179126137,179126677,540,spec2/voc/Bl122_179126137.jpg,Bl122,0
12608.632896,12608.651896,1,voc,378258986,378259556,570,spec2/voc/Bl122_378258986.jpg,Bl122,0
8019.539748,8019.542748,1,voc,240586192,240586282,90,spec2/voc/Bl122_240586192.jpg,Bl122,0
9073.124241,9073.243241,1,voc,272193727,272197297,3570,spec2/voc/Bl122_272193727.jpg,Bl122,0
6090.12515,6090.13015,1,voc,182703754,182703904,150,spec2/voc/Bl122_182703754.jpg,Bl122,0
8936.845967,8936.951967,1,voc,268105379,268108559,3180,spec2/voc/Bl122_268105379.jpg,Bl122,0
13583.627236,13583.639236,1,voc,407508817,407509177,360,spec2/voc/Bl122_407508817.jpg,Bl122,0
6000.421256,6000.489256,1,voc,180012637,180014677,2040,spec2/voc/Bl122_180012637.jpg,Bl122,0
6033.873533,6033.950533,1,voc,181016205,181018515,2310,spec2/voc/Bl122_181016205.jpg,Bl122,0
3053.520288,3053.576288,1,voc,91605608,91607288,1680,spec2/voc/Bl122_91605608.jpg,Bl122,0
9018.189241,9018.237241,1,voc,270545677,270547117,1440,spec2/voc/Bl122_270545677.jpg,Bl122,0
14808.730551,14808.839551,1,voc,444261916,444265186,3270,spec2/voc/Bl122_444261916.jpg,Bl122,0
12591.646947,12591.654947,1,voc,377749408,377749648,240,spec2/voc/Bl122_377749408.jpg,Bl122,0
9077.568241,9077.630241,1,voc,272327047,272328907,1860,spec2/voc/Bl122_272327047.jpg,Bl122,0
14809.475551,14809.487551,1,voc,444284266,444284626,360,spec2/voc/Bl122_444284266.jpg,Bl122,0
6134.338293,6134.567293,1,voc,184030148,184037018,6870,spec2/voc/Bl122_184030148.jpg,Bl122,0
13244.849606,13244.905606,1,voc,397345488,397347168,1680,spec2/voc/Bl122_397345488.jpg,Bl122,0
14824.046551,14824.268551,1,voc,444721396,444728056,6660,spec2/voc/Bl122_444721396.jpg,Bl122,0
14819.892551,14819.952551,1,voc,444596776,444598576,1800,spec2/voc/Bl122_444596776.jpg,Bl122,0
7977.212748,7977.226748,1,voc,239316382,239316802,420,spec2/voc/Bl122_239316382.jpg,Bl122,0
14149.309855,14149.315855,1,voc,424479295,424479475,180,spec2/voc/Bl122_424479295.jpg,Bl122,0
13206.492389,13206.497389,1,voc,396194771,396194921,150,spec2/voc/Bl122_396194771.jpg,Bl122,0
3890.822652,3890.940652,1,voc,116724679,116728219,3540,spec2/voc/Bl122_116724679.jpg,Bl122,0
9097.640241,9097.649241,1,voc,272929207,272929477,270,spec2/voc/Bl122_272929207.jpg,Bl122,0
11210.095894,11210.123894,1,voc,336302876,336303716,840,spec2/voc/Bl122_336302876.jpg,Bl122,0
13733.804497,13733.812497,1,voc,412014134,412014374,240,spec2/voc/Bl122_412014134.jpg,Bl122,0
8987.323025,8987.345025,1,voc,269619690,269620350,660,spec2/voc/Bl122_269619690.jpg,Bl122,0
3826.026649,3826.265649,1,voc,114780799,114787969,7170,spec2/voc/Bl122_114780799.jpg,Bl122,0
14825.090551,14825.122551,1,voc,444752716,444753676,960,spec2/voc/Bl122_444752716.jpg,Bl122,0
13976.933117,13976.936117,1,voc,419307993,419308083,90,spec2/voc/Bl122_419307993.jpg,Bl122,0
9018.031241,9018.155241,1,voc,270540937,270544657,3720,spec2/voc/Bl122_270540937.jpg,Bl122,0
13546.235973,13546.289973,1,voc,406387079,406388699,1620,spec2/voc/Bl122_406387079.jpg,Bl122,0
6118.185706,6118.285706,1,voc,183545571,183548571,3000,spec2/voc/Bl122_183545571.jpg,Bl122,0
6004.968256,6004.971256,1,voc,180149047,180149137,90,spec2/voc/Bl122_180149047.jpg,Bl122,0
5985.390256,5985.417256,1,voc,179561707,179562517,810,spec2/voc/Bl122_179561707.jpg,Bl122,0
11209.914894,11209.936894,1,voc,336297446,336298106,660,spec2/voc/Bl122_336297446.jpg,Bl122,0
11144.650955,11144.743955,1,voc,334339528,334342318,2790,spec2/voc/Bl122_334339528.jpg,Bl122,0
11158.33818,11158.34418,1,voc,334750145,334750325,180,spec2/voc/Bl122_334750145.jpg,Bl122,0
8207.953882,8207.998882,1,voc,246238616,246239966,1350,spec2/voc/Bl122_246238616.jpg,Bl122,0
3802.835649,3802.840649,1,voc,114085069,114085219,150,spec2/voc/Bl122_114085069.jpg,Bl122,0
14709.411469,14709.442469,1,voc,441282344,441283274,930,spec2/voc/Bl122_441282344.jpg,Bl122,0
7906.002748,7906.029748,1,voc,237180082,237180892,810,spec2/voc/Bl122_237180082.jpg,Bl122,0
11125.492005,11125.593005,1,voc,333764760,333767790,3030,spec2/voc/Bl122_333764760.jpg,Bl122,0
8003.471748,8003.475748,1,voc,240104152,240104272,120,spec2/voc/Bl122_240104152.jpg,Bl122,0
7781.065748,7781.085748,1,voc,233431972,233432572,600,spec2/voc/Bl122_233431972.jpg,Bl122,0
7968.349748,7968.408748,1,voc,239050492,239052262,1770,spec2/voc/Bl122_239050492.jpg,Bl122,0
6169.892327,6169.896327,1,voc,185096769,185096889,120,spec2/voc/Bl122_185096769.jpg,Bl122,0
7968.765748,7968.768748,1,voc,239062972,239063062,90,spec2/voc/Bl122_239062972.jpg,Bl122,0
8347.192566,8347.290566,1,voc,250415776,250418716,2940,spec2/voc/Bl122_250415776.jpg,Bl122,0
13163.592891,13163.637891,1,voc,394907786,394909136,1350,spec2/voc/Bl122_394907786.jpg,Bl122,0
11162.88218,11162.88918,1,voc,334886465,334886675,210,spec2/voc/Bl122_334886465.jpg,Bl122,0
5987.972256,5988.004256,1,voc,179639167,179640127,960,spec2/voc/Bl122_179639167.jpg,Bl122,0
13963.069384,13963.141384,1,voc,418892081,418894241,2160,spec2/voc/Bl122_418892081.jpg,Bl122,0
13210.461389,13210.465389,1,voc,396313841,396313961,120,spec2/voc/Bl122_396313841.jpg,Bl122,0
9094.555241,9094.563241,1,voc,272836657,272836897,240,spec2/voc/Bl122_272836657.jpg,Bl122,0
7846.235748,7846.247748,1,voc,235387072,235387432,360,spec2/voc/Bl122_235387072.jpg,Bl122,0
13558.548616,13558.552616,1,voc,406756458,406756578,120,spec2/voc/Bl122_406756458.jpg,Bl122,0
10943.557807,10943.595807,1,voc,328306734,328307874,1140,spec2/voc/Bl122_328306734.jpg,Bl122,0
9165.745604,9165.906604,1,voc,274972368,274977198,4830,spec2/voc/Bl122_274972368.jpg,Bl122,0
14782.360844,14782.364844,1,voc,443470825,443470945,120,spec2/voc/Bl122_443470825.jpg,Bl122,0
7798.383748,7798.389748,1,voc,233951512,233951692,180,spec2/voc/Bl122_233951512.jpg,Bl122,0
6058.500705,6058.505705,1,voc,181755021,181755171,150,spec2/voc/Bl122_181755021.jpg,Bl122,0
6221.690295,6221.726295,1,voc,186650708,186651788,1080,spec2/voc/Bl122_186650708.jpg,Bl122,0
8950.679967,8950.683967,1,voc,268520399,268520519,120,spec2/voc/Bl122_268520399.jpg,Bl122,0
10881.848609,10881.889609,1,voc,326455458,326456688,1230,spec2/voc/Bl122_326455458.jpg,Bl122,0
6144.215349,6144.317349,1,voc,184326460,184329520,3060,spec2/voc/Bl122_184326460.jpg,Bl122,0
10937.295807,10937.320807,1,voc,328118874,328119624,750,spec2/voc/Bl122_328118874.jpg,Bl122,0
10919.969807,10919.971807,1,voc,327599094,327599154,60,spec2/voc/Bl122_327599094.jpg,Bl122,0
9036.904241,9037.178241,1,voc,271107127,271115347,8220,spec2/voc/Bl122_271107127.jpg,Bl122,0
9096.051241,9096.056241,1,voc,272881537,272881687,150,spec2/voc/Bl122_272881537.jpg,Bl122,0
6083.21715,6083.22715,1,voc,182496514,182496814,300,spec2/voc/Bl122_182496514.jpg,Bl122,0
6069.772705,6069.813705,1,voc,182093181,182094411,1230,spec2/voc/Bl122_182093181.jpg,Bl122,0
14824.905551,14824.917551,1,voc,444747166,444747526,360,spec2/voc/Bl122_444747166.jpg,Bl122,0
11201.854894,11202.084894,1,voc,336055646,336062546,6900,spec2/voc/Bl122_336055646.jpg,Bl122,0
10956.188807,10956.245807,1,voc,328685664,328687374,1710,spec2/voc/Bl122_328685664.jpg,Bl122,0
6055.657705,6055.697705,1,voc,181669731,181670931,1200,spec2/voc/Bl122_181669731.jpg,Bl122,0
8912.868773,8912.901773,1,voc,267386063,267387053,990,spec2/voc/Bl122_267386063.jpg,Bl122,0
6164.639343,6164.745343,1,voc,184939180,184942360,3180,spec2/voc/Bl122_184939180.jpg,Bl122,0
14183.328102,14183.355102,1,voc,425499843,425500653,810,spec2/voc/Bl122_425499843.jpg,Bl122,0
11159.03918,11159.04118,1,voc,334771175,334771235,60,spec2/voc/Bl122_334771175.jpg,Bl122,0
10924.745807,10924.853807,1,voc,327742374,327745614,3240,spec2/voc/Bl122_327742374.jpg,Bl122,0
5987.856256,5987.863256,1,voc,179635687,179635897,210,spec2/voc/Bl122_179635687.jpg,Bl122,0
10913.024807,10913.029807,1,voc,327390744,327390894,150,spec2/voc/Bl122_327390744.jpg,Bl122,0
10959.400807,10959.436807,1,voc,328782024,328783104,1080,spec2/voc/Bl122_328782024.jpg,Bl122,0
11141.741955,11141.771955,1,voc,334252258,334253158,900,spec2/voc/Bl122_334252258.jpg,Bl122,0
6222.994295,6222.998295,1,voc,186689828,186689948,120,spec2/voc/Bl122_186689828.jpg,Bl122,0
5979.735256,5979.777256,1,voc,179392057,179393317,1260,spec2/voc/Bl122_179392057.jpg,Bl122,0
14201.552387,14201.646387,1,voc,426046571,426049391,2820,spec2/voc/Bl122_426046571.jpg,Bl122,0
5977.344256,5977.391256,1,voc,179320327,179321737,1410,spec2/voc/Bl122_179320327.jpg,Bl122,0
3821.498649,3821.819649,1,voc,114644959,114654589,9630,spec2/voc/Bl122_114644959.jpg,Bl122,0
3394.930689,3394.942689,1,voc,101847920,101848280,360,spec2/voc/Bl122_101847920.jpg,Bl122,0
10903.485825,10903.594825,1,voc,327104574,327107844,3270,spec2/voc/Bl122_327104574.jpg,Bl122,0
6138.388293,6138.400293,1,voc,184151648,184152008,360,spec2/voc/Bl122_184151648.jpg,Bl122,0
8040.764748,8040.774748,1,voc,241222942,241223242,300,spec2/voc/Bl122_241222942.jpg,Bl122,0
3896.016652,3896.037652,1,voc,116880499,116881129,630,spec2/voc/Bl122_116880499.jpg,Bl122,0
9051.262241,9051.286241,1,voc,271537867,271538587,720,spec2/voc/Bl122_271537867.jpg,Bl122,0
14155.061825,14155.070825,1,voc,424651854,424652124,270,spec2/voc/Bl122_424651854.jpg,Bl122,0
7854.619748,7854.624748,1,voc,235638592,235638742,150,spec2/voc/Bl122_235638592.jpg,Bl122,0
12661.317535,12661.392535,1,voc,379839526,379841776,2250,spec2/voc/Bl122_379839526.jpg,Bl122,0
6023.251533,6023.266533,1,voc,180697545,180697995,450,spec2/voc/Bl122_180697545.jpg,Bl122,0
9039.617241,9039.627241,1,voc,271188517,271188817,300,spec2/voc/Bl122_271188517.jpg,Bl122,0
7837.768748,7837.799748,1,voc,235133062,235133992,930,spec2/voc/Bl122_235133062.jpg,Bl122,0
6011.101533,6011.310533,1,voc,180333045,180339315,6270,spec2/voc/Bl122_180333045.jpg,Bl122,0
6026.742533,6026.909533,1,voc,180802275,180807285,5010,spec2/voc/Bl122_180802275.jpg,Bl122,0
6194.853327,6194.856327,1,voc,185845599,185845689,90,spec2/voc/Bl122_185845599.jpg,Bl122,0
8319.375436,8319.379436,1,voc,249581263,249581383,120,spec2/voc/Bl122_249581263.jpg,Bl122,0
9149.154842,9149.158842,1,voc,274474645,274474765,120,spec2/voc/Bl122_274474645.jpg,Bl122,0
9113.635184,9113.752184,1,voc,273409055,273412565,3510,spec2/voc/Bl122_273409055.jpg,Bl122,0
6091.17515,6091.17715,1,voc,182735254,182735314,60,spec2/voc/Bl122_182735254.jpg,Bl122,0
3885.954062,3885.957062,1,voc,116578621,116578711,90,spec2/voc/Bl122_116578621.jpg,Bl122,0
10953.376807,10953.380807,1,voc,328601304,328601424,120,spec2/voc/Bl122_328601304.jpg,Bl122,0
5974.058256,5974.066256,1,voc,179221747,179221987,240,spec2/voc/Bl122_179221747.jpg,Bl122,0
8015.019748,8015.189748,1,voc,240450592,240455692,5100,spec2/voc/Bl122_240450592.jpg,Bl122,0
3838.802415,3838.883415,1,voc,115164072,115166502,2430,spec2/voc/Bl122_115164072.jpg,Bl122,0
14817.657551,14817.664551,1,voc,444529726,444529936,210,spec2/voc/Bl122_444529726.jpg,Bl122,0
14822.147551,14822.150551,1,voc,444664426,444664516,90,spec2/voc/Bl122_444664426.jpg,Bl122,0
5936.709256,5936.802256,1,voc,178101277,178104067,2790,spec2/voc/Bl122_178101277.jpg,Bl122,0
9048.501241,9048.543241,1,voc,271455037,271456297,1260,spec2/voc/Bl122_271455037.jpg,Bl122,0
9096.422241,9096.510241,1,voc,272892667,272895307,2640,spec2/voc/Bl122_272892667.jpg,Bl122,0
9028.776241,9028.899241,1,voc,270863287,270866977,3690,spec2/voc/Bl122_270863287.jpg,Bl122,0
9178.650321,9178.817321,1,voc,275359509,275364519,5010,spec2/voc/Bl122_275359509.jpg,Bl122,0
8928.449773,8928.582773,1,voc,267853493,267857483,3990,spec2/voc/Bl122_267853493.jpg,Bl122,0
9070.150241,9070.155241,1,voc,272104507,272104657,150,spec2/voc/Bl122_272104507.jpg,Bl122,0
6145.439349,6145.593349,1,voc,184363180,184367800,4620,spec2/voc/Bl122_184363180.jpg,Bl122,0
10959.205807,10959.209807,1,voc,328776174,328776294,120,spec2/voc/Bl122_328776174.jpg,Bl122,0
6160.281349,6160.347349,1,voc,184808440,184810420,1980,spec2/voc/Bl122_184808440.jpg,Bl122,0
6170.880327,6170.884327,1,voc,185126409,185126529,120,spec2/voc/Bl122_185126409.jpg,Bl122,0
7916.239748,7916.242748,1,voc,237487192,237487282,90,spec2/voc/Bl122_237487192.jpg,Bl122,0
6042.6432,6042.6602,1,voc,181279296,181279806,510,spec2/voc/Bl122_181279296.jpg,Bl122,0
14794.873551,14794.877551,1,voc,443846206,443846326,120,spec2/voc/Bl122_443846206.jpg,Bl122,0
7923.623748,7923.748748,1,voc,237708712,237712462,3750,spec2/voc/Bl122_237708712.jpg,Bl122,0
10896.323557,10896.353557,1,voc,326889706,326890606,900,spec2/voc/Bl122_326889706.jpg,Bl122,0
13589.260236,13589.271236,1,voc,407677807,407678137,330,spec2/voc/Bl122_407677807.jpg,Bl122,0
8036.754748,8036.760748,1,voc,241102642,241102822,180,spec2/voc/Bl122_241102642.jpg,Bl122,0
9070.036241,9070.049241,1,voc,272101087,272101477,390,spec2/voc/Bl122_272101087.jpg,Bl122,0
3794.149649,3794.173649,1,voc,113824489,113825209,720,spec2/voc/Bl122_113824489.jpg,Bl122,0
6117.796706,6117.915706,1,voc,183533901,183537471,3570,spec2/voc/Bl122_183533901.jpg,Bl122,0
13973.293117,13973.372117,1,voc,419198793,419201163,2370,spec2/voc/Bl122_419198793.jpg,Bl122,0
3884.720062,3884.729062,1,voc,116541601,116541871,270,spec2/voc/Bl122_116541601.jpg,Bl122,0
13957.118384,13957.512384,1,voc,418713551,418725371,11820,spec2/voc/Bl122_418713551.jpg,Bl122,0
10913.968807,10914.054807,1,voc,327419064,327421644,2580,spec2/voc/Bl122_327419064.jpg,Bl122,0
13147.044358,13147.317358,1,voc,394411330,394419520,8190,spec2/voc/Bl122_394411330.jpg,Bl122,0
8916.380773,8916.467773,1,voc,267491423,267494033,2610,spec2/voc/Bl122_267491423.jpg,Bl122,0
6015.052533,6015.112533,1,voc,180451575,180453375,1800,spec2/voc/Bl122_180451575.jpg,Bl122,0
9114.738184,9114.741184,1,voc,273442145,273442235,90,spec2/voc/Bl122_273442145.jpg,Bl122,0
5929.684364,5929.739364,1,voc,177890530,177892180,1650,spec2/voc/Bl122_177890530.jpg,Bl122,0
14152.174278,14152.337278,1,voc,424565228,424570118,4890,spec2/voc/Bl122_424565228.jpg,Bl122,0
6227.515295,6227.594295,1,voc,186825458,186827828,2370,spec2/voc/Bl122_186825458.jpg,Bl122,0
13961.082384,13961.085384,1,voc,418832471,418832561,90,spec2/voc/Bl122_418832471.jpg,Bl122,0
13164.389891,13164.584891,1,voc,394931696,394937546,5850,spec2/voc/Bl122_394931696.jpg,Bl122,0
3819.311649,3819.328649,1,voc,114579349,114579859,510,spec2/voc/Bl122_114579349.jpg,Bl122,0
7974.589748,7974.593748,1,voc,239237692,239237812,120,spec2/voc/Bl122_239237692.jpg,Bl122,0
8987.691025,8987.693025,1,voc,269630730,269630790,60,spec2/voc/Bl122_269630730.jpg,Bl122,0
8037.634748,8037.651748,1,voc,241129042,241129552,510,spec2/voc/Bl122_241129042.jpg,Bl122,0
9052.297241,9052.312241,1,voc,271568917,271569367,450,spec2/voc/Bl122_271568917.jpg,Bl122,0
8966.895712,8966.922712,1,voc,269006871,269007681,810,spec2/voc/Bl122_269006871.jpg,Bl122,0
6133.135293,6133.176293,1,voc,183994058,183995288,1230,spec2/voc/Bl122_183994058.jpg,Bl122,0
9098.481241,9098.678241,1,voc,272954437,272960347,5910,spec2/voc/Bl122_272954437.jpg,Bl122,0
7924.726748,7924.743748,1,voc,237741802,237742312,510,spec2/voc/Bl122_237741802.jpg,Bl122,0
14148.841855,14148.843855,1,voc,424465255,424465315,60,spec2/voc/Bl122_424465255.jpg,Bl122,0
9054.702241,9054.710241,1,voc,271641067,271641307,240,spec2/voc/Bl122_271641067.jpg,Bl122,0
7968.328748,7968.340748,1,voc,239049862,239050222,360,spec2/voc/Bl122_239049862.jpg,Bl122,0
13180.602701,13180.806701,1,voc,395418081,395424201,6120,spec2/voc/Bl122_395418081.jpg,Bl122,0
7928.485748,7928.497748,1,voc,237854572,237854932,360,spec2/voc/Bl122_237854572.jpg,Bl122,0
11182.61718,11182.71818,1,voc,335478515,335481545,3030,spec2/voc/Bl122_335478515.jpg,Bl122,0
14791.648551,14791.651551,1,voc,443749456,443749546,90,spec2/voc/Bl122_443749456.jpg,Bl122,0
3824.703649,3824.707649,1,voc,114741109,114741229,120,spec2/voc/Bl122_114741109.jpg,Bl122,0
8027.433748,8027.470748,1,voc,240823012,240824122,1110,spec2/voc/Bl122_240823012.jpg,Bl122,0
5945.807256,5945.842256,1,voc,178374217,178375267,1050,spec2/voc/Bl122_178374217.jpg,Bl122,0
10924.895807,10924.901807,1,voc,327746874,327747054,180,spec2/voc/Bl122_327746874.jpg,Bl122,0
5992.017256,5992.180256,1,voc,179760517,179765407,4890,spec2/voc/Bl122_179760517.jpg,Bl122,0
9048.786241,9048.834241,1,voc,271463587,271465027,1440,spec2/voc/Bl122_271463587.jpg,Bl122,0
6109.263706,6109.340706,1,voc,183277911,183280221,2310,spec2/voc/Bl122_183277911.jpg,Bl122,0
9030.273241,9030.310241,1,voc,270908197,270909307,1110,spec2/voc/Bl122_270908197.jpg,Bl122,0
10919.717807,10919.738807,1,voc,327591534,327592164,630,spec2/voc/Bl122_327591534.jpg,Bl122,0
3818.879649,3819.095649,1,voc,114566389,114572869,6480,spec2/voc/Bl122_114566389.jpg,Bl122,0
13588.869236,13588.921236,1,voc,407666077,407667637,1560,spec2/voc/Bl122_407666077.jpg,Bl122,0
8924.427773,8924.567773,1,voc,267732833,267737033,4200,spec2/voc/Bl122_267732833.jpg,Bl122,0
9123.372182,9123.403182,1,voc,273701165,273702095,930,spec2/voc/Bl122_273701165.jpg,Bl122,0
9051.643241,9051.962241,1,voc,271549297,271558867,9570,spec2/voc/Bl122_271549297.jpg,Bl122,0
6047.6152,6047.6222,1,voc,181428456,181428666,210,spec2/voc/Bl122_181428456.jpg,Bl122,0
6153.887349,6153.946349,1,voc,184616620,184618390,1770,spec2/voc/Bl122_184616620.jpg,Bl122,0
3843.139415,3843.150415,1,voc,115294182,115294512,330,spec2/voc/Bl122_115294182.jpg,Bl122,0
9062.027241,9062.075241,1,voc,271860817,271862257,1440,spec2/voc/Bl122_271860817.jpg,Bl122,0
11179.26918,11179.30118,1,voc,335378075,335379035,960,spec2/voc/Bl122_335378075.jpg,Bl122,0
5952.356256,5952.377256,1,voc,178570687,178571317,630,spec2/voc/Bl122_178570687.jpg,Bl122,0
8920.513773,8920.526773,1,voc,267615413,267615803,390,spec2/voc/Bl122_267615413.jpg,Bl122,0
11140.045955,11140.134955,1,voc,334201378,334204048,2670,spec2/voc/Bl122_334201378.jpg,Bl122,0
6125.336706,6125.360706,1,voc,183760101,183760821,720,spec2/voc/Bl122_183760101.jpg,Bl122,0
8020.576748,8020.622748,1,voc,240617302,240618682,1380,spec2/voc/Bl122_240617302.jpg,Bl122,0
5988.167256,5988.225256,1,voc,179645017,179646757,1740,spec2/voc/Bl122_179645017.jpg,Bl122,0
5937.227256,5937.314256,1,voc,178116817,178119427,2610,spec2/voc/Bl122_178116817.jpg,Bl122,0
10881.941609,10882.148609,1,voc,326458248,326464458,6210,spec2/voc/Bl122_326458248.jpg,Bl122,0
6101.972706,6101.979706,1,voc,183059181,183059391,210,spec2/voc/Bl122_183059181.jpg,Bl122,0
5955.280256,5955.286256,1,voc,178658407,178658587,180,spec2/voc/Bl122_178658407.jpg,Bl122,0
11209.662894,11209.690894,1,voc,336289886,336290726,840,spec2/voc/Bl122_336289886.jpg,Bl122,0
7915.640748,7915.646748,1,voc,237469222,237469402,180,spec2/voc/Bl122_237469222.jpg,Bl122,0
13217.654389,13217.722389,1,voc,396529631,396531671,2040,spec2/voc/Bl122_396529631.jpg,Bl122,0
7859.656748,7859.659748,1,voc,235789702,235789792,90,spec2/voc/Bl122_235789702.jpg,Bl122,0
6199.718327,6199.729327,1,voc,185991549,185991879,330,spec2/voc/Bl122_185991549.jpg,Bl122,0
8930.606773,8930.849773,1,voc,267918203,267925493,7290,spec2/voc/Bl122_267918203.jpg,Bl122,0
5939.011256,5939.046256,1,voc,178170337,178171387,1050,spec2/voc/Bl122_178170337.jpg,Bl122,0
5963.147256,5963.337256,1,voc,178894417,178900117,5700,spec2/voc/Bl122_178894417.jpg,Bl122,0
13212.535389,13212.570389,1,voc,396376061,396377111,1050,spec2/voc/Bl122_396376061.jpg,Bl122,0
13214.843389,13214.847389,1,voc,396445301,396445421,120,spec2/voc/Bl122_396445301.jpg,Bl122,0
14840.619682,14840.843682,1,voc,445218590,445225310,6720,spec2/voc/Bl122_445218590.jpg,Bl122,0
6048.6562,6048.6632,1,voc,181459686,181459896,210,spec2/voc/Bl122_181459686.jpg,Bl122,0
13172.271701,13172.289701,1,voc,395168151,395168691,540,spec2/voc/Bl122_395168151.jpg,Bl122,0
5986.762256,5986.823256,1,voc,179602867,179604697,1830,spec2/voc/Bl122_179602867.jpg,Bl122,0
6169.750327,6169.793327,1,voc,185092509,185093799,1290,spec2/voc/Bl122_185092509.jpg,Bl122,0
3875.251848,3875.335848,1,voc,116257555,116260075,2520,spec2/voc/Bl122_116257555.jpg,Bl122,0
9003.922241,9003.930241,1,voc,270117667,270117907,240,spec2/voc/Bl122_270117667.jpg,Bl122,0
6143.824349,6143.931349,1,voc,184314730,184317940,3210,spec2/voc/Bl122_184314730.jpg,Bl122,0
13966.990352,13967.024352,1,voc,419009710,419010730,1020,spec2/voc/Bl122_419009710.jpg,Bl122,0
7941.867748,7941.878748,1,voc,238256032,238256362,330,spec2/voc/Bl122_238256032.jpg,Bl122,0
5970.384256,5970.593256,1,voc,179111527,179117797,6270,spec2/voc/Bl122_179111527.jpg,Bl122,0
9038.732241,9038.743241,1,voc,271161967,271162297,330,spec2/voc/Bl122_271161967.jpg,Bl122,0
3820.183649,3820.203649,1,voc,114605509,114606109,600,spec2/voc/Bl122_114605509.jpg,Bl122,0
5964.531256,5964.583256,1,voc,178935937,178937497,1560,spec2/voc/Bl122_178935937.jpg,Bl122,0
13541.571816,13541.596816,1,voc,406247154,406247904,750,spec2/voc/Bl122_406247154.jpg,Bl122,0
7974.906748,7974.909748,1,voc,239247202,239247292,90,spec2/voc/Bl122_239247202.jpg,Bl122,0
10908.158825,10908.171825,1,voc,327244764,327245154,390,spec2/voc/Bl122_327244764.jpg,Bl122,0
6068.393705,6068.505705,1,voc,182051811,182055171,3360,spec2/voc/Bl122_182051811.jpg,Bl122,0
3794.124649,3794.142649,1,voc,113823739,113824279,540,spec2/voc/Bl122_113823739.jpg,Bl122,0
3811.574649,3811.809649,1,voc,114347239,114354289,7050,spec2/voc/Bl122_114347239.jpg,Bl122,0
5985.894256,5985.899256,1,voc,179576827,179576977,150,spec2/voc/Bl122_179576827.jpg,Bl122,0
5965.529256,5965.795256,1,voc,178965877,178973857,7980,spec2/voc/Bl122_178965877.jpg,Bl122,0
13973.527117,13973.627117,1,voc,419205813,419208813,3000,spec2/voc/Bl122_419205813.jpg,Bl122,0
9069.917241,9069.928241,1,voc,272097517,272097847,330,spec2/voc/Bl122_272097517.jpg,Bl122,0
11154.30018,11154.34118,1,voc,334629005,334630235,1230,spec2/voc/Bl122_334629005.jpg,Bl122,0
3816.335649,3816.395649,1,voc,114490069,114491869,1800,spec2/voc/Bl122_114490069.jpg,Bl122,0
9087.408241,9087.412241,1,voc,272622247,272622367,120,spec2/voc/Bl122_272622247.jpg,Bl122,0
8022.842748,8022.849748,1,voc,240685282,240685492,210,spec2/voc/Bl122_240685282.jpg,Bl122,0
13244.212606,13244.232606,1,voc,397326378,397326978,600,spec2/voc/Bl122_397326378.jpg,Bl122,0
5944.696256,5944.709256,1,voc,178340887,178341277,390,spec2/voc/Bl122_178340887.jpg,Bl122,0
6142.053349,6142.385349,1,voc,184261600,184271560,9960,spec2/voc/Bl122_184261600.jpg,Bl122,0
10880.237609,10880.249609,1,voc,326407128,326407488,360,spec2/voc/Bl122_326407128.jpg,Bl122,0
13585.198236,13585.215236,1,voc,407555947,407556457,510,spec2/voc/Bl122_407555947.jpg,Bl122,0
13222.411389,13222.540389,1,voc,396672341,396676211,3870,spec2/voc/Bl122_396672341.jpg,Bl122,0
6021.901533,6021.904533,1,voc,180657045,180657135,90,spec2/voc/Bl122_180657045.jpg,Bl122,0
9017.945241,9018.010241,1,voc,270538357,270540307,1950,spec2/voc/Bl122_270538357.jpg,Bl122,0
7961.555748,7961.563748,1,voc,238846672,238846912,240,spec2/voc/Bl122_238846672.jpg,Bl122,0
6221.920295,6221.933295,1,voc,186657608,186657998,390,spec2/voc/Bl122_186657608.jpg,Bl122,0
7911.886748,7911.888748,1,voc,237356602,237356662,60,spec2/voc/Bl122_237356602.jpg,Bl122,0
8013.205748,8013.223748,1,voc,240396172,240396712,540,spec2/voc/Bl122_240396172.jpg,Bl122,0
5948.676256,5948.679256,1,voc,178460287,178460377,90,spec2/voc/Bl122_178460287.jpg,Bl122,0
8008.275748,8008.297748,1,voc,240248272,240248932,660,spec2/voc/Bl122_240248272.jpg,Bl122,0
3797.688649,3797.825649,1,voc,113930659,113934769,4110,spec2/voc/Bl122_113930659.jpg,Bl122,0
14821.701551,14821.803551,1,voc,444651046,444654106,3060,spec2/voc/Bl122_444651046.jpg,Bl122,0
6105.799706,6105.802706,1,voc,183173991,183174081,90,spec2/voc/Bl122_183173991.jpg,Bl122,0
6059.750705,6059.753705,1,voc,181792521,181792611,90,spec2/voc/Bl122_181792521.jpg,Bl122,0
9085.592241,9085.614241,1,voc,272567767,272568427,660,spec2/voc/Bl122_272567767.jpg,Bl122,0
10885.581162,10885.645162,1,voc,326567434,326569354,1920,spec2/voc/Bl122_326567434.jpg,Bl122,0
13763.220895,13763.225895,1,voc,412896626,412896776,150,spec2/voc/Bl122_412896626.jpg,Bl122,0
11208.457894,11208.481894,1,voc,336253736,336254456,720,spec2/voc/Bl122_336253736.jpg,Bl122,0
9128.911981,9128.945981,1,voc,273867359,273868379,1020,spec2/voc/Bl122_273867359.jpg,Bl122,0
6112.169706,6112.362706,1,voc,183365091,183370881,5790,spec2/voc/Bl122_183365091.jpg,Bl122,0
13204.597389,13204.619389,1,voc,396137921,396138581,660,spec2/voc/Bl122_396137921.jpg,Bl122,0
5287.935292,5288.164292,1,voc,158638058,158644928,6870,spec2/voc/Bl122_158638058.jpg,Bl122,0
7984.219748,7984.240748,1,voc,239526592,239527222,630,spec2/voc/Bl122_239526592.jpg,Bl122,0
8914.148773,8914.151773,1,voc,267424463,267424553,90,spec2/voc/Bl122_267424463.jpg,Bl122,0
11155.42218,11155.42918,1,voc,334662665,334662875,210,spec2/voc/Bl122_334662665.jpg,Bl122,0
6134.703293,6134.718293,1,voc,184041098,184041548,450,spec2/voc/Bl122_184041098.jpg,Bl122,0
5999.500256,5999.507256,1,voc,179985007,179985217,210,spec2/voc/Bl122_179985007.jpg,Bl122,1
6060.262705,6060.338705,1,voc,181807881,181810161,2280,spec2/voc/Bl122_181807881.jpg,Bl122,1
7985.297748,7985.301748,1,voc,239558932,239559052,120,spec2/voc/Bl122_239558932.jpg,Bl122,1
3797.679649,3797.683649,1,voc,113930389,113930509,120,spec2/voc/Bl122_113930389.jpg,Bl122,1
8998.498241,8999.123241,1,voc,269954947,269973697,18750,spec2/voc/Bl122_269954947.jpg,Bl122,1
5944.713256,5944.748256,1,voc,178341397,178342447,1050,spec2/voc/Bl122_178341397.jpg,Bl122,1
8924.360773,8924.366773,1,voc,267730823,267731003,180,spec2/voc/Bl122_267730823.jpg,Bl122,1
13221.059389,13221.066389,1,voc,396631781,396631991,210,spec2/voc/Bl122_396631781.jpg,Bl122,1
6077.050705,6077.139705,1,voc,182311521,182314191,2670,spec2/voc/Bl122_182311521.jpg,Bl122,1
8014.724748,8014.733748,1,voc,240441742,240442012,270,spec2/voc/Bl122_240441742.jpg,Bl122,1
7886.170748,7886.176748,1,voc,236585122,236585302,180,spec2/voc/Bl122_236585122.jpg,Bl122,1
5972.565256,5972.581256,1,voc,179176957,179177437,480,spec2/voc/Bl122_179176957.jpg,Bl122,1
13207.611389,13207.618389,1,voc,396228341,396228551,210,spec2/voc/Bl122_396228341.jpg,Bl122,1
14805.527551,14805.641551,1,voc,444165826,444169246,3420,spec2/voc/Bl122_444165826.jpg,Bl122,1
3892.739652,3892.791652,1,voc,116782189,116783749,1560,spec2/voc/Bl122_116782189.jpg,Bl122,1
13973.630117,13973.739117,1,voc,419208903,419212173,3270,spec2/voc/Bl122_419208903.jpg,Bl122,1
5972.096256,5972.100256,1,voc,179162887,179163007,120,spec2/voc/Bl122_179162887.jpg,Bl122,1
11889.101845,11889.103845,1,voc,356673055,356673115,60,spec2/voc/Bl122_356673055.jpg,Bl122,1
9058.068241,9058.103241,1,voc,271742047,271743097,1050,spec2/voc/Bl122_271742047.jpg,Bl122,1
5987.548256,5987.552256,1,voc,179626447,179626567,120,spec2/voc/Bl122_179626447.jpg,Bl122,1
13956.633384,13956.649384,1,voc,418699001,418699481,480,spec2/voc/Bl122_418699001.jpg,Bl122,1
6026.171533,6026.185533,1,voc,180785145,180785565,420,spec2/voc/Bl122_180785145.jpg,Bl122,1
8195.50775,8195.55575,1,voc,245865232,245866672,1440,spec2/voc/Bl122_245865232.jpg,Bl122,1
10879.525609,10879.710609,1,voc,326385768,326391318,5550,spec2/voc/Bl122_326385768.jpg,Bl122,1
5944.112256,5944.115256,1,voc,178323367,178323457,90,spec2/voc/Bl122_178323367.jpg,Bl122,1
8921.525773,8921.606773,1,voc,267645773,267648203,2430,spec2/voc/Bl122_267645773.jpg,Bl122,1
7908.619748,7908.628748,1,voc,237258592,237258862,270,spec2/voc/Bl122_237258592.jpg,Bl122,1
5987.208256,5987.216256,1,voc,179616247,179616487,240,spec2/voc/Bl122_179616247.jpg,Bl122,1
3894.032652,3894.121652,1,voc,116820979,116823649,2670,spec2/voc/Bl122_116820979.jpg,Bl122,1
13953.016911,13953.227911,1,voc,418590507,418596837,6330,spec2/voc/Bl122_418590507.jpg,Bl122,1
9042.977241,9043.296241,1,voc,271289317,271298887,9570,spec2/voc/Bl122_271289317.jpg,Bl122,1
6051.3092,6051.3212,1,voc,181539276,181539636,360,spec2/voc/Bl122_181539276.jpg,Bl122,1
8998.021241,8998.057241,1,voc,269940637,269941717,1080,spec2/voc/Bl122_269940637.jpg,Bl122,1
6075.578705,6076.006705,1,voc,182267361,182280201,12840,spec2/voc/Bl122_182267361.jpg,Bl122,1
3809.633649,3809.705649,1,voc,114289009,114291169,2160,spec2/voc/Bl122_114289009.jpg,Bl122,1
8966.688712,8966.699712,1,voc,269000661,269000991,330,spec2/voc/Bl122_269000661.jpg,Bl122,1
14812.366551,14812.426551,1,voc,444370996,444372796,1800,spec2/voc/Bl122_444370996.jpg,Bl122,1
13601.765736,13601.772736,1,voc,408052972,408053182,210,spec2/voc/Bl122_408052972.jpg,Bl122,1
6048.2122,6048.2142,1,voc,181446366,181446426,60,spec2/voc/Bl122_181446366.jpg,Bl122,1
3807.501649,3807.518649,1,voc,114225049,114225559,510,spec2/voc/Bl122_114225049.jpg,Bl122,1
10962.020807,10962.053807,1,voc,328860624,328861614,990,spec2/voc/Bl122_328860624.jpg,Bl122,1
6071.592705,6071.619705,1,voc,182147781,182148591,810,spec2/voc/Bl122_182147781.jpg,Bl122,1
5968.947256,5968.975256,1,voc,179068417,179069257,840,spec2/voc/Bl122_179068417.jpg,Bl122,1
9167.785604,9167.807604,1,voc,275033568,275034228,660,spec2/voc/Bl122_275033568.jpg,Bl122,1
6152.080349,6152.222349,1,voc,184562410,184566670,4260,spec2/voc/Bl122_184562410.jpg,Bl122,1
3819.595649,3819.602649,1,voc,114587869,114588079,210,spec2/voc/Bl122_114587869.jpg,Bl122,1
9057.661241,9057.672241,1,voc,271729837,271730167,330,spec2/voc/Bl122_271729837.jpg,Bl122,1
14201.732387,14201.799387,1,voc,426051971,426053981,2010,spec2/voc/Bl122_426051971.jpg,Bl122,1
13733.462497,13733.470497,1,voc,412003874,412004114,240,spec2/voc/Bl122_412003874.jpg,Bl122,1
3837.628415,3837.684415,1,voc,115128852,115130532,1680,spec2/voc/Bl122_115128852.jpg,Bl122,1
13938.3379,13938.3449,1,voc,418150137,418150347,210,spec2/voc/Bl122_418150137.jpg,Bl122,1
13827.13922,13827.14122,1,voc,414814176,414814236,60,spec2/voc/Bl122_414814176.jpg,Bl122,1
12591.517947,12591.548947,1,voc,377745538,377746468,930,spec2/voc/Bl122_377745538.jpg,Bl122,1
7846.343748,7846.355748,1,voc,235390312,235390672,360,spec2/voc/Bl122_235390312.jpg,Bl122,1
8110.323418,8110.335418,1,voc,243309702,243310062,360,spec2/voc/Bl122_243309702.jpg,Bl122,1
14826.077551,14826.114551,1,voc,444782326,444783436,1110,spec2/voc/Bl122_444782326.jpg,Bl122,1
5972.667256,5972.705256,1,voc,179180017,179181157,1140,spec2/voc/Bl122_179180017.jpg,Bl122,1
9080.659241,9080.877241,1,voc,272419777,272426317,6540,spec2/voc/Bl122_272419777.jpg,Bl122,1
5970.675256,5970.730256,1,voc,179120257,179121907,1650,spec2/voc/Bl122_179120257.jpg,Bl122,1
9050.177241,9050.194241,1,voc,271505317,271505827,510,spec2/voc/Bl122_271505317.jpg,Bl122,1
13163.817891,13163.826891,1,voc,394914536,394914806,270,spec2/voc/Bl122_394914536.jpg,Bl122,1
5964.771256,5964.971256,1,voc,178943137,178949137,6000,spec2/voc/Bl122_178943137.jpg,Bl122,1
7864.259748,7864.288748,1,voc,235927792,235928662,870,spec2/voc/Bl122_235927792.jpg,Bl122,1
14807.825551,14807.830551,1,voc,444234766,444234916,150,spec2/voc/Bl122_444234766.jpg,Bl122,1
13818.803617,13818.813617,1,voc,414564108,414564408,300,spec2/voc/Bl122_414564108.jpg,Bl122,1
6042.7902,6042.8262,1,voc,181283706,181284786,1080,spec2/voc/Bl122_181283706.jpg,Bl122,1
5986.056256,5986.070256,1,voc,179581687,179582107,420,spec2/voc/Bl122_179581687.jpg,Bl122,1
3806.892649,3806.935649,1,voc,114206779,114208069,1290,spec2/voc/Bl122_114206779.jpg,Bl122,1
6205.513327,6205.539327,1,voc,186165399,186166179,780,spec2/voc/Bl122_186165399.jpg,Bl122,1
7976.116748,7976.334748,1,voc,239283502,239290042,6540,spec2/voc/Bl122_239283502.jpg,Bl122,1
8015.413748,8015.471748,1,voc,240462412,240464152,1740,spec2/voc/Bl122_240462412.jpg,Bl122,1
3842.115415,3842.143415,1,voc,115263462,115264302,840,spec2/voc/Bl122_115263462.jpg,Bl122,1
8920.775773,8920.787773,1,voc,267623273,267623633,360,spec2/voc/Bl122_267623273.jpg,Bl122,1
6226.965295,6227.011295,1,voc,186808958,186810338,1380,spec2/voc/Bl122_186808958.jpg,Bl122,1
6019.223533,6019.227533,1,voc,180576705,180576825,120,spec2/voc/Bl122_180576705.jpg,Bl122,1
13217.830389,13217.836389,1,voc,396534911,396535091,180,spec2/voc/Bl122_396534911.jpg,Bl122,1
6097.99415,6098.14815,1,voc,182939824,182944444,4620,spec2/voc/Bl122_182939824.jpg,Bl122,1
6124.007706,6124.080706,1,voc,183720231,183722421,2190,spec2/voc/Bl122_183720231.jpg,Bl122,1
13732.938497,13733.010497,1,voc,411988154,411990314,2160,spec2/voc/Bl122_411988154.jpg,Bl122,1
12666.713394,12666.881394,1,voc,380001401,380006441,5040,spec2/voc/Bl122_380001401.jpg,Bl122,1
9078.976241,9079.003241,1,voc,272369287,272370097,810,spec2/voc/Bl122_272369287.jpg,Bl122,1
14796.677551,14796.685551,1,voc,443900326,443900566,240,spec2/voc/Bl122_443900326.jpg,Bl122,1
8017.510748,8017.528748,1,voc,240525322,240525862,540,spec2/voc/Bl122_240525322.jpg,Bl122,1
14141.015328,14141.267328,1,voc,424230459,424238019,7560,spec2/voc/Bl122_424230459.jpg,Bl122,1
8921.015773,8921.077773,1,voc,267630473,267632333,1860,spec2/voc/Bl122_267630473.jpg,Bl122,1
8981.087025,8981.137025,1,voc,269432610,269434110,1500,spec2/voc/Bl122_269432610.jpg,Bl122,1
13179.968701,13180.007701,1,voc,395399061,395400231,1170,spec2/voc/Bl122_395399061.jpg,Bl122,1
7901.320748,7901.713748,1,voc,237039622,237051412,11790,spec2/voc/Bl122_237039622.jpg,Bl122,1
9042.425241,9042.453241,1,voc,271272757,271273597,840,spec2/voc/Bl122_271272757.jpg,Bl122,1
8031.959748,8032.070748,1,voc,240958792,240962122,3330,spec2/voc/Bl122_240958792.jpg,Bl122,1
7961.403748,7961.406748,1,voc,238842112,238842202,90,spec2/voc/Bl122_238842112.jpg,Bl122,1
11914.834799,11914.836799,1,voc,357445043,357445103,60,spec2/voc/Bl122_357445043.jpg,Bl122,1
7972.250748,7972.255748,1,voc,239167522,239167672,150,spec2/voc/Bl122_239167522.jpg,Bl122,1
8035.841748,8035.846748,1,voc,241075252,241075402,150,spec2/voc/Bl122_241075252.jpg,Bl122,1
5984.270256,5984.278256,1,voc,179528107,179528347,240,spec2/voc/Bl122_179528107.jpg,Bl122,1
7842.591748,7842.627748,1,voc,235277752,235278832,1080,spec2/voc/Bl122_235277752.jpg,Bl122,1
7945.005748,7945.010748,1,voc,238350172,238350322,150,spec2/voc/Bl122_238350172.jpg,Bl122,1
13154.886774,13155.036774,1,voc,394646603,394651103,4500,spec2/voc/Bl122_394646603.jpg,Bl122,1
9020.797241,9020.799241,1,voc,270623917,270623977,60,spec2/voc/Bl122_270623917.jpg,Bl122,1
5954.474256,5954.485256,1,voc,178634227,178634557,330,spec2/voc/Bl122_178634227.jpg,Bl122,1
6134.571293,6134.626293,1,voc,184037138,184038788,1650,spec2/voc/Bl122_184037138.jpg,Bl122,1
9099.815241,9099.858241,1,voc,272994457,272995747,1290,spec2/voc/Bl122_272994457.jpg,Bl122,1
3820.588649,3820.595649,1,voc,114617659,114617869,210,spec2/voc/Bl122_114617659.jpg,Bl122,1
14805.004551,14805.018551,1,voc,444150136,444150556,420,spec2/voc/Bl122_444150136.jpg,Bl122,1
6136.150293,6136.376293,1,voc,184084508,184091288,6780,spec2/voc/Bl122_184084508.jpg,Bl122,1
6098.40115,6098.41415,1,voc,182952034,182952424,390,spec2/voc/Bl122_182952034.jpg,Bl122,1
13827.14622,13827.15022,1,voc,414814386,414814506,120,spec2/voc/Bl122_414814386.jpg,Bl122,1
3846.030415,3846.040415,1,voc,115380912,115381212,300,spec2/voc/Bl122_115380912.jpg,Bl122,1
8019.642748,8019.672748,1,voc,240589282,240590182,900,spec2/voc/Bl122_240589282.jpg,Bl122,1
12639.485849,12639.558849,1,voc,379184575,379186765,2190,spec2/voc/Bl122_379184575.jpg,Bl122,1
14808.899551,14808.922551,1,voc,444266986,444267676,690,spec2/voc/Bl122_444266986.jpg,Bl122,1
6049.0332,6049.2782,1,voc,181470996,181478346,7350,spec2/voc/Bl122_181470996.jpg,Bl122,1
8967.454712,8967.474712,1,voc,269023641,269024241,600,spec2/voc/Bl122_269023641.jpg,Bl122,1
8015.803748,8015.809748,1,voc,240474112,240474292,180,spec2/voc/Bl122_240474112.jpg,Bl122,1
11173.34618,11173.41018,1,voc,335200385,335202305,1920,spec2/voc/Bl122_335200385.jpg,Bl122,1
12591.433947,12591.441947,1,voc,377743018,377743258,240,spec2/voc/Bl122_377743018.jpg,Bl122,1
5973.954256,5973.959256,1,voc,179218627,179218777,150,spec2/voc/Bl122_179218627.jpg,Bl122,1
13983.906943,13983.910943,1,voc,419517208,419517328,120,spec2/voc/Bl122_419517208.jpg,Bl122,1
9078.187241,9078.192241,1,voc,272345617,272345767,150,spec2/voc/Bl122_272345617.jpg,Bl122,1
6192.920327,6192.948327,1,voc,185787609,185788449,840,spec2/voc/Bl122_185787609.jpg,Bl122,1
13541.804816,13541.810816,1,voc,406254144,406254324,180,spec2/voc/Bl122_406254144.jpg,Bl122,1
8944.494967,8944.498967,1,voc,268334849,268334969,120,spec2/voc/Bl122_268334849.jpg,Bl122,1
11206.652894,11206.680894,1,voc,336199586,336200426,840,spec2/voc/Bl122_336199586.jpg,Bl122,1
5965.092256,5965.099256,1,voc,178952767,178952977,210,spec2/voc/Bl122_178952767.jpg,Bl122,1
11194.92718,11194.95718,1,voc,335847815,335848715,900,spec2/voc/Bl122_335847815.jpg,Bl122,1
14815.127551,14815.156551,1,voc,444453826,444454696,870,spec2/voc/Bl122_444453826.jpg,Bl122,1
3895.967652,3895.970652,1,voc,116879029,116879119,90,spec2/voc/Bl122_116879029.jpg,Bl122,1
8019.907748,8019.916748,1,voc,240597232,240597502,270,spec2/voc/Bl122_240597232.jpg,Bl122,1
5970.815256,5970.822256,1,voc,179124457,179124667,210,spec2/voc/Bl122_179124457.jpg,Bl122,1
13818.879617,13818.884617,1,voc,414566388,414566538,150,spec2/voc/Bl122_414566388.jpg,Bl122,1
8978.854025,8978.856025,1,voc,269365620,269365680,60,spec2/voc/Bl122_269365620.jpg,Bl122,1
3831.590649,3831.594649,1,voc,114947719,114947839,120,spec2/voc/Bl122_114947719.jpg,Bl122,1
5947.218256,5947.235256,1,voc,178416547,178417057,510,spec2/voc/Bl122_178416547.jpg,Bl122,1
9128.269981,9128.272981,1,voc,273848099,273848189,90,spec2/voc/Bl122_273848099.jpg,Bl122,1
6028.556533,6028.560533,1,voc,180856695,180856815,120,spec2/voc/Bl122_180856695.jpg,Bl122,1
13201.217389,13201.222389,1,voc,396036521,396036671,150,spec2/voc/Bl122_396036521.jpg,Bl122,1
11125.989005,11126.004005,1,voc,333779670,333780120,450,spec2/voc/Bl122_333779670.jpg,Bl122,1
7901.132481,7901.178481,1,voc,237033974,237035354,1380,spec2/voc/Bl122_237033974.jpg,Bl122,1
8031.623748,8031.628748,1,voc,240948712,240948862,150,spec2/voc/Bl122_240948712.jpg,Bl122,1
3176.406448,3176.409448,1,voc,95292193,95292283,90,spec2/voc/Bl122_95292193.jpg,Bl122,1
13968.980352,13969.021352,1,voc,419069410,419070640,1230,spec2/voc/Bl122_419069410.jpg,Bl122,1
14645.174676,14645.379676,1,voc,439355240,439361390,6150,spec2/voc/Bl122_439355240.jpg,Bl122,1
7882.873748,7882.877748,1,voc,236486212,236486332,120,spec2/voc/Bl122_236486212.jpg,Bl122,1
3812.793649,3812.823649,1,voc,114383809,114384709,900,spec2/voc/Bl122_114383809.jpg,Bl122,1
13958.844384,13958.847384,1,voc,418765331,418765421,90,spec2/voc/Bl122_418765331.jpg,Bl122,1
13208.786389,13208.790389,1,voc,396263591,396263711,120,spec2/voc/Bl122_396263591.jpg,Bl122,1
6155.425349,6155.543349,1,voc,184662760,184666300,3540,spec2/voc/Bl122_184662760.jpg,Bl122,1
3891.966652,3892.112652,1,voc,116758999,116763379,4380,spec2/voc/Bl122_116758999.jpg,Bl122,1
5972.595256,5972.624256,1,voc,179177857,179178727,870,spec2/voc/Bl122_179177857.jpg,Bl122,1
3854.677415,3854.681415,1,voc,115640322,115640442,120,spec2/voc/Bl122_115640322.jpg,Bl122,1
6098.68615,6098.69815,1,voc,182960584,182960944,360,spec2/voc/Bl122_182960584.jpg,Bl122,1
5963.511256,5963.536256,1,voc,178905337,178906087,750,spec2/voc/Bl122_178905337.jpg,Bl122,1
5958.208256,5958.224256,1,voc,178746247,178746727,480,spec2/voc/Bl122_178746247.jpg,Bl122,1
14709.812469,14709.855469,1,voc,441294374,441295664,1290,spec2/voc/Bl122_441294374.jpg,Bl122,1
3860.979367,3860.985367,1,voc,115829381,115829561,180,spec2/voc/Bl122_115829381.jpg,Bl122,1
5982.306256,5982.365256,1,voc,179469187,179470957,1770,spec2/voc/Bl122_179469187.jpg,Bl122,1
9005.009241,9005.348241,1,voc,270150277,270160447,10170,spec2/voc/Bl122_270150277.jpg,Bl122,1
13193.355662,13193.359662,1,voc,395800669,395800789,120,spec2/voc/Bl122_395800669.jpg,Bl122,1
8964.476712,8964.524712,1,voc,268934301,268935741,1440,spec2/voc/Bl122_268934301.jpg,Bl122,1
5956.502256,5956.523256,1,voc,178695067,178695697,630,spec2/voc/Bl122_178695067.jpg,Bl122,1
13206.931389,13206.938389,1,voc,396207941,396208151,210,spec2/voc/Bl122_396207941.jpg,Bl122,1
14811.057551,14811.061551,1,voc,444331726,444331846,120,spec2/voc/Bl122_444331726.jpg,Bl122,1
6170.549327,6170.566327,1,voc,185116479,185116989,510,spec2/voc/Bl122_185116479.jpg,Bl122,1
10888.295136,10888.462136,1,voc,326648854,326653864,5010,spec2/voc/Bl122_326648854.jpg,Bl122,1
7842.258748,7842.293748,1,voc,235267762,235268812,1050,spec2/voc/Bl122_235267762.jpg,Bl122,1
9161.498057,9161.551057,1,voc,274844941,274846531,1590,spec2/voc/Bl122_274844941.jpg,Bl122,1
14838.529682,14838.566682,1,voc,445155890,445157000,1110,spec2/voc/Bl122_445155890.jpg,Bl122,1
13217.899389,13217.906389,1,voc,396536981,396537191,210,spec2/voc/Bl122_396536981.jpg,Bl122,1
13587.897236,13587.997236,1,voc,407636917,407639917,3000,spec2/voc/Bl122_407636917.jpg,Bl122,1
11180.42118,11180.42918,1,voc,335412635,335412875,240,spec2/voc/Bl122_335412635.jpg,Bl122,1
7915.606931,7915.631931,1,voc,237468207,237468957,750,spec2/voc/Bl122_237468207.jpg,Bl122,1
10921.476807,10921.498807,1,voc,327644304,327644964,660,spec2/voc/Bl122_327644304.jpg,Bl122,1
11205.964894,11206.060894,1,voc,336178946,336181826,2880,spec2/voc/Bl122_336178946.jpg,Bl122,1
7807.329748,7807.334748,1,voc,234219892,234220042,150,spec2/voc/Bl122_234219892.jpg,Bl122,1
9162.056057,9162.075057,1,voc,274861681,274862251,570,spec2/voc/Bl122_274861681.jpg,Bl122,1
10917.083807,10917.089807,1,voc,327512514,327512694,180,spec2/voc/Bl122_327512514.jpg,Bl122,1
3883.133062,3883.138062,1,voc,116493991,116494141,150,spec2/voc/Bl122_116493991.jpg,Bl122,1
7975.412748,7975.416748,1,voc,239262382,239262502,120,spec2/voc/Bl122_239262382.jpg,Bl122,1
9056.735241,9056.765241,1,voc,271702057,271702957,900,spec2/voc/Bl122_271702057.jpg,Bl122,1
6131.342293,6131.345293,1,voc,183940268,183940358,90,spec2/voc/Bl122_183940268.jpg,Bl122,1
6094.31915,6094.32815,1,voc,182829574,182829844,270,spec2/voc/Bl122_182829574.jpg,Bl122,1
3865.213367,3865.341367,1,voc,115956401,115960241,3840,spec2/voc/Bl122_115956401.jpg,Bl122,1
14790.601551,14790.603551,1,voc,443718046,443718106,60,spec2/voc/Bl122_443718046.jpg,Bl122,1
3884.669062,3884.700062,1,voc,116540071,116541001,930,spec2/voc/Bl122_116540071.jpg,Bl122,1
13829.419664,13829.532664,1,voc,414882589,414885979,3390,spec2/voc/Bl122_414882589.jpg,Bl122,1
10904.415825,10904.418825,1,voc,327132474,327132564,90,spec2/voc/Bl122_327132474.jpg,Bl122,1
13933.472118,13933.612118,1,voc,418004163,418008363,4200,spec2/voc/Bl122_418004163.jpg,Bl122,1
10950.360807,10950.374807,1,voc,328510824,328511244,420,spec2/voc/Bl122_328510824.jpg,Bl122,1
13919.075483,13919.119483,1,voc,417572264,417573584,1320,spec2/voc/Bl122_417572264.jpg,Bl122,1
6160.052349,6160.113349,1,voc,184801570,184803400,1830,spec2/voc/Bl122_184801570.jpg,Bl122,1
13604.769736,13604.890736,1,voc,408143092,408146722,3630,spec2/voc/Bl122_408143092.jpg,Bl122,1
10947.316807,10947.321807,1,voc,328419504,328419654,150,spec2/voc/Bl122_328419504.jpg,Bl122,1
6121.546706,6121.570706,1,voc,183646401,183647121,720,spec2/voc/Bl122_183646401.jpg,Bl122,1
14841.569682,14841.574682,1,voc,445247090,445247240,150,spec2/voc/Bl122_445247090.jpg,Bl122,1
7939.463748,7939.465748,1,voc,238183912,238183972,60,spec2/voc/Bl122_238183912.jpg,Bl122,1
6025.550533,6025.572533,1,voc,180766515,180767175,660,spec2/voc/Bl122_180766515.jpg,Bl122,1
8020.194748,8020.262748,1,voc,240605842,240607882,2040,spec2/voc/Bl122_240605842.jpg,Bl122,1
6030.741533,6030.781533,1,voc,180922245,180923445,1200,spec2/voc/Bl122_180922245.jpg,Bl122,1
13244.586606,13244.590606,1,voc,397337598,397337718,120,spec2/voc/Bl122_397337598.jpg,Bl122,1
5994.547256,5994.663256,1,voc,179836417,179839897,3480,spec2/voc/Bl122_179836417.jpg,Bl122,1
7975.854748,7975.963748,1,voc,239275642,239278912,3270,spec2/voc/Bl122_239275642.jpg,Bl122,1
14155.248825,14155.253825,1,voc,424657464,424657614,150,spec2/voc/Bl122_424657464.jpg,Bl122,1
7845.371748,7845.374748,1,voc,235361152,235361242,90,spec2/voc/Bl122_235361152.jpg,Bl122,1
9056.376241,9056.446241,1,voc,271691287,271693387,2100,spec2/voc/Bl122_271691287.jpg,Bl122,1
11126.130005,11126.269005,1,voc,333783900,333788070,4170,spec2/voc/Bl122_333783900.jpg,Bl122,1
8924.247773,8924.256773,1,voc,267727433,267727703,270,spec2/voc/Bl122_267727433.jpg,Bl122,1
9012.048241,9012.249241,1,voc,270361447,270367477,6030,spec2/voc/Bl122_270361447.jpg,Bl122,1
6187.800327,6187.861327,1,voc,185634009,185635839,1830,spec2/voc/Bl122_185634009.jpg,Bl122,1
8213.077724,8213.124724,1,voc,246392331,246393741,1410,spec2/voc/Bl122_246392331.jpg,Bl122,1
3793.568649,3793.586649,1,voc,113807059,113807599,540,spec2/voc/Bl122_113807059.jpg,Bl122,1
11159.19218,11159.20018,1,voc,334775765,334776005,240,spec2/voc/Bl122_334775765.jpg,Bl122,1
6120.284706,6120.362706,1,voc,183608541,183610881,2340,spec2/voc/Bl122_183608541.jpg,Bl122,1
6137.299293,6137.309293,1,voc,184118978,184119278,300,spec2/voc/Bl122_184118978.jpg,Bl122,1
6018.133533,6018.595533,1,voc,180544005,180557865,13860,spec2/voc/Bl122_180544005.jpg,Bl122,1
7850.531748,7850.538748,1,voc,235515952,235516162,210,spec2/voc/Bl122_235515952.jpg,Bl122,1
3844.907415,3844.923415,1,voc,115347222,115347702,480,spec2/voc/Bl122_115347222.jpg,Bl122,1
7820.071748,7820.081748,1,voc,234602152,234602452,300,spec2/voc/Bl122_234602152.jpg,Bl122,1
11953.577309,11953.581309,1,voc,358607319,358607439,120,spec2/voc/Bl122_358607319.jpg,Bl122,1
9003.297241,9003.299241,1,voc,270098917,270098977,60,spec2/voc/Bl122_270098917.jpg,Bl122,1
5941.763256,5941.824256,1,voc,178252897,178254727,1830,spec2/voc/Bl122_178252897.jpg,Bl122,1
14796.792551,14796.823551,1,voc,443903776,443904706,930,spec2/voc/Bl122_443903776.jpg,Bl122,1
3839.606415,3839.613415,1,voc,115188192,115188402,210,spec2/voc/Bl122_115188192.jpg,Bl122,1
8917.045773,8917.055773,1,voc,267511373,267511673,300,spec2/voc/Bl122_267511373.jpg,Bl122,1
8923.393773,8923.398773,1,voc,267701813,267701963,150,spec2/voc/Bl122_267701813.jpg,Bl122,1
6169.880327,6169.889327,1,voc,185096409,185096679,270,spec2/voc/Bl122_185096409.jpg,Bl122,1
12828.671025,12828.727025,1,voc,384860130,384861810,1680,spec2/voc/Bl122_384860130.jpg,Bl122,1
13601.878736,13601.907736,1,voc,408056362,408057232,870,spec2/voc/Bl122_408056362.jpg,Bl122,1
7902.421748,7902.432748,1,voc,237072652,237072982,330,spec2/voc/Bl122_237072652.jpg,Bl122,1
14819.489551,14819.507551,1,voc,444584686,444585226,540,spec2/voc/Bl122_444584686.jpg,Bl122,1
5983.594256,5983.668256,1,voc,179507827,179510047,2220,spec2/voc/Bl122_179507827.jpg,Bl122,1
7820.045748,7820.065748,1,voc,234601372,234601972,600,spec2/voc/Bl122_234601372.jpg,Bl122,1
6030.363533,6030.421533,1,voc,180910905,180912645,1740,spec2/voc/Bl122_180910905.jpg,Bl122,1
7900.267748,7900.271748,1,voc,237008032,237008152,120,spec2/voc/Bl122_237008032.jpg,Bl122,1
3799.695649,3799.709649,1,voc,113990869,113991289,420,spec2/voc/Bl122_113990869.jpg,Bl122,1
7866.878748,7866.902748,1,voc,236006362,236007082,720,spec2/voc/Bl122_236006362.jpg,Bl122,1
11141.673955,11141.735955,1,voc,334250218,334252078,1860,spec2/voc/Bl122_334250218.jpg,Bl122,1
8966.227712,8966.237712,1,voc,268986831,268987131,300,spec2/voc/Bl122_268986831.jpg,Bl122,1
6138.222293,6138.225293,1,voc,184146668,184146758,90,spec2/voc/Bl122_184146668.jpg,Bl122,1
6075.015705,6075.017705,1,voc,182250471,182250531,60,spec2/voc/Bl122_182250471.jpg,Bl122,1
7832.177748,7832.180748,1,voc,234965332,234965422,90,spec2/voc/Bl122_234965332.jpg,Bl122,1
6106.064706,6106.074706,1,voc,183181941,183182241,300,spec2/voc/Bl122_183181941.jpg,Bl122,1
11184.82318,11184.86118,1,voc,335544695,335545835,1140,spec2/voc/Bl122_335544695.jpg,Bl122,1
7975.419748,7975.425748,1,voc,239262592,239262772,180,spec2/voc/Bl122_239262592.jpg,Bl122,1
3827.157649,3827.486649,1,voc,114814729,114824599,9870,spec2/voc/Bl122_114814729.jpg,Bl122,1
6081.442511,6081.471511,1,voc,182443275,182444145,870,spec2/voc/Bl122_182443275.jpg,Bl122,1
7998.824748,7998.828748,1,voc,239964742,239964862,120,spec2/voc/Bl122_239964742.jpg,Bl122,1
7899.141748,7899.144748,1,voc,236974252,236974342,90,spec2/voc/Bl122_236974252.jpg,Bl122,1
7948.124748,7948.147748,1,voc,238443742,238444432,690,spec2/voc/Bl122_238443742.jpg,Bl122,1
6075.407705,6075.409705,1,voc,182262231,182262291,60,spec2/voc/Bl122_182262231.jpg,Bl122,1
6125.240706,6125.268706,1,voc,183757221,183758061,840,spec2/voc/Bl122_183757221.jpg,Bl122,1
13218.247389,13218.304389,1,voc,396547421,396549131,1710,spec2/voc/Bl122_396547421.jpg,Bl122,1
10948.114807,10948.193807,1,voc,328443444,328445814,2370,spec2/voc/Bl122_328443444.jpg,Bl122,1
3855.603415,3855.606415,1,voc,115668102,115668192,90,spec2/voc/Bl122_115668102.jpg,Bl122,1
8020.095748,8020.150748,1,voc,240602872,240604522,1650,spec2/voc/Bl122_240602872.jpg,Bl122,1
9065.988241,9066.005241,1,voc,271979647,271980157,510,spec2/voc/Bl122_271979647.jpg,Bl122,1
12933.15829,12933.23229,1,voc,387994748,387996968,2220,spec2/voc/Bl122_387994748.jpg,Bl122,1
9004.205241,9004.212241,1,voc,270126157,270126367,210,spec2/voc/Bl122_270126157.jpg,Bl122,1
6148.191349,6148.203349,1,voc,184445740,184446100,360,spec2/voc/Bl122_184445740.jpg,Bl122,1
3896.171652,3896.186652,1,voc,116885149,116885599,450,spec2/voc/Bl122_116885149.jpg,Bl122,1
7915.757931,7916.032931,1,voc,237472737,237480987,8250,spec2/voc/Bl122_237472737.jpg,Bl122,1
13180.425701,13180.429701,1,voc,395412771,395412891,120,spec2/voc/Bl122_395412771.jpg,Bl122,1
8014.925748,8015.004748,1,voc,240447772,240450142,2370,spec2/voc/Bl122_240447772.jpg,Bl122,1
11208.651894,11208.659894,1,voc,336259556,336259796,240,spec2/voc/Bl122_336259556.jpg,Bl122,1
14795.274551,14795.278551,1,voc,443858236,443858356,120,spec2/voc/Bl122_443858236.jpg,Bl122,1
13988.925864,13988.933864,1,voc,419667775,419668015,240,spec2/voc/Bl122_419667775.jpg,Bl122,1
8920.669773,8920.678773,1,voc,267620093,267620363,270,spec2/voc/Bl122_267620093.jpg,Bl122,1
7915.648748,7915.673748,1,voc,237469462,237470212,750,spec2/voc/Bl122_237469462.jpg,Bl122,1
6125.743706,6125.749706,1,voc,183772311,183772491,180,spec2/voc/Bl122_183772311.jpg,Bl122,1
9078.337241,9078.344241,1,voc,272350117,272350327,210,spec2/voc/Bl122_272350117.jpg,Bl122,1
7943.714748,7943.740748,1,voc,238311442,238312222,780,spec2/voc/Bl122_238311442.jpg,Bl122,1
10959.575807,10959.579807,1,voc,328787274,328787394,120,spec2/voc/Bl122_328787274.jpg,Bl122,1
3839.054415,3839.437415,1,voc,115171632,115183122,11490,spec2/voc/Bl122_115171632.jpg,Bl122,1
5952.792256,5952.795256,1,voc,178583767,178583857,90,spec2/voc/Bl122_178583767.jpg,Bl122,1
8981.335025,8981.347025,1,voc,269440050,269440410,360,spec2/voc/Bl122_269440050.jpg,Bl122,1
13151.642729,13151.701729,1,voc,394549281,394551051,1770,spec2/voc/Bl122_394549281.jpg,Bl122,1
7976.758748,7976.764748,1,voc,239302762,239302942,180,spec2/voc/Bl122_239302762.jpg,Bl122,1
7885.628748,7885.658748,1,voc,236568862,236569762,900,spec2/voc/Bl122_236568862.jpg,Bl122,1
8207.243882,8207.288882,1,voc,246217316,246218666,1350,spec2/voc/Bl122_246217316.jpg,Bl122,1
13140.421936,13140.620936,1,voc,394212658,394218628,5970,spec2/voc/Bl122_394212658.jpg,Bl122,1
9064.502241,9064.525241,1,voc,271935067,271935757,690,spec2/voc/Bl122_271935067.jpg,Bl122,1
6027.700533,6027.732533,1,voc,180831015,180831975,960,spec2/voc/Bl122_180831015.jpg,Bl122,1
8208.073882,8208.203882,1,voc,246242216,246246116,3900,spec2/voc/Bl122_246242216.jpg,Bl122,1
9007.790241,9007.846241,1,voc,270233707,270235387,1680,spec2/voc/Bl122_270233707.jpg,Bl122,1
6155.545349,6155.582349,1,voc,184666360,184667470,1110,spec2/voc/Bl122_184666360.jpg,Bl122,1
8951.298967,8951.315967,1,voc,268538969,268539479,510,spec2/voc/Bl122_268538969.jpg,Bl122,1
6147.044349,6147.056349,1,voc,184411330,184411690,360,spec2/voc/Bl122_184411330.jpg,Bl122,1
9070.020241,9070.033241,1,voc,272100607,272100997,390,spec2/voc/Bl122_272100607.jpg,Bl122,1
14015.330222,14015.382222,1,voc,420459906,420461466,1560,spec2/voc/Bl122_420459906.jpg,Bl122,1
8918.554773,8918.559773,1,voc,267556643,267556793,150,spec2/voc/Bl122_267556643.jpg,Bl122,1
5944.234256,5944.256256,1,voc,178327027,178327687,660,spec2/voc/Bl122_178327027.jpg,Bl122,1
9131.069981,9131.128981,1,voc,273932099,273933869,1770,spec2/voc/Bl122_273932099.jpg,Bl122,1
3810.162649,3810.181649,1,voc,114304879,114305449,570,spec2/voc/Bl122_114304879.jpg,Bl122,1
10931.062807,10931.070807,1,voc,327931884,327932124,240,spec2/voc/Bl122_327931884.jpg,Bl122,1
3823.926649,3824.046649,1,voc,114717799,114721399,3600,spec2/voc/Bl122_114717799.jpg,Bl122,1
3394.946689,3394.972689,1,voc,101848400,101849180,780,spec2/voc/Bl122_101848400.jpg,Bl122,1
7910.260748,7910.267748,1,voc,237307822,237308032,210,spec2/voc/Bl122_237307822.jpg,Bl122,1
6095.66615,6095.84515,1,voc,182869984,182875354,5370,spec2/voc/Bl122_182869984.jpg,Bl122,1
8367.230166,8367.276166,1,voc,251016904,251018284,1380,spec2/voc/Bl122_251016904.jpg,Bl122,1
3811.126649,3811.211649,1,voc,114333799,114336349,2550,spec2/voc/Bl122_114333799.jpg,Bl122,1
5967.671256,5967.676256,1,voc,179030137,179030287,150,spec2/voc/Bl122_179030137.jpg,Bl122,1
11159.21718,11159.34118,1,voc,334776515,334780235,3720,spec2/voc/Bl122_334776515.jpg,Bl122,1
3796.072649,3796.293649,1,voc,113882179,113888809,6630,spec2/voc/Bl122_113882179.jpg,Bl122,1
7911.442748,7911.448748,1,voc,237343282,237343462,180,spec2/voc/Bl122_237343282.jpg,Bl122,1
5974.974256,5974.987256,1,voc,179249227,179249617,390,spec2/voc/Bl122_179249227.jpg,Bl122,1
13984.259943,13984.321943,1,voc,419527798,419529658,1860,spec2/voc/Bl122_419527798.jpg,Bl122,1
6198.814327,6198.881327,1,voc,185964429,185966439,2010,spec2/voc/Bl122_185964429.jpg,Bl122,1
8022.722748,8022.840748,1,voc,240681682,240685222,3540,spec2/voc/Bl122_240681682.jpg,Bl122,1
3846.775415,3846.808415,1,voc,115403262,115404252,990,spec2/voc/Bl122_115403262.jpg,Bl122,1
6062.128705,6062.132705,1,voc,181863861,181863981,120,spec2/voc/Bl122_181863861.jpg,Bl122,1
3854.418415,3854.421415,1,voc,115632552,115632642,90,spec2/voc/Bl122_115632552.jpg,Bl122,1
9142.827757,9142.881757,1,voc,274284832,274286452,1620,spec2/voc/Bl122_274284832.jpg,Bl122,1
13744.270896,13744.274896,1,voc,412328126,412328246,120,spec2/voc/Bl122_412328126.jpg,Bl122,1
8916.606773,8916.640773,1,voc,267498203,267499223,1020,spec2/voc/Bl122_267498203.jpg,Bl122,1
9030.490241,9030.528241,1,voc,270914707,270915847,1140,spec2/voc/Bl122_270914707.jpg,Bl122,1
3794.531649,3794.679649,1,voc,113835949,113840389,4440,spec2/voc/Bl122_113835949.jpg,Bl122,1
5991.730256,5991.757256,1,voc,179751907,179752717,810,spec2/voc/Bl122_179751907.jpg,Bl122,1
14805.647551,14805.681551,1,voc,444169426,444170446,1020,spec2/voc/Bl122_444169426.jpg,Bl122,1
11032.669132,11032.972132,1,voc,330980073,330989163,9090,spec2/voc/Bl122_330980073.jpg,Bl122,1
7895.070748,7895.083748,1,voc,236852122,236852512,390,spec2/voc/Bl122_236852122.jpg,Bl122,1
6130.735293,6130.800293,1,voc,183922058,183924008,1950,spec2/voc/Bl122_183922058.jpg,Bl122,1
6109.367706,6109.429706,1,voc,183281031,183282891,1860,spec2/voc/Bl122_183281031.jpg,Bl122,1
10905.458825,10905.489825,1,voc,327163764,327164694,930,spec2/voc/Bl122_327163764.jpg,Bl122,1
13206.305389,13206.311389,1,voc,396189161,396189341,180,spec2/voc/Bl122_396189161.jpg,Bl122,1
6154.675349,6154.725349,1,voc,184640260,184641760,1500,spec2/voc/Bl122_184640260.jpg,Bl122,1
9042.902241,9042.931241,1,voc,271287067,271287937,870,spec2/voc/Bl122_271287067.jpg,Bl122,1
8943.359967,8943.362967,1,voc,268300799,268300889,90,spec2/voc/Bl122_268300799.jpg,Bl122,1
11211.823894,11211.848894,1,voc,336354716,336355466,750,spec2/voc/Bl122_336354716.jpg,Bl122,1
14809.966551,14810.171551,1,voc,444298996,444305146,6150,spec2/voc/Bl122_444298996.jpg,Bl122,1
10953.397807,10953.425807,1,voc,328601934,328602774,840,spec2/voc/Bl122_328601934.jpg,Bl122,1
14154.359825,14154.364825,1,voc,424630794,424630944,150,spec2/voc/Bl122_424630794.jpg,Bl122,1
8919.149773,8919.157773,1,voc,267574493,267574733,240,spec2/voc/Bl122_267574493.jpg,Bl122,1
9007.538241,9007.688241,1,voc,270226147,270230647,4500,spec2/voc/Bl122_270226147.jpg,Bl122,1
14801.552551,14801.578551,1,voc,444046576,444047356,780,spec2/voc/Bl122_444046576.jpg,Bl122,1
10903.304825,10903.398825,1,voc,327099144,327101964,2820,spec2/voc/Bl122_327099144.jpg,Bl122,1
5945.189256,5945.192256,1,voc,178355677,178355767,90,spec2/voc/Bl122_178355677.jpg,Bl122,1
8026.159748,8026.162748,1,voc,240784792,240784882,90,spec2/voc/Bl122_240784792.jpg,Bl122,1
7802.195748,7802.197748,1,voc,234065872,234065932,60,spec2/voc/Bl122_234065872.jpg,Bl122,1
8947.047967,8947.064967,1,voc,268411439,268411949,510,spec2/voc/Bl122_268411439.jpg,Bl122,1
12661.090535,12661.143535,1,voc,379832716,379834306,1590,spec2/voc/Bl122_379832716.jpg,Bl122,1
11138.325955,11138.555955,1,voc,334149778,334156678,6900,spec2/voc/Bl122_334149778.jpg,Bl122,1
11894.849847,11895.097847,1,voc,356845495,356852935,7440,spec2/voc/Bl122_356845495.jpg,Bl122,1
6090.18215,6090.20115,1,voc,182705464,182706034,570,spec2/voc/Bl122_182705464.jpg,Bl122,1
5973.361256,5973.379256,1,voc,179200837,179201377,540,spec2/voc/Bl122_179200837.jpg,Bl122,1
6069.464705,6069.502705,1,voc,182083941,182085081,1140,spec2/voc/Bl122_182083941.jpg,Bl122,1
11163.98018,11163.98618,1,voc,334919405,334919585,180,spec2/voc/Bl122_334919405.jpg,Bl122,1
11169.02818,11169.26118,1,voc,335070845,335077835,6990,spec2/voc/Bl122_335070845.jpg,Bl122,1
9108.978935,9108.983935,1,voc,273269368,273269518,150,spec2/voc/Bl122_273269368.jpg,Bl122,1
7974.558748,7974.561748,1,voc,239236762,239236852,90,spec2/voc/Bl122_239236762.jpg,Bl122,1
6015.397533,6015.401533,1,voc,180461925,180462045,120,spec2/voc/Bl122_180461925.jpg,Bl122,1
8952.715967,8952.797967,1,voc,268581479,268583939,2460,spec2/voc/Bl122_268581479.jpg,Bl122,1
5986.382256,5986.404256,1,voc,179591467,179592127,660,spec2/voc/Bl122_179591467.jpg,Bl122,1
3826.299649,3826.306649,1,voc,114788989,114789199,210,spec2/voc/Bl122_114788989.jpg,Bl122,1
13580.137236,13580.172236,1,voc,407404117,407405167,1050,spec2/voc/Bl122_407404117.jpg,Bl122,1
9089.892241,9089.917241,1,voc,272696767,272697517,750,spec2/voc/Bl122_272696767.jpg,Bl122,1
13214.076389,13214.117389,1,voc,396422291,396423521,1230,spec2/voc/Bl122_396422291.jpg,Bl122,1
13222.869389,13222.888389,1,voc,396686081,396686651,570,spec2/voc/Bl122_396686081.jpg,Bl122,1
9052.105241,9052.111241,1,voc,271563157,271563337,180,spec2/voc/Bl122_271563157.jpg,Bl122,1
6092.49915,6092.58515,1,voc,182774974,182777554,2580,spec2/voc/Bl122_182774974.jpg,Bl122,1
8334.306758,8334.364758,1,voc,250029202,250030942,1740,spec2/voc/Bl122_250029202.jpg,Bl122,1
6097.96415,6097.98715,1,voc,182938924,182939614,690,spec2/voc/Bl122_182938924.jpg,Bl122,1
13659.456334,13659.484334,1,voc,409783690,409784530,840,spec2/voc/Bl122_409783690.jpg,Bl122,1
6093.04115,6093.07715,1,voc,182791234,182792314,1080,spec2/voc/Bl122_182791234.jpg,Bl122,1
8035.812748,8035.814748,1,voc,241074382,241074442,60,spec2/voc/Bl122_241074382.jpg,Bl122,1
6142.993349,6143.188349,1,voc,184289800,184295650,5850,spec2/voc/Bl122_184289800.jpg,Bl122,1
14802.281551,14802.299551,1,voc,444068446,444068986,540,spec2/voc/Bl122_444068446.jpg,Bl122,1
6021.735533,6021.739533,1,voc,180652065,180652185,120,spec2/voc/Bl122_180652065.jpg,Bl122,1
14836.614682,14836.624682,1,voc,445098440,445098740,300,spec2/voc/Bl122_445098440.jpg,Bl122,1
3889.537652,3889.553652,1,voc,116686129,116686609,480,spec2/voc/Bl122_116686129.jpg,Bl122,1
6104.006706,6104.012706,1,voc,183120201,183120381,180,spec2/voc/Bl122_183120201.jpg,Bl122,1
3868.454367,3868.658367,1,voc,116053631,116059751,6120,spec2/voc/Bl122_116053631.jpg,Bl122,1
7859.005748,7859.012748,1,voc,235770172,235770382,210,spec2/voc/Bl122_235770172.jpg,Bl122,1
11207.954894,11208.000894,1,voc,336238646,336240026,1380,spec2/voc/Bl122_336238646.jpg,Bl122,1
14822.635551,14822.650551,1,voc,444679066,444679516,450,spec2/voc/Bl122_444679066.jpg,Bl122,1
9064.421241,9064.446241,1,voc,271932637,271933387,750,spec2/voc/Bl122_271932637.jpg,Bl122,1
9127.749981,9127.947981,1,voc,273832499,273838439,5940,spec2/voc/Bl122_273832499.jpg,Bl122,1
14789.110551,14789.114551,1,voc,443673316,443673436,120,spec2/voc/Bl122_443673316.jpg,Bl122,1
6044.5712,6044.7732,1,voc,181337136,181343196,6060,spec2/voc/Bl122_181337136.jpg,Bl122,1
6029.911533,6029.914533,1,voc,180897345,180897435,90,spec2/voc/Bl122_180897345.jpg,Bl122,1
13170.266701,13170.268701,1,voc,395108001,395108061,60,spec2/voc/Bl122_395108001.jpg,Bl122,1
5945.725256,5945.790256,1,voc,178371757,178373707,1950,spec2/voc/Bl122_178371757.jpg,Bl122,1
8013.729748,8013.737748,1,voc,240411892,240412132,240,spec2/voc/Bl122_240411892.jpg,Bl122,1
13163.544891,13163.547891,1,voc,394906346,394906436,90,spec2/voc/Bl122_394906346.jpg,Bl122,1
7853.722748,7853.745748,1,voc,235611682,235612372,690,spec2/voc/Bl122_235611682.jpg,Bl122,1
7999.154748,7999.159748,1,voc,239974642,239974792,150,spec2/voc/Bl122_239974642.jpg,Bl122,1
7841.509748,7841.519748,1,voc,235245292,235245592,300,spec2/voc/Bl122_235245292.jpg,Bl122,1
6092.87315,6092.92715,1,voc,182786194,182787814,1620,spec2/voc/Bl122_182786194.jpg,Bl122,1
9129.122981,9129.178981,1,voc,273873689,273875369,1680,spec2/voc/Bl122_273873689.jpg,Bl122,1
6030.629533,6030.634533,1,voc,180918885,180919035,150,spec2/voc/Bl122_180918885.jpg,Bl122,1
10898.57056,10898.57356,1,voc,326957116,326957206,90,spec2/voc/Bl122_326957116.jpg,Bl122,1
10881.566609,10881.597609,1,voc,326446998,326447928,930,spec2/voc/Bl122_326446998.jpg,Bl122,1
10958.140807,10958.193807,1,voc,328744224,328745814,1590,spec2/voc/Bl122_328744224.jpg,Bl122,1
6169.354327,6169.460327,1,voc,185080629,185083809,3180,spec2/voc/Bl122_185080629.jpg,Bl122,1
5968.230256,5968.616256,1,voc,179046907,179058487,11580,spec2/voc/Bl122_179046907.jpg,Bl122,1
8019.220748,8019.224748,1,voc,240576622,240576742,120,spec2/voc/Bl122_240576622.jpg,Bl122,1
10842.169842,10842.171842,1,voc,325265095,325265155,60,spec2/voc/Bl122_325265095.jpg,Bl122,1
7934.085748,7934.097748,1,voc,238022572,238022932,360,spec2/voc/Bl122_238022572.jpg,Bl122,1
5953.268256,5953.281256,1,voc,178598047,178598437,390,spec2/voc/Bl122_178598047.jpg,Bl122,1
9048.448241,9048.497241,1,voc,271453447,271454917,1470,spec2/voc/Bl122_271453447.jpg,Bl122,1
13163.221891,13163.232891,1,voc,394896656,394896986,330,spec2/voc/Bl122_394896656.jpg,Bl122,1
13949.687911,13949.789911,1,voc,418490637,418493697,3060,spec2/voc/Bl122_418490637.jpg,Bl122,1
13732.376497,13732.514497,1,voc,411971294,411975434,4140,spec2/voc/Bl122_411971294.jpg,Bl122,1
3799.676649,3799.684649,1,voc,113990299,113990539,240,spec2/voc/Bl122_113990299.jpg,Bl122,1
5974.628256,5974.635256,1,voc,179238847,179239057,210,spec2/voc/Bl122_179238847.jpg,Bl122,1
7851.666748,7851.669748,1,voc,235550002,235550092,90,spec2/voc/Bl122_235550002.jpg,Bl122,1
11210.997894,11211.037894,1,voc,336329936,336331136,1200,spec2/voc/Bl122_336329936.jpg,Bl122,1
13966.962352,13966.986352,1,voc,419008870,419009590,720,spec2/voc/Bl122_419008870.jpg,Bl122,1
6189.482327,6189.493327,1,voc,185684469,185684799,330,spec2/voc/Bl122_185684469.jpg,Bl122,1
7973.642748,7973.644748,1,voc,239209282,239209342,60,spec2/voc/Bl122_239209282.jpg,Bl122,1
7986.361748,7986.365748,1,voc,239590852,239590972,120,spec2/voc/Bl122_239590852.jpg,Bl122,1
7846.022748,7846.034748,1,voc,235380682,235381042,360,spec2/voc/Bl122_235380682.jpg,Bl122,1
13195.658662,13195.663662,1,voc,395869759,395869909,150,spec2/voc/Bl122_395869759.jpg,Bl122,1
8928.425773,8928.445773,1,voc,267852773,267853373,600,spec2/voc/Bl122_267852773.jpg,Bl122,1
8942.558967,8942.560967,1,voc,268276769,268276829,60,spec2/voc/Bl122_268276769.jpg,Bl122,1
9039.504241,9039.508241,1,voc,271185127,271185247,120,spec2/voc/Bl122_271185127.jpg,Bl122,1
8110.337418,8110.582418,1,voc,243310122,243317472,7350,spec2/voc/Bl122_243310122.jpg,Bl122,1
13947.644911,13947.646911,1,voc,418429347,418429407,60,spec2/voc/Bl122_418429347.jpg,Bl122,1
6029.604533,6029.616533,1,voc,180888135,180888495,360,spec2/voc/Bl122_180888135.jpg,Bl122,1
9057.949241,9058.066241,1,voc,271738477,271741987,3510,spec2/voc/Bl122_271738477.jpg,Bl122,1
8992.224241,8992.234241,1,voc,269766727,269767027,300,spec2/voc/Bl122_269766727.jpg,Bl122,1
7993.664748,7993.667748,1,voc,239809942,239810032,90,spec2/voc/Bl122_239809942.jpg,Bl122,1
11152.51518,11152.53318,1,voc,334575455,334575995,540,spec2/voc/Bl122_334575455.jpg,Bl122,1
3850.453415,3850.461415,1,voc,115513602,115513842,240,spec2/voc/Bl122_115513602.jpg,Bl122,1
6043.5072,6043.5582,1,voc,181305216,181306746,1530,spec2/voc/Bl122_181305216.jpg,Bl122,1
10938.134807,10938.137807,1,voc,328144044,328144134,90,spec2/voc/Bl122_328144044.jpg,Bl122,1
5944.444256,5944.531256,1,voc,178333327,178335937,2610,spec2/voc/Bl122_178333327.jpg,Bl122,1
10937.603807,10937.712807,1,voc,328128114,328131384,3270,spec2/voc/Bl122_328128114.jpg,Bl122,1
14794.770551,14794.806551,1,voc,443843116,443844196,1080,spec2/voc/Bl122_443843116.jpg,Bl122,1
6096.42515,6096.42715,1,voc,182892754,182892814,60,spec2/voc/Bl122_182892754.jpg,Bl122,1
9095.499241,9095.540241,1,voc,272864977,272866207,1230,spec2/voc/Bl122_272864977.jpg,Bl122,1
9069.730241,9069.795241,1,voc,272091907,272093857,1950,spec2/voc/Bl122_272091907.jpg,Bl122,1
5983.289256,5983.294256,1,voc,179498677,179498827,150,spec2/voc/Bl122_179498677.jpg,Bl122,1
13733.489497,13733.496497,1,voc,412004684,412004894,210,spec2/voc/Bl122_412004684.jpg,Bl122,1
9054.609241,9054.625241,1,voc,271638277,271638757,480,spec2/voc/Bl122_271638277.jpg,Bl122,1
11156.35918,11156.38518,1,voc,334690775,334691555,780,spec2/voc/Bl122_334690775.jpg,Bl122,1
7911.221748,7911.240748,1,voc,237336652,237337222,570,spec2/voc/Bl122_237336652.jpg,Bl122,1
12660.784535,12660.958535,1,voc,379823536,379828756,5220,spec2/voc/Bl122_379823536.jpg,Bl122,1
9130.427981,9130.435981,1,voc,273912839,273913079,240,spec2/voc/Bl122_273912839.jpg,Bl122,1
10945.174807,10945.200807,1,voc,328355244,328356024,780,spec2/voc/Bl122_328355244.jpg,Bl122,1
6144.152349,6144.206349,1,voc,184324570,184326190,1620,spec2/voc/Bl122_184324570.jpg,Bl122,1
7975.829748,7975.846748,1,voc,239274892,239275402,510,spec2/voc/Bl122_239274892.jpg,Bl122,1
8031.606748,8031.613748,1,voc,240948202,240948412,210,spec2/voc/Bl122_240948202.jpg,Bl122,1
11155.88618,11155.88918,1,voc,334676585,334676675,90,spec2/voc/Bl122_334676585.jpg,Bl122,1
5956.610256,5956.618256,1,voc,178698307,178698547,240,spec2/voc/Bl122_178698307.jpg,Bl122,1
7948.889748,7948.895748,1,voc,238466692,238466872,180,spec2/voc/Bl122_238466692.jpg,Bl122,1
14835.580682,14835.749682,1,voc,445067420,445072490,5070,spec2/voc/Bl122_445067420.jpg,Bl122,1
3811.106649,3811.111649,1,voc,114333199,114333349,150,spec2/voc/Bl122_114333199.jpg,Bl122,1
9063.107241,9063.112241,1,voc,271893217,271893367,150,spec2/voc/Bl122_271893217.jpg,Bl122,1
6137.387293,6137.509293,1,voc,184121618,184125278,3660,spec2/voc/Bl122_184121618.jpg,Bl122,1
10896.401557,10896.405557,1,voc,326892046,326892166,120,spec2/voc/Bl122_326892046.jpg,Bl122,1
5950.666256,5950.693256,1,voc,178519987,178520797,810,spec2/voc/Bl122_178519987.jpg,Bl122,1
6114.669706,6114.700706,1,voc,183440091,183441021,930,spec2/voc/Bl122_183440091.jpg,Bl122,1
7880.075748,7880.085748,1,voc,236402272,236402572,300,spec2/voc/Bl122_236402272.jpg,Bl122,1
8999.604241,8999.730241,1,voc,269988127,269991907,3780,spec2/voc/Bl122_269988127.jpg,Bl122,1
14841.731682,14841.739682,1,voc,445251950,445252190,240,spec2/voc/Bl122_445251950.jpg,Bl122,1
13960.835384,13960.858384,1,voc,418825061,418825751,690,spec2/voc/Bl122_418825061.jpg,Bl122,1
7936.761748,7936.771748,1,voc,238102852,238103152,300,spec2/voc/Bl122_238102852.jpg,Bl122,1
11158.67418,11158.73918,1,voc,334760225,334762175,1950,spec2/voc/Bl122_334760225.jpg,Bl122,1
7876.485748,7876.487748,1,voc,236294572,236294632,60,spec2/voc/Bl122_236294572.jpg,Bl122,1
13824.68922,13824.69322,1,voc,414740676,414740796,120,spec2/voc/Bl122_414740676.jpg,Bl122,1
9048.319241,9048.323241,1,voc,271449577,271449697,120,spec2/voc/Bl122_271449577.jpg,Bl122,1
6186.212327,6186.219327,1,voc,185586369,185586579,210,spec2/voc/Bl122_185586369.jpg,Bl122,1
7901.843748,7901.918748,1,voc,237055312,237057562,2250,spec2/voc/Bl122_237055312.jpg,Bl122,1
5945.095256,5945.126256,1,voc,178352857,178353787,930,spec2/voc/Bl122_178352857.jpg,Bl122,1
11156.45218,11156.47518,1,voc,334693565,334694255,690,spec2/voc/Bl122_334693565.jpg,Bl122,1
10909.436807,10909.455807,1,voc,327283104,327283674,570,spec2/voc/Bl122_327283104.jpg,Bl122,1
9146.091342,9146.213342,1,voc,274382740,274386400,3660,spec2/voc/Bl122_274382740.jpg,Bl122,1
6040.487065,6040.692065,1,voc,181214611,181220761,6150,spec2/voc/Bl122_181214611.jpg,Bl122,1
10736.03964,10736.54864,1,voc,322081189,322096459,15270,spec2/voc/Bl122_322081189.jpg,Bl122,1
3847.300415,3847.346415,1,voc,115419012,115420392,1380,spec2/voc/Bl122_115419012.jpg,Bl122,1
9044.162241,9044.171241,1,voc,271324867,271325137,270,spec2/voc/Bl122_271324867.jpg,Bl122,1
10960.415807,10960.454807,1,voc,328812474,328813644,1170,spec2/voc/Bl122_328812474.jpg,Bl122,1
13203.017389,13203.021389,1,voc,396090521,396090641,120,spec2/voc/Bl122_396090521.jpg,Bl122,1
6008.954533,6008.978533,1,voc,180268635,180269355,720,spec2/voc/Bl122_180268635.jpg,Bl122,1
3818.300649,3818.314649,1,voc,114549019,114549439,420,spec2/voc/Bl122_114549019.jpg,Bl122,1
7858.553748,7858.579748,1,voc,235756612,235757392,780,spec2/voc/Bl122_235756612.jpg,Bl122,1
14166.902536,14166.904536,1,voc,425007076,425007136,60,spec2/voc/Bl122_425007076.jpg,Bl122,1
13219.658389,13219.680389,1,voc,396589751,396590411,660,spec2/voc/Bl122_396589751.jpg,Bl122,1
5966.450256,5966.460256,1,voc,178993507,178993807,300,spec2/voc/Bl122_178993507.jpg,Bl122,1
13733.525497,13733.530497,1,voc,412005764,412005914,150,spec2/voc/Bl122_412005764.jpg,Bl122,1
6024.756533,6024.762533,1,voc,180742695,180742875,180,spec2/voc/Bl122_180742695.jpg,Bl122,1
11186.85118,11186.86518,1,voc,335605535,335605955,420,spec2/voc/Bl122_335605535.jpg,Bl122,1
13829.005664,13829.189664,1,voc,414870169,414875689,5520,spec2/voc/Bl122_414870169.jpg,Bl122,1
5971.865256,5971.871256,1,voc,179155957,179156137,180,spec2/voc/Bl122_179155957.jpg,Bl122,1
13156.167066,13156.231066,1,voc,394685011,394686931,1920,spec2/voc/Bl122_394685011.jpg,Bl122,1
12639.857849,12639.860849,1,voc,379195735,379195825,90,spec2/voc/Bl122_379195735.jpg,Bl122,1
8001.221748,8001.233748,1,voc,240036652,240037012,360,spec2/voc/Bl122_240036652.jpg,Bl122,1
6051.6252,6051.6502,1,voc,181548756,181549506,750,spec2/voc/Bl122_181548756.jpg,Bl122,1
6070.770705,6070.913705,1,voc,182123121,182127411,4290,spec2/voc/Bl122_182123121.jpg,Bl122,1
6182.541327,6182.552327,1,voc,185476239,185476569,330,spec2/voc/Bl122_185476239.jpg,Bl122,1
6091.80315,6091.81115,1,voc,182754094,182754334,240,spec2/voc/Bl122_182754094.jpg,Bl122,1
8998.352241,8998.375241,1,voc,269950567,269951257,690,spec2/voc/Bl122_269950567.jpg,Bl122,1
6114.319706,6114.326706,1,voc,183429591,183429801,210,spec2/voc/Bl122_183429591.jpg,Bl122,1
3853.634415,3853.798415,1,voc,115609032,115613952,4920,spec2/voc/Bl122_115609032.jpg,Bl122,1
5841.924221,5842.383221,1,voc,175257726,175271496,13770,spec2/voc/Bl122_175257726.jpg,Bl122,1
7901.796481,7901.841481,1,voc,237053894,237055244,1350,spec2/voc/Bl122_237053894.jpg,Bl122,1
8942.468967,8942.484967,1,voc,268274069,268274549,480,spec2/voc/Bl122_268274069.jpg,Bl122,1
13977.461117,13977.466117,1,voc,419323833,419323983,150,spec2/voc/Bl122_419323833.jpg,Bl122,1
5961.476256,5961.487256,1,voc,178844287,178844617,330,spec2/voc/Bl122_178844287.jpg,Bl122,1
8987.304025,8987.309025,1,voc,269619120,269619270,150,spec2/voc/Bl122_269619120.jpg,Bl122,1
14801.789551,14801.800551,1,voc,444053686,444054016,330,spec2/voc/Bl122_444053686.jpg,Bl122,1
13173.906701,13174.235701,1,voc,395217201,395227071,9870,spec2/voc/Bl122_395217201.jpg,Bl122,1
6226.504295,6226.509295,1,voc,186795128,186795278,150,spec2/voc/Bl122_186795128.jpg,Bl122,1
3811.010649,3811.013649,1,voc,114330319,114330409,90,spec2/voc/Bl122_114330319.jpg,Bl122,1
6116.303706,6116.307706,1,voc,183489111,183489231,120,spec2/voc/Bl122_183489111.jpg,Bl122,1
10955.482807,10955.484807,1,voc,328664484,328664544,60,spec2/voc/Bl122_328664484.jpg,Bl122,1
8355.347686,8355.525686,1,voc,250660430,250665770,5340,spec2/voc/Bl122_250660430.jpg,Bl122,1
7911.961748,7911.987748,1,voc,237358852,237359632,780,spec2/voc/Bl122_237358852.jpg,Bl122,1
9030.101241,9030.113241,1,voc,270903037,270903397,360,spec2/voc/Bl122_270903037.jpg,Bl122,1
6051.4882,6051.5922,1,voc,181544646,181547766,3120,spec2/voc/Bl122_181544646.jpg,Bl122,1
8334.465758,8334.722758,1,voc,250033972,250041682,7710,spec2/voc/Bl122_250033972.jpg,Bl122,1
11032.087132,11032.100132,1,voc,330962613,330963003,390,spec2/voc/Bl122_330962613.jpg,Bl122,1
7932.209748,7932.221748,1,voc,237966292,237966652,360,spec2/voc/Bl122_237966292.jpg,Bl122,1
3849.947415,3849.951415,1,voc,115498422,115498542,120,spec2/voc/Bl122_115498422.jpg,Bl122,1
6130.975293,6131.137293,1,voc,183929258,183934118,4860,spec2/voc/Bl122_183929258.jpg,Bl122,1
10928.951807,10928.960807,1,voc,327868554,327868824,270,spec2/voc/Bl122_327868554.jpg,Bl122,1
14156.184825,14156.192825,1,voc,424685544,424685784,240,spec2/voc/Bl122_424685544.jpg,Bl122,1
7984.526748,7984.570748,1,voc,239535802,239537122,1320,spec2/voc/Bl122_239535802.jpg,Bl122,1
5942.077256,5942.242256,1,voc,178262317,178267267,4950,spec2/voc/Bl122_178262317.jpg,Bl122,1
7974.324748,7974.330748,1,voc,239229742,239229922,180,spec2/voc/Bl122_239229742.jpg,Bl122,1
14796.747551,14796.790551,1,voc,443902426,443903716,1290,spec2/voc/Bl122_443902426.jpg,Bl122,1
6090.80715,6090.80915,1,voc,182724214,182724274,60,spec2/voc/Bl122_182724214.jpg,Bl122,1
6031.346533,6031.531533,1,voc,180940395,180945945,5550,spec2/voc/Bl122_180940395.jpg,Bl122,1
11151.05518,11151.08018,1,voc,334531655,334532405,750,spec2/voc/Bl122_334531655.jpg,Bl122,1
9066.626241,9066.632241,1,voc,271998787,271998967,180,spec2/voc/Bl122_271998787.jpg,Bl122,1
9010.922241,9010.943241,1,voc,270327667,270328297,630,spec2/voc/Bl122_270327667.jpg,Bl122,1
13208.025389,13208.027389,1,voc,396240761,396240821,60,spec2/voc/Bl122_396240761.jpg,Bl122,1
5954.496256,5954.714256,1,voc,178634887,178641427,6540,spec2/voc/Bl122_178634887.jpg,Bl122,1
9040.194241,9040.219241,1,voc,271205827,271206577,750,spec2/voc/Bl122_271205827.jpg,Bl122,1
14821.658551,14821.698551,1,voc,444649756,444650956,1200,spec2/voc/Bl122_444649756.jpg,Bl122,1
9097.278241,9097.602241,1,voc,272918347,272928067,9720,spec2/voc/Bl122_272918347.jpg,Bl122,1
6221.972295,6221.976295,1,voc,186659168,186659288,120,spec2/voc/Bl122_186659168.jpg,Bl122,1
7853.067748,7853.072748,1,voc,235592032,235592182,150,spec2/voc/Bl122_235592032.jpg,Bl122,1
13744.612896,13744.708896,1,voc,412338386,412341266,2880,spec2/voc/Bl122_412338386.jpg,Bl122,1
11130.546005,11130.579005,1,voc,333916380,333917370,990,spec2/voc/Bl122_333916380.jpg,Bl122,1
3861.744367,3861.767367,1,voc,115852331,115853021,690,spec2/voc/Bl122_115852331.jpg,Bl122,1
5986.223256,5986.270256,1,voc,179586697,179588107,1410,spec2/voc/Bl122_179586697.jpg,Bl122,1
9174.335287,9174.386287,1,voc,275230058,275231588,1530,spec2/voc/Bl122_275230058.jpg,Bl122,1
11889.028845,11889.095845,1,voc,356670865,356672875,2010,spec2/voc/Bl122_356670865.jpg,Bl122,1
14791.708551,14791.716551,1,voc,443751256,443751496,240,spec2/voc/Bl122_443751256.jpg,Bl122,1
6026.268533,6026.275533,1,voc,180788055,180788265,210,spec2/voc/Bl122_180788055.jpg,Bl122,1
6035.378533,6035.385533,1,voc,181061355,181061565,210,spec2/voc/Bl122_181061355.jpg,Bl122,1
7856.831748,7856.837748,1,voc,235704952,235705132,180,spec2/voc/Bl122_235704952.jpg,Bl122,1
5966.466256,5966.630256,1,voc,178993987,178998907,4920,spec2/voc/Bl122_178993987.jpg,Bl122,1
7802.203748,7802.245748,1,voc,234066112,234067372,1260,spec2/voc/Bl122_234066112.jpg,Bl122,1
3057.381192,3057.475192,1,voc,91721435,91724255,2820,spec2/voc/Bl122_91721435.jpg,Bl122,1
3795.931649,3795.937649,1,voc,113877949,113878129,180,spec2/voc/Bl122_113877949.jpg,Bl122,1
10957.005807,10957.007807,1,voc,328710174,328710234,60,spec2/voc/Bl122_328710174.jpg,Bl122,1
7974.342748,7974.346748,1,voc,239230282,239230402,120,spec2/voc/Bl122_239230282.jpg,Bl122,1
8985.709025,8985.722025,1,voc,269571270,269571660,390,spec2/voc/Bl122_269571270.jpg,Bl122,1
6204.635327,6204.644327,1,voc,186139059,186139329,270,spec2/voc/Bl122_186139059.jpg,Bl122,1
3865.756367,3865.854367,1,voc,115972691,115975631,2940,spec2/voc/Bl122_115972691.jpg,Bl122,1
13774.845473,13774.894473,1,voc,413245364,413246834,1470,spec2/voc/Bl122_413245364.jpg,Bl122,1
13244.337606,13244.364606,1,voc,397330128,397330938,810,spec2/voc/Bl122_397330128.jpg,Bl122,1
3828.666649,3828.847649,1,voc,114859999,114865429,5430,spec2/voc/Bl122_114859999.jpg,Bl122,1
6144.818349,6144.830349,1,voc,184344550,184344910,360,spec2/voc/Bl122_184344550.jpg,Bl122,1
13947.082911,13947.095911,1,voc,418412487,418412877,390,spec2/voc/Bl122_418412487.jpg,Bl122,1
13180.165701,13180.221701,1,voc,395404971,395406651,1680,spec2/voc/Bl122_395404971.jpg,Bl122,1
13546.818973,13546.822973,1,voc,406404569,406404689,120,spec2/voc/Bl122_406404569.jpg,Bl122,1
11166.14918,11166.27718,1,voc,334984475,334988315,3840,spec2/voc/Bl122_334984475.jpg,Bl122,1
13163.891891,13163.904891,1,voc,394916756,394917146,390,spec2/voc/Bl122_394916756.jpg,Bl122,1
9037.220241,9037.223241,1,voc,271116607,271116697,90,spec2/voc/Bl122_271116607.jpg,Bl122,1
11134.759005,11134.763005,1,voc,334042770,334042890,120,spec2/voc/Bl122_334042770.jpg,Bl122,1
13975.081117,13975.215117,1,voc,419252433,419256453,4020,spec2/voc/Bl122_419252433.jpg,Bl122,1
13170.128701,13170.132701,1,voc,395103861,395103981,120,spec2/voc/Bl122_395103861.jpg,Bl122,1
5965.073256,5965.078256,1,voc,178952197,178952347,150,spec2/voc/Bl122_178952197.jpg,Bl122,1
14808.932551,14809.065551,1,voc,444267976,444271966,3990,spec2/voc/Bl122_444267976.jpg,Bl122,1
5999.090256,5999.095256,1,voc,179972707,179972857,150,spec2/voc/Bl122_179972707.jpg,Bl122,1
6122.980706,6122.984706,1,voc,183689421,183689541,120,spec2/voc/Bl122_183689421.jpg,Bl122,1
5944.842256,5944.979256,1,voc,178345267,178349377,4110,spec2/voc/Bl122_178345267.jpg,Bl122,1
5977.259256,5977.263256,1,voc,179317777,179317897,120,spec2/voc/Bl122_179317777.jpg,Bl122,1
7910.275748,7910.278748,1,voc,237308272,237308362,90,spec2/voc/Bl122_237308272.jpg,Bl122,1
12630.859392,12630.919392,1,voc,378925781,378927581,1800,spec2/voc/Bl122_378925781.jpg,Bl122,1
6138.065293,6138.120293,1,voc,184141958,184143608,1650,spec2/voc/Bl122_184141958.jpg,Bl122,1
7964.023748,7964.033748,1,voc,238920712,238921012,300,spec2/voc/Bl122_238920712.jpg,Bl122,1
13725.54041,13725.58541,1,voc,411766212,411767562,1350,spec2/voc/Bl122_411766212.jpg,Bl122,1
8023.302748,8023.306748,1,voc,240699082,240699202,120,spec2/voc/Bl122_240699082.jpg,Bl122,1
9057.646241,9057.659241,1,voc,271729387,271729777,390,spec2/voc/Bl122_271729387.jpg,Bl122,1
11173.28618,11173.34418,1,voc,335198585,335200325,1740,spec2/voc/Bl122_335198585.jpg,Bl122,1
6061.773705,6062.013705,1,voc,181853211,181860411,7200,spec2/voc/Bl122_181853211.jpg,Bl122,1
12631.050392,12631.470392,1,voc,378931511,378944111,12600,spec2/voc/Bl122_378931511.jpg,Bl122,1
7949.166748,7949.173748,1,voc,238475002,238475212,210,spec2/voc/Bl122_238475002.jpg,Bl122,1
14175.598361,14175.604361,1,voc,425267950,425268130,180,spec2/voc/Bl122_425267950.jpg,Bl122,1
14804.748551,14804.753551,1,voc,444142456,444142606,150,spec2/voc/Bl122_444142456.jpg,Bl122,1
11189.69218,11189.74018,1,voc,335690765,335692205,1440,spec2/voc/Bl122_335690765.jpg,Bl122,1
3862.059367,3862.087367,1,voc,115861781,115862621,840,spec2/voc/Bl122_115861781.jpg,Bl122,1
3841.273415,3841.433415,1,voc,115238202,115243002,4800,spec2/voc/Bl122_115238202.jpg,Bl122,1
14154.143825,14154.343825,1,voc,424624314,424630314,6000,spec2/voc/Bl122_424624314.jpg,Bl122,1
8213.066724,8213.069724,1,voc,246392001,246392091,90,spec2/voc/Bl122_246392001.jpg,Bl122,1
6115.528706,6115.540706,1,voc,183465861,183466221,360,spec2/voc/Bl122_183465861.jpg,Bl122,1
7962.286748,7962.349748,1,voc,238868602,238870492,1890,spec2/voc/Bl122_238868602.jpg,Bl122,1
5972.889256,5972.895256,1,voc,179186677,179186857,180,spec2/voc/Bl122_179186677.jpg,Bl122,1
7936.572748,7936.609748,1,voc,238097182,238098292,1110,spec2/voc/Bl122_238097182.jpg,Bl122,1
7952.860748,7952.939748,1,voc,238585822,238588192,2370,spec2/voc/Bl122_238585822.jpg,Bl122,1
6098.70715,6098.71415,1,voc,182961214,182961424,210,spec2/voc/Bl122_182961214.jpg,Bl122,1
5948.098256,5948.114256,1,voc,178442947,178443427,480,spec2/voc/Bl122_178442947.jpg,Bl122,1
7961.866748,7961.873748,1,voc,238856002,238856212,210,spec2/voc/Bl122_238856002.jpg,Bl122,1
13825.77222,13825.78122,1,voc,414773166,414773436,270,spec2/voc/Bl122_414773166.jpg,Bl122,1
6204.650327,6204.657327,1,voc,186139509,186139719,210,spec2/voc/Bl122_186139509.jpg,Bl122,1
10933.563807,10933.729807,1,voc,328006914,328011894,4980,spec2/voc/Bl122_328006914.jpg,Bl122,1
6188.547327,6188.716327,1,voc,185656419,185661489,5070,spec2/voc/Bl122_185656419.jpg,Bl122,1
8015.475748,8015.485748,1,voc,240464272,240464572,300,spec2/voc/Bl122_240464272.jpg,Bl122,1
6123.779706,6123.803706,1,voc,183713391,183714111,720,spec2/voc/Bl122_183713391.jpg,Bl122,1
9033.692241,9033.714241,1,voc,271010767,271011427,660,spec2/voc/Bl122_271010767.jpg,Bl122,1
9042.505241,9042.513241,1,voc,271275157,271275397,240,spec2/voc/Bl122_271275157.jpg,Bl122,1
6142.532349,6142.559349,1,voc,184275970,184276780,810,spec2/voc/Bl122_184275970.jpg,Bl122,1
7961.413748,7961.425748,1,voc,238842412,238842772,360,spec2/voc/Bl122_238842412.jpg,Bl122,1
11180.64218,11180.66118,1,voc,335419265,335419835,570,spec2/voc/Bl122_335419265.jpg,Bl122,1
9065.399241,9065.403241,1,voc,271961977,271962097,120,spec2/voc/Bl122_271961977.jpg,Bl122,1
14791.369551,14791.572551,1,voc,443741086,443747176,6090,spec2/voc/Bl122_443741086.jpg,Bl122,1
10924.962807,10925.071807,1,voc,327748884,327752154,3270,spec2/voc/Bl122_327748884.jpg,Bl122,1
3810.211649,3810.215649,1,voc,114306349,114306469,120,spec2/voc/Bl122_114306349.jpg,Bl122,1
9048.426241,9048.446241,1,voc,271452787,271453387,600,spec2/voc/Bl122_271452787.jpg,Bl122,1
14793.597551,14793.607551,1,voc,443807926,443808226,300,spec2/voc/Bl122_443807926.jpg,Bl122,1
6090.73915,6090.74615,1,voc,182722174,182722384,210,spec2/voc/Bl122_182722174.jpg,Bl122,1
11193.09018,11193.16818,1,voc,335792705,335795045,2340,spec2/voc/Bl122_335792705.jpg,Bl122,1
8915.849773,8915.853773,1,voc,267475493,267475613,120,spec2/voc/Bl122_267475493.jpg,Bl122,1
9054.153241,9054.207241,1,voc,271624597,271626217,1620,spec2/voc/Bl122_271624597.jpg,Bl122,1
5948.688256,5948.716256,1,voc,178460647,178461487,840,spec2/voc/Bl122_178460647.jpg,Bl122,1
6038.499533,6038.509533,1,voc,181154985,181155285,300,spec2/voc/Bl122_181154985.jpg,Bl122,1
3800.521649,3800.743649,1,voc,114015649,114022309,6660,spec2/voc/Bl122_114015649.jpg,Bl122,1
6052.1892,6052.2102,1,voc,181565676,181566306,630,spec2/voc/Bl122_181565676.jpg,Bl122,1
8003.459748,8003.463748,1,voc,240103792,240103912,120,spec2/voc/Bl122_240103792.jpg,Bl122,1
9057.535241,9057.548241,1,voc,271726057,271726447,390,spec2/voc/Bl122_271726057.jpg,Bl122,1
9041.743241,9041.747241,1,voc,271252297,271252417,120,spec2/voc/Bl122_271252297.jpg,Bl122,1
11131.407005,11131.565005,1,voc,333942210,333946950,4740,spec2/voc/Bl122_333942210.jpg,Bl122,1
5979.814256,5979.992256,1,voc,179394427,179399767,5340,spec2/voc/Bl122_179394427.jpg,Bl122,1
13984.042943,13984.046943,1,voc,419521288,419521408,120,spec2/voc/Bl122_419521288.jpg,Bl122,1
9097.745241,9097.765241,1,voc,272932357,272932957,600,spec2/voc/Bl122_272932357.jpg,Bl122,1
9146.411342,9146.448342,1,voc,274392340,274393450,1110,spec2/voc/Bl122_274392340.jpg,Bl122,1
3863.840367,3863.976367,1,voc,115915211,115919291,4080,spec2/voc/Bl122_115915211.jpg,Bl122,1
6047.0252,6047.0682,1,voc,181410756,181412046,1290,spec2/voc/Bl122_181410756.jpg,Bl122,1
3892.820652,3892.996652,1,voc,116784619,116789899,5280,spec2/voc/Bl122_116784619.jpg,Bl122,1
7975.293748,7975.300748,1,voc,239258812,239259022,210,spec2/voc/Bl122_239258812.jpg,Bl122,1
6118.791706,6118.817706,1,voc,183563751,183564531,780,spec2/voc/Bl122_183563751.jpg,Bl122,1
13774.208473,13774.222473,1,voc,413226254,413226674,420,spec2/voc/Bl122_413226254.jpg,Bl122,1
14805.139551,14805.171551,1,voc,444154186,444155146,960,spec2/voc/Bl122_444154186.jpg,Bl122,1
10953.907807,10953.930807,1,voc,328617234,328617924,690,spec2/voc/Bl122_328617234.jpg,Bl122,1
13198.895389,13199.127389,1,voc,395966861,395973821,6960,spec2/voc/Bl122_395966861.jpg,Bl122,1
3828.439649,3828.650649,1,voc,114853189,114859519,6330,spec2/voc/Bl122_114853189.jpg,Bl122,1
7882.289748,7882.294748,1,voc,236468692,236468842,150,spec2/voc/Bl122_236468692.jpg,Bl122,1
9101.234241,9101.240241,1,voc,273037027,273037207,180,spec2/voc/Bl122_273037027.jpg,Bl122,1
9007.866241,9007.875241,1,voc,270235987,270236257,270,spec2/voc/Bl122_270235987.jpg,Bl122,1
5985.439256,5985.489256,1,voc,179563177,179564677,1500,spec2/voc/Bl122_179563177.jpg,Bl122,1
11179.94218,11179.96518,1,voc,335398265,335398955,690,spec2/voc/Bl122_335398265.jpg,Bl122,1
7965.811748,7965.813748,1,voc,238974352,238974412,60,spec2/voc/Bl122_238974352.jpg,Bl122,1
6080.808511,6080.891511,1,voc,182424255,182426745,2490,spec2/voc/Bl122_182424255.jpg,Bl122,1
10918.523807,10918.526807,1,voc,327555714,327555804,90,spec2/voc/Bl122_327555714.jpg,Bl122,1
7913.856748,7913.868748,1,voc,237415702,237416062,360,spec2/voc/Bl122_237415702.jpg,Bl122,1
7912.012748,7912.052748,1,voc,237360382,237361582,1200,spec2/voc/Bl122_237360382.jpg,Bl122,1
9090.659241,9090.686241,1,voc,272719777,272720587,810,spec2/voc/Bl122_272719777.jpg,Bl122,1
5953.790256,5953.980256,1,voc,178613707,178619407,5700,spec2/voc/Bl122_178613707.jpg,Bl122,1
3817.334649,3817.344649,1,voc,114520039,114520339,300,spec2/voc/Bl122_114520039.jpg,Bl122,1
10943.048807,10943.060807,1,voc,328291464,328291824,360,spec2/voc/Bl122_328291464.jpg,Bl122,1
10922.762807,10922.812807,1,voc,327682884,327684384,1500,spec2/voc/Bl122_327682884.jpg,Bl122,1
3272.184278,3272.265278,1,voc,98165528,98167958,2430,spec2/voc/Bl122_98165528.jpg,Bl122,1
7842.421748,7842.427748,1,voc,235272652,235272832,180,spec2/voc/Bl122_235272652.jpg,Bl122,1
6227.124295,6227.203295,1,voc,186813728,186816098,2370,spec2/voc/Bl122_186813728.jpg,Bl122,1
11174.15018,11174.23418,1,voc,335224505,335227025,2520,spec2/voc/Bl122_335224505.jpg,Bl122,1
5997.634256,5997.642256,1,voc,179929027,179929267,240,spec2/voc/Bl122_179929027.jpg,Bl122,1
8991.581241,8991.743241,1,voc,269747437,269752297,4860,spec2/voc/Bl122_269747437.jpg,Bl122,1
13952.485911,13952.497911,1,voc,418574577,418574937,360,spec2/voc/Bl122_418574577.jpg,Bl122,1
10964.628807,10964.634807,1,voc,328938864,328939044,180,spec2/voc/Bl122_328938864.jpg,Bl122,1
5938.733256,5938.736256,1,voc,178161997,178162087,90,spec2/voc/Bl122_178161997.jpg,Bl122,1
6226.829295,6226.864295,1,voc,186804878,186805928,1050,spec2/voc/Bl122_186804878.jpg,Bl122,1
6205.553327,6205.557327,1,voc,186166599,186166719,120,spec2/voc/Bl122_186166599.jpg,Bl122,1
13774.808473,13774.815473,1,voc,413244254,413244464,210,spec2/voc/Bl122_413244254.jpg,Bl122,1
3795.146649,3795.303649,1,voc,113854399,113859109,4710,spec2/voc/Bl122_113854399.jpg,Bl122,1
11183.62518,11183.70018,1,voc,335508755,335511005,2250,spec2/voc/Bl122_335508755.jpg,Bl122,1
12639.214849,12639.217849,1,voc,379176445,379176535,90,spec2/voc/Bl122_379176445.jpg,Bl122,1
6026.623533,6026.634533,1,voc,180798705,180799035,330,spec2/voc/Bl122_180798705.jpg,Bl122,1
6186.492327,6186.496327,1,voc,185594769,185594889,120,spec2/voc/Bl122_185594769.jpg,Bl122,1
11206.755894,11206.784894,1,voc,336202676,336203546,870,spec2/voc/Bl122_336202676.jpg,Bl122,1
6048.7232,6048.7262,1,voc,181461696,181461786,90,spec2/voc/Bl122_181461696.jpg,Bl122,1
5931.390256,5931.475256,1,voc,177941707,177944257,2550,spec2/voc/Bl122_177941707.jpg,Bl122,1
7993.834748,7993.837748,1,voc,239815042,239815132,90,spec2/voc/Bl122_239815042.jpg,Bl122,1
6132.206293,6132.209293,1,voc,183966188,183966278,90,spec2/voc/Bl122_183966188.jpg,Bl122,1
6056.436705,6056.446705,1,voc,181693101,181693401,300,spec2/voc/Bl122_181693101.jpg,Bl122,1
13195.509662,13195.521662,1,voc,395865289,395865649,360,spec2/voc/Bl122_395865289.jpg,Bl122,1
6152.616349,6152.722349,1,voc,184578490,184581670,3180,spec2/voc/Bl122_184578490.jpg,Bl122,1
9029.914241,9029.916241,1,voc,270897427,270897487,60,spec2/voc/Bl122_270897427.jpg,Bl122,1
13807.909653,13808.105653,1,voc,414237289,414243169,5880,spec2/voc/Bl122_414237289.jpg,Bl122,1
7960.471748,7960.479748,1,voc,238814152,238814392,240,spec2/voc/Bl122_238814152.jpg,Bl122,1
9165.348604,9165.446604,1,voc,274960458,274963398,2940,spec2/voc/Bl122_274960458.jpg,Bl122,1
12667.857394,12667.864394,1,voc,380035721,380035931,210,spec2/voc/Bl122_380035721.jpg,Bl122,1
11868.579862,11868.821862,1,voc,356057395,356064655,7260,spec2/voc/Bl122_356057395.jpg,Bl122,1
6197.879327,6197.891327,1,voc,185936379,185936739,360,spec2/voc/Bl122_185936379.jpg,Bl122,1
7991.668748,7991.689748,1,voc,239750062,239750692,630,spec2/voc/Bl122_239750062.jpg,Bl122,1
11953.468309,11953.495309,1,voc,358604049,358604859,810,spec2/voc/Bl122_358604049.jpg,Bl122,1
9001.381241,9001.607241,1,voc,270041437,270048217,6780,spec2/voc/Bl122_270041437.jpg,Bl122,1
7844.288748,7844.292748,1,voc,235328662,235328782,120,spec2/voc/Bl122_235328662.jpg,Bl122,1
13977.026117,13977.168117,1,voc,419310783,419315043,4260,spec2/voc/Bl122_419310783.jpg,Bl122,1
9169.612604,9169.614604,1,voc,275088378,275088438,60,spec2/voc/Bl122_275088378.jpg,Bl122,1
9158.694796,9158.696796,1,voc,274760843,274760903,60,spec2/voc/Bl122_274760843.jpg,Bl122,1
3827.629649,3827.632649,1,voc,114828889,114828979,90,spec2/voc/Bl122_114828889.jpg,Bl122,1
7843.849748,7843.881748,1,voc,235315492,235316452,960,spec2/voc/Bl122_235315492.jpg,Bl122,1
10964.778807,10964.781807,1,voc,328943364,328943454,90,spec2/voc/Bl122_328943364.jpg,Bl122,1
6063.744705,6063.804705,1,voc,181912341,181914141,1800,spec2/voc/Bl122_181912341.jpg,Bl122,1
13582.400236,13582.508236,1,voc,407472007,407475247,3240,spec2/voc/Bl122_407472007.jpg,Bl122,1
10931.857807,10931.864807,1,voc,327955734,327955944,210,spec2/voc/Bl122_327955734.jpg,Bl122,1
11159.87218,11160.05618,1,voc,334796165,334801685,5520,spec2/voc/Bl122_334796165.jpg,Bl122,1
6058.333705,6058.373705,1,voc,181750011,181751211,1200,spec2/voc/Bl122_181750011.jpg,Bl122,1
6045.1572,6045.1602,1,voc,181354716,181354806,90,spec2/voc/Bl122_181354716.jpg,Bl122,1
3829.505649,3829.518649,1,voc,114885169,114885559,390,spec2/voc/Bl122_114885169.jpg,Bl122,1
9046.266241,9046.313241,1,voc,271387987,271389397,1410,spec2/voc/Bl122_271387987.jpg,Bl122,1
6036.247533,6036.249533,1,voc,181087425,181087485,60,spec2/voc/Bl122_181087425.jpg,Bl122,1
11139.368955,11139.432955,1,voc,334181068,334182988,1920,spec2/voc/Bl122_334181068.jpg,Bl122,1
6223.891295,6223.936295,1,voc,186716738,186718088,1350,spec2/voc/Bl122_186716738.jpg,Bl122,1
7798.360748,7798.373748,1,voc,233950822,233951212,390,spec2/voc/Bl122_233950822.jpg,Bl122,1
9064.754241,9064.769241,1,voc,271942627,271943077,450,spec2/voc/Bl122_271942627.jpg,Bl122,1
8996.803241,8996.812241,1,voc,269904097,269904367,270,spec2/voc/Bl122_269904097.jpg,Bl122,1
7854.574748,7854.608748,1,voc,235637242,235638262,1020,spec2/voc/Bl122_235637242.jpg,Bl122,1
10920.516807,10920.657807,1,voc,327615504,327619734,4230,spec2/voc/Bl122_327615504.jpg,Bl122,1
9051.079241,9051.081241,1,voc,271532377,271532437,60,spec2/voc/Bl122_271532377.jpg,Bl122,1
7881.908748,7881.930748,1,voc,236457262,236457922,660,spec2/voc/Bl122_236457262.jpg,Bl122,1
7983.339748,7983.346748,1,voc,239500192,239500402,210,spec2/voc/Bl122_239500192.jpg,Bl122,1
9067.810241,9067.835241,1,voc,272034307,272035057,750,spec2/voc/Bl122_272034307.jpg,Bl122,1
11145.272955,11145.389955,1,voc,334358188,334361698,3510,spec2/voc/Bl122_334358188.jpg,Bl122,1
7999.539748,7999.547748,1,voc,239986192,239986432,240,spec2/voc/Bl122_239986192.jpg,Bl122,1
3884.783062,3884.974062,1,voc,116543491,116549221,5730,spec2/voc/Bl122_116543491.jpg,Bl122,1
3889.983652,3889.988652,1,voc,116699509,116699659,150,spec2/voc/Bl122_116699509.jpg,Bl122,1
14789.708551,14789.722551,1,voc,443691256,443691676,420,spec2/voc/Bl122_443691256.jpg,Bl122,1
9022.668241,9022.674241,1,voc,270680047,270680227,180,spec2/voc/Bl122_270680047.jpg,Bl122,1
7928.608748,7928.615748,1,voc,237858262,237858472,210,spec2/voc/Bl122_237858262.jpg,Bl122,1
14811.119551,14811.122551,1,voc,444333586,444333676,90,spec2/voc/Bl122_444333586.jpg,Bl122,1
13219.491389,13219.643389,1,voc,396584741,396589301,4560,spec2/voc/Bl122_396584741.jpg,Bl122,1
8319.686436,8319.822436,1,voc,249590593,249594673,4080,spec2/voc/Bl122_249590593.jpg,Bl122,1
7949.005748,7949.008748,1,voc,238470172,238470262,90,spec2/voc/Bl122_238470172.jpg,Bl122,1
6055.582705,6055.604705,1,voc,181667481,181668141,660,spec2/voc/Bl122_181667481.jpg,Bl122,1
13951.680911,13951.917911,1,voc,418550427,418557537,7110,spec2/voc/Bl122_418550427.jpg,Bl122,1
5941.725256,5941.751256,1,voc,178251757,178252537,780,spec2/voc/Bl122_178251757.jpg,Bl122,1
14836.900682,14837.154682,1,voc,445107020,445114640,7620,spec2/voc/Bl122_445107020.jpg,Bl122,1
6109.782706,6109.982706,1,voc,183293481,183299481,6000,spec2/voc/Bl122_183293481.jpg,Bl122,1
6145.937349,6145.961349,1,voc,184378120,184378840,720,spec2/voc/Bl122_184378120.jpg,Bl122,1
9032.536241,9032.582241,1,voc,270976087,270977467,1380,spec2/voc/Bl122_270976087.jpg,Bl122,1
11130.329005,11130.334005,1,voc,333909870,333910020,150,spec2/voc/Bl122_333909870.jpg,Bl122,1
13983.796943,13983.827943,1,voc,419513908,419514838,930,spec2/voc/Bl122_419513908.jpg,Bl122,1
6047.7452,6047.7492,1,voc,181432356,181432476,120,spec2/voc/Bl122_181432356.jpg,Bl122,1
9039.825241,9039.828241,1,voc,271194757,271194847,90,spec2/voc/Bl122_271194757.jpg,Bl122,1
3808.122649,3808.128649,1,voc,114243679,114243859,180,spec2/voc/Bl122_114243679.jpg,Bl122,1
14796.687551,14796.743551,1,voc,443900626,443902306,1680,spec2/voc/Bl122_443900626.jpg,Bl122,1
6052.9912,6053.2152,1,voc,181589736,181596456,6720,spec2/voc/Bl122_181589736.jpg,Bl122,1
8304.933054,8304.987054,1,voc,249147991,249149611,1620,spec2/voc/Bl122_249147991.jpg,Bl122,1
3876.524848,3876.526848,1,voc,116295745,116295805,60,spec2/voc/Bl122_116295745.jpg,Bl122,1
6004.734256,6004.742256,1,voc,180142027,180142267,240,spec2/voc/Bl122_180142027.jpg,Bl122,1
7974.569748,7974.571748,1,voc,239237092,239237152,60,spec2/voc/Bl122_239237092.jpg,Bl122,1
12672.867513,12672.886513,1,voc,380186025,380186595,570,spec2/voc/Bl122_380186025.jpg,Bl122,1
6158.172349,6158.181349,1,voc,184745170,184745440,270,spec2/voc/Bl122_184745170.jpg,Bl122,1
13206.470389,13206.472389,1,voc,396194111,396194171,60,spec2/voc/Bl122_396194111.jpg,Bl122,1
10958.929807,10959.004807,1,voc,328767894,328770144,2250,spec2/voc/Bl122_328767894.jpg,Bl122,1
6032.463533,6032.520533,1,voc,180973905,180975615,1710,spec2/voc/Bl122_180973905.jpg,Bl122,1
10907.340825,10907.364825,1,voc,327220224,327220944,720,spec2/voc/Bl122_327220224.jpg,Bl122,1
6195.812327,6195.902327,1,voc,185874369,185877069,2700,spec2/voc/Bl122_185874369.jpg,Bl122,1
7859.920748,7859.955748,1,voc,235797622,235798672,1050,spec2/voc/Bl122_235797622.jpg,Bl122,1
8996.844241,8997.190241,1,voc,269905327,269915707,10380,spec2/voc/Bl122_269905327.jpg,Bl122,1
6045.8292,6045.8942,1,voc,181374876,181376826,1950,spec2/voc/Bl122_181374876.jpg,Bl122,1
7862.009748,7862.018748,1,voc,235860292,235860562,270,spec2/voc/Bl122_235860292.jpg,Bl122,1
6189.811327,6189.939327,1,voc,185694339,185698179,3840,spec2/voc/Bl122_185694339.jpg,Bl122,1
13180.464701,13180.466701,1,voc,395413941,395414001,60,spec2/voc/Bl122_395413941.jpg,Bl122,1
3876.719848,3876.774848,1,voc,116301595,116303245,1650,spec2/voc/Bl122_116301595.jpg,Bl122,1
3801.196649,3801.221649,1,voc,114035899,114036649,750,spec2/voc/Bl122_114035899.jpg,Bl122,1
13206.743389,13206.759389,1,voc,396202301,396202781,480,spec2/voc/Bl122_396202301.jpg,Bl122,1
8997.194241,8997.263241,1,voc,269915827,269917897,2070,spec2/voc/Bl122_269915827.jpg,Bl122,1
3798.043649,3798.244649,1,voc,113941309,113947339,6030,spec2/voc/Bl122_113941309.jpg,Bl122,1
11185.70118,11185.86118,1,voc,335571035,335575835,4800,spec2/voc/Bl122_335571035.jpg,Bl122,1
7929.260748,7929.288748,1,voc,237877822,237878662,840,spec2/voc/Bl122_237877822.jpg,Bl122,1
11135.923005,11136.013005,1,voc,334077690,334080390,2700,spec2/voc/Bl122_334077690.jpg,Bl122,1
6072.267705,6072.393705,1,voc,182168031,182171811,3780,spec2/voc/Bl122_182168031.jpg,Bl122,1
6122.987706,6123.313706,1,voc,183689631,183699411,9780,spec2/voc/Bl122_183689631.jpg,Bl122,1
5946.212256,5946.215256,1,voc,178386367,178386457,90,spec2/voc/Bl122_178386367.jpg,Bl122,1
14807.884551,14807.949551,1,voc,444236536,444238486,1950,spec2/voc/Bl122_444236536.jpg,Bl122,1
6130.687293,6130.728293,1,voc,183920618,183921848,1230,spec2/voc/Bl122_183920618.jpg,Bl122,1
7842.098748,7842.131748,1,voc,235262962,235263952,990,spec2/voc/Bl122_235262962.jpg,Bl122,1
13825.74022,13825.75222,1,voc,414772206,414772566,360,spec2/voc/Bl122_414772206.jpg,Bl122,1
6169.797327,6169.811327,1,voc,185093919,185094339,420,spec2/voc/Bl122_185093919.jpg,Bl122,1
3809.373649,3809.408649,1,voc,114281209,114282259,1050,spec2/voc/Bl122_114281209.jpg,Bl122,1
6145.423349,6145.436349,1,voc,184362700,184363090,390,spec2/voc/Bl122_184362700.jpg,Bl122,1
6022.337533,6022.346533,1,voc,180670125,180670395,270,spec2/voc/Bl122_180670125.jpg,Bl122,1
13193.056662,13193.070662,1,voc,395791699,395792119,420,spec2/voc/Bl122_395791699.jpg,Bl122,1
14154.502825,14154.505825,1,voc,424635084,424635174,90,spec2/voc/Bl122_424635084.jpg,Bl122,1
6098.90815,6099.01815,1,voc,182967244,182970544,3300,spec2/voc/Bl122_182967244.jpg,Bl122,1
13605.949736,13605.958736,1,voc,408178492,408178762,270,spec2/voc/Bl122_408178492.jpg,Bl122,1
13588.416236,13588.444236,1,voc,407652487,407653327,840,spec2/voc/Bl122_407652487.jpg,Bl122,1
5958.593256,5958.829256,1,voc,178757797,178764877,7080,spec2/voc/Bl122_178757797.jpg,Bl122,1
6026.643533,6026.661533,1,voc,180799305,180799845,540,spec2/voc/Bl122_180799305.jpg,Bl122,1
7844.412748,7844.419748,1,voc,235332382,235332592,210,spec2/voc/Bl122_235332382.jpg,Bl122,1
9030.530241,9030.655241,1,voc,270915907,270919657,3750,spec2/voc/Bl122_270915907.jpg,Bl122,1
9165.723604,9165.741604,1,voc,274971708,274972248,540,spec2/voc/Bl122_274971708.jpg,Bl122,1
8004.291748,8004.309748,1,voc,240128752,240129292,540,spec2/voc/Bl122_240128752.jpg,Bl122,1
10914.212807,10914.412807,1,voc,327426384,327432384,6000,spec2/voc/Bl122_327426384.jpg,Bl122,1
6222.212295,6222.224295,1,voc,186666368,186666728,360,spec2/voc/Bl122_186666368.jpg,Bl122,1
5987.425256,5987.450256,1,voc,179622757,179623507,750,spec2/voc/Bl122_179622757.jpg,Bl122,1
8930.243773,8930.302773,1,voc,267907313,267909083,1770,spec2/voc/Bl122_267907313.jpg,Bl122,1
10918.418807,10918.424807,1,voc,327552564,327552744,180,spec2/voc/Bl122_327552564.jpg,Bl122,1
6012.877533,6012.912533,1,voc,180386325,180387375,1050,spec2/voc/Bl122_180386325.jpg,Bl122,1
9021.503241,9021.543241,1,voc,270645097,270646297,1200,spec2/voc/Bl122_270645097.jpg,Bl122,1
7976.048748,7976.053748,1,voc,239281462,239281612,150,spec2/voc/Bl122_239281462.jpg,Bl122,1
8977.761025,8978.139025,1,voc,269332830,269344170,11340,spec2/voc/Bl122_269332830.jpg,Bl122,1
9081.027241,9081.038241,1,voc,272430817,272431147,330,spec2/voc/Bl122_272430817.jpg,Bl122,1
3823.196649,3823.332649,1,voc,114695899,114699979,4080,spec2/voc/Bl122_114695899.jpg,Bl122,1
14801.094551,14801.204551,1,voc,444032836,444036136,3300,spec2/voc/Bl122_444032836.jpg,Bl122,1
8993.788241,8993.813241,1,voc,269813647,269814397,750,spec2/voc/Bl122_269813647.jpg,Bl122,1
12671.107513,12671.114513,1,voc,380133225,380133435,210,spec2/voc/Bl122_380133225.jpg,Bl122,1
11180.01318,11180.19018,1,voc,335400395,335405705,5310,spec2/voc/Bl122_335400395.jpg,Bl122,1
6108.034706,6108.050706,1,voc,183241041,183241521,480,spec2/voc/Bl122_183241041.jpg,Bl122,1
6071.128705,6071.297705,1,voc,182133861,182138931,5070,spec2/voc/Bl122_182133861.jpg,Bl122,1
5972.869256,5972.874256,1,voc,179186077,179186227,150,spec2/voc/Bl122_179186077.jpg,Bl122,1
9152.887842,9153.072842,1,voc,274586635,274592185,5550,spec2/voc/Bl122_274586635.jpg,Bl122,1
9000.696241,9000.950241,1,voc,270020887,270028507,7620,spec2/voc/Bl122_270020887.jpg,Bl122,1
5977.663256,5977.889256,1,voc,179329897,179336677,6780,spec2/voc/Bl122_179329897.jpg,Bl122,1
6062.342705,6062.373705,1,voc,181870281,181871211,930,spec2/voc/Bl122_181870281.jpg,Bl122,1
7844.404748,7844.406748,1,voc,235332142,235332202,60,spec2/voc/Bl122_235332142.jpg,Bl122,1
3813.639649,3813.717649,1,voc,114409189,114411529,2340,spec2/voc/Bl122_114409189.jpg,Bl122,1
7937.882748,7937.889748,1,voc,238136482,238136692,210,spec2/voc/Bl122_238136482.jpg,Bl122,1
9054.228241,9054.233241,1,voc,271626847,271626997,150,spec2/voc/Bl122_271626847.jpg,Bl122,1
9092.798241,9092.805241,1,voc,272783947,272784157,210,spec2/voc/Bl122_272783947.jpg,Bl122,1
13659.733334,13659.761334,1,voc,409792000,409792840,840,spec2/voc/Bl122_409792000.jpg,Bl122,1
14823.514551,14823.525551,1,voc,444705436,444705766,330,spec2/voc/Bl122_444705436.jpg,Bl122,1
7972.678748,7972.680748,1,voc,239180362,239180422,60,spec2/voc/Bl122_239180362.jpg,Bl122,1
7973.667748,7973.673748,1,voc,239210032,239210212,180,spec2/voc/Bl122_239210032.jpg,Bl122,1
9013.565241,9013.659241,1,voc,270406957,270409777,2820,spec2/voc/Bl122_270406957.jpg,Bl122,1
9031.466241,9031.470241,1,voc,270943987,270944107,120,spec2/voc/Bl122_270943987.jpg,Bl122,1
14839.011682,14839.153682,1,voc,445170350,445174610,4260,spec2/voc/Bl122_445170350.jpg,Bl122,1
7905.127748,7905.134748,1,voc,237153832,237154042,210,spec2/voc/Bl122_237153832.jpg,Bl122,1
13160.857891,13160.879891,1,voc,394825736,394826396,660,spec2/voc/Bl122_394825736.jpg,Bl122,1
13961.087384,13961.097384,1,voc,418832621,418832921,300,spec2/voc/Bl122_418832621.jpg,Bl122,1
10897.291557,10897.449557,1,voc,326918746,326923486,4740,spec2/voc/Bl122_326918746.jpg,Bl122,1
9057.244241,9057.404241,1,voc,271717327,271722127,4800,spec2/voc/Bl122_271717327.jpg,Bl122,1
7978.127748,7978.133748,1,voc,239343832,239344012,180,spec2/voc/Bl122_239343832.jpg,Bl122,1
8013.241748,8013.255748,1,voc,240397252,240397672,420,spec2/voc/Bl122_240397252.jpg,Bl122,1
5961.496256,5961.699256,1,voc,178844887,178850977,6090,spec2/voc/Bl122_178844887.jpg,Bl122,1
12667.208394,12667.402394,1,voc,380016251,380022071,5820,spec2/voc/Bl122_380016251.jpg,Bl122,1
6042.7192,6042.7302,1,voc,181281576,181281906,330,spec2/voc/Bl122_181281576.jpg,Bl122,1
14840.060682,14840.067682,1,voc,445201820,445202030,210,spec2/voc/Bl122_445201820.jpg,Bl122,1
8011.543748,8011.546748,1,voc,240346312,240346402,90,spec2/voc/Bl122_240346312.jpg,Bl122,1
10955.247807,10955.287807,1,voc,328657434,328658634,1200,spec2/voc/Bl122_328657434.jpg,Bl122,1
7802.257748,7802.259748,1,voc,234067732,234067792,60,spec2/voc/Bl122_234067732.jpg,Bl122,1
11153.49618,11153.53718,1,voc,334604885,334606115,1230,spec2/voc/Bl122_334604885.jpg,Bl122,1
6169.314327,6169.319327,1,voc,185079429,185079579,150,spec2/voc/Bl122_185079429.jpg,Bl122,1
5957.259256,5957.313256,1,voc,178717777,178719397,1620,spec2/voc/Bl122_178717777.jpg,Bl122,1
7973.862748,7973.867748,1,voc,239215882,239216032,150,spec2/voc/Bl122_239215882.jpg,Bl122,1
6134.160293,6134.166293,1,voc,184024808,184024988,180,spec2/voc/Bl122_184024808.jpg,Bl122,1
8997.813241,8998.019241,1,voc,269934397,269940577,6180,spec2/voc/Bl122_269934397.jpg,Bl122,1
10925.267807,10925.316807,1,voc,327758034,327759504,1470,spec2/voc/Bl122_327758034.jpg,Bl122,1
9148.976842,9148.991842,1,voc,274469305,274469755,450,spec2/voc/Bl122_274469305.jpg,Bl122,1
6087.67115,6087.91015,1,voc,182630134,182637304,7170,spec2/voc/Bl122_182630134.jpg,Bl122,1
10954.848807,10954.933807,1,voc,328645464,328648014,2550,spec2/voc/Bl122_328645464.jpg,Bl122,1
9044.962241,9045.194241,1,voc,271348867,271355827,6960,spec2/voc/Bl122_271348867.jpg,Bl122,1
3807.527649,3807.532649,1,voc,114225829,114225979,150,spec2/voc/Bl122_114225829.jpg,Bl122,1
8036.746748,8036.749748,1,voc,241102402,241102492,90,spec2/voc/Bl122_241102402.jpg,Bl122,1
8016.795748,8016.809748,1,voc,240503872,240504292,420,spec2/voc/Bl122_240503872.jpg,Bl122,1
3865.969367,3865.973367,1,voc,115979081,115979201,120,spec2/voc/Bl122_115979081.jpg,Bl122,1
5965.837256,5965.852256,1,voc,178975117,178975567,450,spec2/voc/Bl122_178975117.jpg,Bl122,1
5962.279256,5962.289256,1,voc,178868377,178868677,300,spec2/voc/Bl122_178868377.jpg,Bl122,1
13762.957895,13762.964895,1,voc,412888736,412888946,210,spec2/voc/Bl122_412888736.jpg,Bl122,1
3822.020649,3822.024649,1,voc,114660619,114660739,120,spec2/voc/Bl122_114660619.jpg,Bl122,1
11167.94618,11167.97218,1,voc,335038385,335039165,780,spec2/voc/Bl122_335038385.jpg,Bl122,1
11933.70857,11933.85057,1,voc,358011257,358015517,4260,spec2/voc/Bl122_358011257.jpg,Bl122,1
7781.103748,7781.107748,1,voc,233433112,233433232,120,spec2/voc/Bl122_233433112.jpg,Bl122,1
14799.894551,14799.917551,1,voc,443996836,443997526,690,spec2/voc/Bl122_443996836.jpg,Bl122,1
10961.638807,10961.998807,1,voc,328849164,328859964,10800,spec2/voc/Bl122_328849164.jpg,Bl122,1
13221.304389,13221.308389,1,voc,396639131,396639251,120,spec2/voc/Bl122_396639131.jpg,Bl122,1
8020.284748,8020.305748,1,voc,240608542,240609172,630,spec2/voc/Bl122_240608542.jpg,Bl122,1
11164.34318,11164.37318,1,voc,334930295,334931195,900,spec2/voc/Bl122_334930295.jpg,Bl122,1
14836.073682,14836.089682,1,voc,445082210,445082690,480,spec2/voc/Bl122_445082210.jpg,Bl122,1
9069.812241,9069.820241,1,voc,272094367,272094607,240,spec2/voc/Bl122_272094367.jpg,Bl122,1
7901.796748,7901.841748,1,voc,237053902,237055252,1350,spec2/voc/Bl122_237053902.jpg,Bl122,1
5943.442256,5943.650256,1,voc,178303267,178309507,6240,spec2/voc/Bl122_178303267.jpg,Bl122,1
6132.094293,6132.143293,1,voc,183962828,183964298,1470,spec2/voc/Bl122_183962828.jpg,Bl122,1
10932.514807,10932.549807,1,voc,327975444,327976494,1050,spec2/voc/Bl122_327975444.jpg,Bl122,1
9081.668241,9081.727241,1,voc,272450047,272451817,1770,spec2/voc/Bl122_272450047.jpg,Bl122,1
6039.978065,6040.026065,1,voc,181199341,181200781,1440,spec2/voc/Bl122_181199341.jpg,Bl122,1
11914.949799,11915.128799,1,voc,357448493,357453863,5370,spec2/voc/Bl122_357448493.jpg,Bl122,1
10929.891807,10930.042807,1,voc,327896754,327901284,4530,spec2/voc/Bl122_327896754.jpg,Bl122,1
13829.191664,13829.415664,1,voc,414875749,414882469,6720,spec2/voc/Bl122_414875749.jpg,Bl122,1
6012.816533,6012.826533,1,voc,180384495,180384795,300,spec2/voc/Bl122_180384495.jpg,Bl122,1
14837.631682,14837.634682,1,voc,445128950,445129040,90,spec2/voc/Bl122_445128950.jpg,Bl122,1
6035.553533,6035.584533,1,voc,181066605,181067535,930,spec2/voc/Bl122_181066605.jpg,Bl122,1
6084.57415,6084.57815,1,voc,182537224,182537344,120,spec2/voc/Bl122_182537224.jpg,Bl122,1
8013.344748,8013.348748,1,voc,240400342,240400462,120,spec2/voc/Bl122_240400342.jpg,Bl122,1
5997.093256,5997.104256,1,voc,179912797,179913127,330,spec2/voc/Bl122_179912797.jpg,Bl122,1
9099.763241,9099.806241,1,voc,272992897,272994187,1290,spec2/voc/Bl122_272992897.jpg,Bl122,1
7999.162748,7999.176748,1,voc,239974882,239975302,420,spec2/voc/Bl122_239974882.jpg,Bl122,1
6178.263327,6178.270327,1,voc,185347899,185348109,210,spec2/voc/Bl122_185347899.jpg,Bl122,1
10957.315807,10957.330807,1,voc,328719474,328719924,450,spec2/voc/Bl122_328719474.jpg,Bl122,1
9011.119241,9011.145241,1,voc,270333577,270334357,780,spec2/voc/Bl122_270333577.jpg,Bl122,1
7869.270748,7869.308748,1,voc,236078122,236079262,1140,spec2/voc/Bl122_236078122.jpg,Bl122,1
13221.213389,13221.245389,1,voc,396636401,396637361,960,spec2/voc/Bl122_396636401.jpg,Bl122,1
7941.829748,7941.839748,1,voc,238254892,238255192,300,spec2/voc/Bl122_238254892.jpg,Bl122,1
9055.105241,9055.110241,1,voc,271653157,271653307,150,spec2/voc/Bl122_271653157.jpg,Bl122,1
5945.702256,5945.708256,1,voc,178371067,178371247,180,spec2/voc/Bl122_178371067.jpg,Bl122,1
13962.075384,13962.124384,1,voc,418862261,418863731,1470,spec2/voc/Bl122_418862261.jpg,Bl122,1
7969.435748,7969.438748,1,voc,239083072,239083162,90,spec2/voc/Bl122_239083072.jpg,Bl122,1
9031.178241,9031.204241,1,voc,270935347,270936127,780,spec2/voc/Bl122_270935347.jpg,Bl122,1
5991.925256,5991.959256,1,voc,179757757,179758777,1020,spec2/voc/Bl122_179757757.jpg,Bl122,1
9053.734241,9053.739241,1,voc,271612027,271612177,150,spec2/voc/Bl122_271612027.jpg,Bl122,1
13733.848497,13733.856497,1,voc,412015454,412015694,240,spec2/voc/Bl122_412015454.jpg,Bl122,1
3796.701649,3796.705649,1,voc,113901049,113901169,120,spec2/voc/Bl122_113901049.jpg,Bl122,1
11187.20418,11187.28818,1,voc,335616125,335618645,2520,spec2/voc/Bl122_335616125.jpg,Bl122,1
8949.933967,8949.937967,1,voc,268498019,268498139,120,spec2/voc/Bl122_268498019.jpg,Bl122,1
3882.545062,3882.548062,1,voc,116476351,116476441,90,spec2/voc/Bl122_116476351.jpg,Bl122,1
8196.01075,8196.08275,1,voc,245880322,245882482,2160,spec2/voc/Bl122_245880322.jpg,Bl122,1
9164.940604,9164.943604,1,voc,274948218,274948308,90,spec2/voc/Bl122_274948218.jpg,Bl122,1
11143.592955,11143.606955,1,voc,334307788,334308208,420,spec2/voc/Bl122_334307788.jpg,Bl122,1
6018.793533,6018.798533,1,voc,180563805,180563955,150,spec2/voc/Bl122_180563805.jpg,Bl122,1
9069.629241,9069.690241,1,voc,272088877,272090707,1830,spec2/voc/Bl122_272088877.jpg,Bl122,1
13206.092389,13206.097389,1,voc,396182771,396182921,150,spec2/voc/Bl122_396182771.jpg,Bl122,1
3845.115415,3845.449415,1,voc,115353462,115363482,10020,spec2/voc/Bl122_115353462.jpg,Bl122,1
6201.676327,6201.689327,1,voc,186050289,186050679,390,spec2/voc/Bl122_186050289.jpg,Bl122,1
13946.758911,13946.762911,1,voc,418402767,418402887,120,spec2/voc/Bl122_418402767.jpg,Bl122,1
8914.912773,8914.939773,1,voc,267447383,267448193,810,spec2/voc/Bl122_267447383.jpg,Bl122,1
6146.492349,6146.523349,1,voc,184394770,184395700,930,spec2/voc/Bl122_184394770.jpg,Bl122,1
3806.940649,3806.944649,1,voc,114208219,114208339,120,spec2/voc/Bl122_114208219.jpg,Bl122,1
6170.348327,6170.365327,1,voc,185110449,185110959,510,spec2/voc/Bl122_185110449.jpg,Bl122,1
5989.121256,5989.133256,1,voc,179673637,179673997,360,spec2/voc/Bl122_179673637.jpg,Bl122,1
7887.494748,7887.518748,1,voc,236624842,236625562,720,spec2/voc/Bl122_236624842.jpg,Bl122,1
10942.937807,10943.030807,1,voc,328288134,328290924,2790,spec2/voc/Bl122_328288134.jpg,Bl122,1
6170.697327,6170.711327,1,voc,185120919,185121339,420,spec2/voc/Bl122_185120919.jpg,Bl122,1
6058.109705,6058.174705,1,voc,181743291,181745241,1950,spec2/voc/Bl122_181743291.jpg,Bl122,1
10929.104807,10929.109807,1,voc,327873144,327873294,150,spec2/voc/Bl122_327873144.jpg,Bl122,1
7955.807748,7955.813748,1,voc,238674232,238674412,180,spec2/voc/Bl122_238674232.jpg,Bl122,1
6017.851533,6017.855533,1,voc,180535545,180535665,120,spec2/voc/Bl122_180535545.jpg,Bl122,1
3895.084652,3895.135652,1,voc,116852539,116854069,1530,spec2/voc/Bl122_116852539.jpg,Bl122,1
14376.290442,14376.517442,1,voc,431288713,431295523,6810,spec2/voc/Bl122_431288713.jpg,Bl122,1
6195.097327,6195.100327,1,voc,185852919,185853009,90,spec2/voc/Bl122_185852919.jpg,Bl122,1
14818.969551,14819.112551,1,voc,444569086,444573376,4290,spec2/voc/Bl122_444569086.jpg,Bl122,1
7868.899748,7868.906748,1,voc,236066992,236067202,210,spec2/voc/Bl122_236066992.jpg,Bl122,1
6107.936706,6107.961706,1,voc,183238101,183238851,750,spec2/voc/Bl122_183238101.jpg,Bl122,1
5948.287256,5948.291256,1,voc,178448617,178448737,120,spec2/voc/Bl122_178448617.jpg,Bl122,1
9100.681241,9100.730241,1,voc,273020437,273021907,1470,spec2/voc/Bl122_273020437.jpg,Bl122,1
7949.135748,7949.158748,1,voc,238474072,238474762,690,spec2/voc/Bl122_238474072.jpg,Bl122,1
9049.335241,9049.338241,1,voc,271480057,271480147,90,spec2/voc/Bl122_271480057.jpg,Bl122,1
11032.015132,11032.084132,1,voc,330960453,330962523,2070,spec2/voc/Bl122_330960453.jpg,Bl122,1
9087.262241,9087.267241,1,voc,272617867,272618017,150,spec2/voc/Bl122_272617867.jpg,Bl122,1
9080.220241,9080.234241,1,voc,272406607,272407027,420,spec2/voc/Bl122_272406607.jpg,Bl122,1
11904.800332,11904.988332,1,voc,357144009,357149649,5640,spec2/voc/Bl122_357144009.jpg,Bl122,1
6088.79815,6088.80515,1,voc,182663944,182664154,210,spec2/voc/Bl122_182663944.jpg,Bl122,1
7907.880748,7907.891748,1,voc,237236422,237236752,330,spec2/voc/Bl122_237236422.jpg,Bl122,1
13583.748236,13583.755236,1,voc,407512447,407512657,210,spec2/voc/Bl122_407512447.jpg,Bl122,1
11209.207894,11209.231894,1,voc,336276236,336276956,720,spec2/voc/Bl122_336276236.jpg,Bl122,1
6201.921327,6202.023327,1,voc,186057639,186060699,3060,spec2/voc/Bl122_186057639.jpg,Bl122,1
5970.979256,5970.986256,1,voc,179129377,179129587,210,spec2/voc/Bl122_179129377.jpg,Bl122,1
13951.232911,13951.237911,1,voc,418536987,418537137,150,spec2/voc/Bl122_418536987.jpg,Bl122,1
13200.299389,13200.304389,1,voc,396008981,396009131,150,spec2/voc/Bl122_396008981.jpg,Bl122,1
11210.361894,11210.389894,1,voc,336310856,336311696,840,spec2/voc/Bl122_336310856.jpg,Bl122,1
12642.738333,12642.742333,1,voc,379282149,379282269,120,spec2/voc/Bl122_379282149.jpg,Bl122,1
8367.081166,8367.084166,1,voc,251012434,251012524,90,spec2/voc/Bl122_251012434.jpg,Bl122,1
13167.806658,13167.963658,1,voc,395034199,395038909,4710,spec2/voc/Bl122_395034199.jpg,Bl122,1
13933.464118,13933.468118,1,voc,418003923,418004043,120,spec2/voc/Bl122_418003923.jpg,Bl122,1
3807.405649,3807.499649,1,voc,114222169,114224989,2820,spec2/voc/Bl122_114222169.jpg,Bl122,1
3881.554062,3881.864062,1,voc,116446621,116455921,9300,spec2/voc/Bl122_116446621.jpg,Bl122,1
3057.524192,3057.529192,1,voc,91725725,91725875,150,spec2/voc/Bl122_91725725.jpg,Bl122,1
6099.62215,6099.62915,1,voc,182988664,182988874,210,spec2/voc/Bl122_182988664.jpg,Bl122,1
11138.300955,11138.318955,1,voc,334149028,334149568,540,spec2/voc/Bl122_334149028.jpg,Bl122,1
7802.483748,7802.489748,1,voc,234074512,234074692,180,spec2/voc/Bl122_234074512.jpg,Bl122,1
11203.484894,11203.498894,1,voc,336104546,336104966,420,spec2/voc/Bl122_336104546.jpg,Bl122,1
6093.18315,6093.22515,1,voc,182795494,182796754,1260,spec2/voc/Bl122_182795494.jpg,Bl122,1
9074.024241,9074.027241,1,voc,272220727,272220817,90,spec2/voc/Bl122_272220727.jpg,Bl122,1
7846.216748,7846.220748,1,voc,235386502,235386622,120,spec2/voc/Bl122_235386502.jpg,Bl122,1
10942.844807,10942.852807,1,voc,328285344,328285584,240,spec2/voc/Bl122_328285344.jpg,Bl122,1
6092.23415,6092.27715,1,voc,182767024,182768314,1290,spec2/voc/Bl122_182767024.jpg,Bl122,1
8007.238748,8007.260748,1,voc,240217162,240217822,660,spec2/voc/Bl122_240217162.jpg,Bl122,1
12939.204352,12939.242352,1,voc,388176130,388177270,1140,spec2/voc/Bl122_388176130.jpg,Bl122,1
6085.66515,6085.67015,1,voc,182569954,182570104,150,spec2/voc/Bl122_182569954.jpg,Bl122,1
12631.686392,12631.716392,1,voc,378950591,378951491,900,spec2/voc/Bl122_378950591.jpg,Bl122,1
6222.912295,6222.917295,1,voc,186687368,186687518,150,spec2/voc/Bl122_186687368.jpg,Bl122,1
11195.06018,11195.07218,1,voc,335851805,335852165,360,spec2/voc/Bl122_335851805.jpg,Bl122,1
6060.225705,6060.256705,1,voc,181806771,181807701,930,spec2/voc/Bl122_181806771.jpg,Bl122,1
6044.1042,6044.1142,1,voc,181323126,181323426,300,spec2/voc/Bl122_181323126.jpg,Bl122,1
9057.733241,9057.739241,1,voc,271731997,271732177,180,spec2/voc/Bl122_271731997.jpg,Bl122,1
5974.277256,5974.474256,1,voc,179228317,179234227,5910,spec2/voc/Bl122_179228317.jpg,Bl122,1
14798.169551,14798.306551,1,voc,443945086,443949196,4110,spec2/voc/Bl122_443945086.jpg,Bl122,1
6028.789533,6029.016533,1,voc,180863685,180870495,6810,spec2/voc/Bl122_180863685.jpg,Bl122,1
10952.611807,10952.671807,1,voc,328578354,328580154,1800,spec2/voc/Bl122_328578354.jpg,Bl122,1
6168.512327,6168.648327,1,voc,185055369,185059449,4080,spec2/voc/Bl122_185055369.jpg,Bl122,1
14804.030551,14804.047551,1,voc,444120916,444121426,510,spec2/voc/Bl122_444120916.jpg,Bl122,1
7851.864748,7851.899748,1,voc,235555942,235556992,1050,spec2/voc/Bl122_235555942.jpg,Bl122,1
7950.621748,7950.646748,1,voc,238518652,238519402,750,spec2/voc/Bl122_238518652.jpg,Bl122,1
11151.21318,11151.41318,1,voc,334536395,334542395,6000,spec2/voc/Bl122_334536395.jpg,Bl122,1
5988.131256,5988.138256,1,voc,179643937,179644147,210,spec2/voc/Bl122_179643937.jpg,Bl122,1
13169.560701,13169.586701,1,voc,395086821,395087601,780,spec2/voc/Bl122_395086821.jpg,Bl122,1
6085.93915,6086.14815,1,voc,182578174,182584444,6270,spec2/voc/Bl122_182578174.jpg,Bl122,1
6097.77015,6097.78415,1,voc,182933104,182933524,420,spec2/voc/Bl122_182933104.jpg,Bl122,1
3846.519415,3846.523415,1,voc,115395582,115395702,120,spec2/voc/Bl122_115395582.jpg,Bl122,1
6027.654533,6027.672533,1,voc,180829635,180830175,540,spec2/voc/Bl122_180829635.jpg,Bl122,1
10952.449807,10952.457807,1,voc,328573494,328573734,240,spec2/voc/Bl122_328573494.jpg,Bl122,1
9032.957241,9032.966241,1,voc,270988717,270988987,270,spec2/voc/Bl122_270988717.jpg,Bl122,1
3846.927415,3846.968415,1,voc,115407822,115409052,1230,spec2/voc/Bl122_115407822.jpg,Bl122,1
7844.219748,7844.237748,1,voc,235326592,235327132,540,spec2/voc/Bl122_235326592.jpg,Bl122,1
7961.820748,7961.855748,1,voc,238854622,238855672,1050,spec2/voc/Bl122_238854622.jpg,Bl122,1
7846.209748,7846.212748,1,voc,235386292,235386382,90,spec2/voc/Bl122_235386292.jpg,Bl122,1
14817.451551,14817.457551,1,voc,444523546,444523726,180,spec2/voc/Bl122_444523546.jpg,Bl122,1
9056.456241,9056.459241,1,voc,271693687,271693777,90,spec2/voc/Bl122_271693687.jpg,Bl122,1
8015.324748,8015.345748,1,voc,240459742,240460372,630,spec2/voc/Bl122_240459742.jpg,Bl122,1
3868.662367,3868.696367,1,voc,116059871,116060891,1020,spec2/voc/Bl122_116059871.jpg,Bl122,1
8016.872748,8016.880748,1,voc,240506182,240506422,240,spec2/voc/Bl122_240506182.jpg,Bl122,1
6024.057533,6024.072533,1,voc,180721725,180722175,450,spec2/voc/Bl122_180721725.jpg,Bl122,1
11202.395894,11202.539894,1,voc,336071876,336076196,4320,spec2/voc/Bl122_336071876.jpg,Bl122,1
10963.023807,10963.147807,1,voc,328890714,328894434,3720,spec2/voc/Bl122_328890714.jpg,Bl122,1
6097.66415,6097.66715,1,voc,182929924,182930014,90,spec2/voc/Bl122_182929924.jpg,Bl122,1
11860.365044,11860.591044,1,voc,355810951,355817731,6780,spec2/voc/Bl122_355810951.jpg,Bl122,1
9101.379241,9101.383241,1,voc,273041377,273041497,120,spec2/voc/Bl122_273041377.jpg,Bl122,1
6043.4002,6043.4242,1,voc,181302006,181302726,720,spec2/voc/Bl122_181302006.jpg,Bl122,1
10882.152609,10882.176609,1,voc,326464578,326465298,720,spec2/voc/Bl122_326464578.jpg,Bl122,1
8993.564241,8993.569241,1,voc,269806927,269807077,150,spec2/voc/Bl122_269806927.jpg,Bl122,1
7952.965748,7952.977748,1,voc,238588972,238589332,360,spec2/voc/Bl122_238588972.jpg,Bl122,1
11181.31018,11181.31418,1,voc,335439305,335439425,120,spec2/voc/Bl122_335439305.jpg,Bl122,1
14824.922551,14825.059551,1,voc,444747676,444751786,4110,spec2/voc/Bl122_444747676.jpg,Bl122,1
5955.824256,5956.070256,1,voc,178674727,178682107,7380,spec2/voc/Bl122_178674727.jpg,Bl122,1
9034.962241,9034.969241,1,voc,271048867,271049077,210,spec2/voc/Bl122_271048867.jpg,Bl122,1
7802.015748,7802.038748,1,voc,234060472,234061162,690,spec2/voc/Bl122_234060472.jpg,Bl122,1
9049.743241,9049.748241,1,voc,271492297,271492447,150,spec2/voc/Bl122_271492297.jpg,Bl122,1
5940.865256,5940.896256,1,voc,178225957,178226887,930,spec2/voc/Bl122_178225957.jpg,Bl122,1
8015.231748,8015.253748,1,voc,240456952,240457612,660,spec2/voc/Bl122_240456952.jpg,Bl122,1
7947.476748,7947.484748,1,voc,238424302,238424542,240,spec2/voc/Bl122_238424302.jpg,Bl122,1
10964.043807,10964.514807,1,voc,328921314,328935444,14130,spec2/voc/Bl122_328921314.jpg,Bl122,1
11196.61118,11196.64818,1,voc,335898335,335899445,1110,spec2/voc/Bl122_335898335.jpg,Bl122,1
6195.017327,6195.022327,1,voc,185850519,185850669,150,spec2/voc/Bl122_185850519.jpg,Bl122,1
13998.639512,13998.649512,1,voc,419959185,419959485,300,spec2/voc/Bl122_419959185.jpg,Bl122,1
13825.03722,13825.04322,1,voc,414751116,414751296,180,spec2/voc/Bl122_414751116.jpg,Bl122,1
5972.790256,5972.812256,1,voc,179183707,179184367,660,spec2/voc/Bl122_179183707.jpg,Bl122,1
5934.183256,5934.187256,1,voc,178025497,178025617,120,spec2/voc/Bl122_178025497.jpg,Bl122,1
9013.776241,9013.800241,1,voc,270413287,270414007,720,spec2/voc/Bl122_270413287.jpg,Bl122,1
10936.325807,10936.332807,1,voc,328089774,328089984,210,spec2/voc/Bl122_328089774.jpg,Bl122,1
9028.561241,9028.590241,1,voc,270856837,270857707,870,spec2/voc/Bl122_270856837.jpg,Bl122,1
7907.714748,7907.746748,1,voc,237231442,237232402,960,spec2/voc/Bl122_237231442.jpg,Bl122,1
14823.937551,14824.026551,1,voc,444718126,444720796,2670,spec2/voc/Bl122_444718126.jpg,Bl122,1
14781.787844,14781.791844,1,voc,443453635,443453755,120,spec2/voc/Bl122_443453635.jpg,Bl122,1
8015.729748,8015.776748,1,voc,240471892,240473302,1410,spec2/voc/Bl122_240471892.jpg,Bl122,1
6161.391349,6161.437349,1,voc,184841740,184843120,1380,spec2/voc/Bl122_184841740.jpg,Bl122,1
10749.407932,10749.491932,1,voc,322482237,322484757,2520,spec2/voc/Bl122_322482237.jpg,Bl122,1
7843.965748,7843.992748,1,voc,235318972,235319782,810,spec2/voc/Bl122_235318972.jpg,Bl122,1
13812.680352,13812.721352,1,voc,414380410,414381640,1230,spec2/voc/Bl122_414380410.jpg,Bl122,1
13827.29122,13827.45022,1,voc,414818736,414823506,4770,spec2/voc/Bl122_414818736.jpg,Bl122,1
11137.613955,11137.781955,1,voc,334128418,334133458,5040,spec2/voc/Bl122_334128418.jpg,Bl122,1
8979.283025,8979.414025,1,voc,269378490,269382420,3930,spec2/voc/Bl122_269378490.jpg,Bl122,1
6224.187295,6224.214295,1,voc,186725618,186726428,810,spec2/voc/Bl122_186725618.jpg,Bl122,1
9048.149241,9048.213241,1,voc,271444477,271446397,1920,spec2/voc/Bl122_271444477.jpg,Bl122,1
3796.811649,3796.816649,1,voc,113904349,113904499,150,spec2/voc/Bl122_113904349.jpg,Bl122,1
9008.517241,9008.526241,1,voc,270255517,270255787,270,spec2/voc/Bl122_270255517.jpg,Bl122,1
7975.525748,7975.531748,1,voc,239265772,239265952,180,spec2/voc/Bl122_239265772.jpg,Bl122,1
9069.450241,9069.578241,1,voc,272083507,272087347,3840,spec2/voc/Bl122_272083507.jpg,Bl122,1
9094.997241,9095.002241,1,voc,272849917,272850067,150,spec2/voc/Bl122_272849917.jpg,Bl122,1
11134.232005,11134.235005,1,voc,334026960,334027050,90,spec2/voc/Bl122_334026960.jpg,Bl122,1
13583.772236,13583.780236,1,voc,407513167,407513407,240,spec2/voc/Bl122_407513167.jpg,Bl122,1
14801.318551,14801.325551,1,voc,444039556,444039766,210,spec2/voc/Bl122_444039556.jpg,Bl122,1
9080.333241,9080.367241,1,voc,272409997,272411017,1020,spec2/voc/Bl122_272409997.jpg,Bl122,1
8014.653748,8014.721748,1,voc,240439612,240441652,2040,spec2/voc/Bl122_240439612.jpg,Bl122,1
3797.252649,3797.256649,1,voc,113917579,113917699,120,spec2/voc/Bl122_113917579.jpg,Bl122,1
6103.413706,6103.627706,1,voc,183102411,183108831,6420,spec2/voc/Bl122_183102411.jpg,Bl122,1
11163.20118,11163.20818,1,voc,334896035,334896245,210,spec2/voc/Bl122_334896035.jpg,Bl122,1
8996.211241,8996.215241,1,voc,269886337,269886457,120,spec2/voc/Bl122_269886337.jpg,Bl122,1
6073.032705,6073.099705,1,voc,182190981,182192991,2010,spec2/voc/Bl122_182190981.jpg,Bl122,1
3889.782652,3889.923652,1,voc,116693479,116697709,4230,spec2/voc/Bl122_116693479.jpg,Bl122,1
10919.589807,10919.599807,1,voc,327587694,327587994,300,spec2/voc/Bl122_327587694.jpg,Bl122,1
13219.211389,13219.241389,1,voc,396576341,396577241,900,spec2/voc/Bl122_396576341.jpg,Bl122,1
5973.797256,5973.939256,1,voc,179213917,179218177,4260,spec2/voc/Bl122_179213917.jpg,Bl122,1
7887.429748,7887.437748,1,voc,236622892,236623132,240,spec2/voc/Bl122_236622892.jpg,Bl122,1
14800.124551,14800.187551,1,voc,444003736,444005626,1890,spec2/voc/Bl122_444003736.jpg,Bl122,1
8036.718748,8036.721748,1,voc,241101562,241101652,90,spec2/voc/Bl122_241101562.jpg,Bl122,1
8926.636773,8926.664773,1,voc,267799103,267799943,840,spec2/voc/Bl122_267799103.jpg,Bl122,1
3816.983649,3816.989649,1,voc,114509509,114509689,180,spec2/voc/Bl122_114509509.jpg,Bl122,1
13176.173701,13176.303701,1,voc,395285211,395289111,3900,spec2/voc/Bl122_395285211.jpg,Bl122,1
8997.351241,8997.354241,1,voc,269920537,269920627,90,spec2/voc/Bl122_269920537.jpg,Bl122,1
6183.409327,6183.424327,1,voc,185502279,185502729,450,spec2/voc/Bl122_185502279.jpg,Bl122,1
8335.011758,8335.080758,1,voc,250050352,250052422,2070,spec2/voc/Bl122_250050352.jpg,Bl122,1
8213.416724,8213.469724,1,voc,246402501,246404091,1590,spec2/voc/Bl122_246402501.jpg,Bl122,1
6016.399533,6016.673533,1,voc,180491985,180500205,8220,spec2/voc/Bl122_180491985.jpg,Bl122,1
8018.478748,8018.483748,1,voc,240554362,240554512,150,spec2/voc/Bl122_240554362.jpg,Bl122,1
10937.363807,10937.409807,1,voc,328120914,328122294,1380,spec2/voc/Bl122_328120914.jpg,Bl122,1
11173.53018,11173.64818,1,voc,335205905,335209445,3540,spec2/voc/Bl122_335205905.jpg,Bl122,1
5969.131256,5969.141256,1,voc,179073937,179074237,300,spec2/voc/Bl122_179073937.jpg,Bl122,1
13208.047389,13208.126389,1,voc,396241421,396243791,2370,spec2/voc/Bl122_396241421.jpg,Bl122,1
5937.357256,5937.362256,1,voc,178120717,178120867,150,spec2/voc/Bl122_178120717.jpg,Bl122,1
7885.959748,7885.971748,1,voc,236578792,236579152,360,spec2/voc/Bl122_236578792.jpg,Bl122,1
6225.010295,6225.242295,1,voc,186750308,186757268,6960,spec2/voc/Bl122_186750308.jpg,Bl122,1
13193.187662,13193.202662,1,voc,395795629,395796079,450,spec2/voc/Bl122_395795629.jpg,Bl122,1
11143.489955,11143.513955,1,voc,334304698,334305418,720,spec2/voc/Bl122_334304698.jpg,Bl122,1
9088.102241,9088.117241,1,voc,272643067,272643517,450,spec2/voc/Bl122_272643067.jpg,Bl122,1
7837.761748,7837.765748,1,voc,235132852,235132972,120,spec2/voc/Bl122_235132852.jpg,Bl122,1
5988.152256,5988.160256,1,voc,179644567,179644807,240,spec2/voc/Bl122_179644567.jpg,Bl122,1
3847.908415,3847.956415,1,voc,115437252,115438692,1440,spec2/voc/Bl122_115437252.jpg,Bl122,1
6018.805533,6018.815533,1,voc,180564165,180564465,300,spec2/voc/Bl122_180564165.jpg,Bl122,1
6089.53215,6089.54215,1,voc,182685964,182686264,300,spec2/voc/Bl122_182685964.jpg,Bl122,1
7977.321748,7977.324748,1,voc,239319652,239319742,90,spec2/voc/Bl122_239319652.jpg,Bl122,1
8022.924748,8022.968748,1,voc,240687742,240689062,1320,spec2/voc/Bl122_240687742.jpg,Bl122,1
9002.815241,9002.819241,1,voc,270084457,270084577,120,spec2/voc/Bl122_270084457.jpg,Bl122,1
10929.313807,10929.358807,1,voc,327879414,327880764,1350,spec2/voc/Bl122_327879414.jpg,Bl122,1
8030.137748,8030.142748,1,voc,240904132,240904282,150,spec2/voc/Bl122_240904132.jpg,Bl122,1
14797.805551,14797.853551,1,voc,443934166,443935606,1440,spec2/voc/Bl122_443934166.jpg,Bl122,1
6226.941295,6226.948295,1,voc,186808238,186808448,210,spec2/voc/Bl122_186808238.jpg,Bl122,1
9048.950241,9048.952241,1,voc,271468507,271468567,60,spec2/voc/Bl122_271468507.jpg,Bl122,1
12661.454535,12661.518535,1,voc,379843636,379845556,1920,spec2/voc/Bl122_379843636.jpg,Bl122,1
7886.153748,7886.164748,1,voc,236584612,236584942,330,spec2/voc/Bl122_236584612.jpg,Bl122,1
8916.164773,8916.186773,1,voc,267484943,267485603,660,spec2/voc/Bl122_267484943.jpg,Bl122,1
14790.873551,14790.967551,1,voc,443726206,443729026,2820,spec2/voc/Bl122_443726206.jpg,Bl122,1
13990.218864,13990.230864,1,voc,419706565,419706925,360,spec2/voc/Bl122_419706565.jpg,Bl122,1
6104.329706,6104.398706,1,voc,183129891,183131961,2070,spec2/voc/Bl122_183129891.jpg,Bl122,1
14790.838551,14790.841551,1,voc,443725156,443725246,90,spec2/voc/Bl122_443725156.jpg,Bl122,1
6137.000293,6137.008293,1,voc,184110008,184110248,240,spec2/voc/Bl122_184110008.jpg,Bl122,1
13912.062482,13912.255482,1,voc,417361874,417367664,5790,spec2/voc/Bl122_417361874.jpg,Bl122,1
13208.577389,13208.584389,1,voc,396257321,396257531,210,spec2/voc/Bl122_396257321.jpg,Bl122,1
7908.016748,7908.096748,1,voc,237240502,237242902,2400,spec2/voc/Bl122_237240502.jpg,Bl122,1
8985.815025,8985.820025,1,voc,269574450,269574600,150,spec2/voc/Bl122_269574450.jpg,Bl122,1
3847.084415,3847.121415,1,voc,115412532,115413642,1110,spec2/voc/Bl122_115412532.jpg,Bl122,1
13586.314236,13586.414236,1,voc,407589427,407592427,3000,spec2/voc/Bl122_407589427.jpg,Bl122,1
11149.60218,11149.80518,1,voc,334488065,334494155,6090,spec2/voc/Bl122_334488065.jpg,Bl122,1
6133.262293,6133.301293,1,voc,183997868,183999038,1170,spec2/voc/Bl122_183997868.jpg,Bl122,1
5957.536256,5957.545256,1,voc,178726087,178726357,270,spec2/voc/Bl122_178726087.jpg,Bl122,1
3840.842415,3840.936415,1,voc,115225272,115228092,2820,spec2/voc/Bl122_115225272.jpg,Bl122,1
9076.476241,9076.516241,1,voc,272294287,272295487,1200,spec2/voc/Bl122_272294287.jpg,Bl122,1
13170.374701,13170.382701,1,voc,395111241,395111481,240,spec2/voc/Bl122_395111241.jpg,Bl122,1
6098.15215,6098.16415,1,voc,182944564,182944924,360,spec2/voc/Bl122_182944564.jpg,Bl122,1
11208.779894,11208.819894,1,voc,336263396,336264596,1200,spec2/voc/Bl122_336263396.jpg,Bl122,1
6057.433705,6057.765705,1,voc,181723011,181732971,9960,spec2/voc/Bl122_181723011.jpg,Bl122,1
7969.457748,7969.462748,1,voc,239083732,239083882,150,spec2/voc/Bl122_239083732.jpg,Bl122,1
6050.8072,6050.8952,1,voc,181524216,181526856,2640,spec2/voc/Bl122_181524216.jpg,Bl122,1
3860.995367,3861.168367,1,voc,115829861,115835051,5190,spec2/voc/Bl122_115829861.jpg,Bl122,1
6176.848327,6176.851327,1,voc,185305449,185305539,90,spec2/voc/Bl122_185305449.jpg,Bl122,1
7957.106748,7957.112748,1,voc,238713202,238713382,180,spec2/voc/Bl122_238713202.jpg,Bl122,1
6138.727293,6138.761293,1,voc,184161818,184162838,1020,spec2/voc/Bl122_184161818.jpg,Bl122,1
5969.759256,5969.761256,1,voc,179092777,179092837,60,spec2/voc/Bl122_179092777.jpg,Bl122,1
7976.702748,7976.709748,1,voc,239301082,239301292,210,spec2/voc/Bl122_239301082.jpg,Bl122,1
8964.246712,8964.343712,1,voc,268927401,268930311,2910,spec2/voc/Bl122_268927401.jpg,Bl122,1
13203.796389,13203.807389,1,voc,396113891,396114221,330,spec2/voc/Bl122_396113891.jpg,Bl122,1
6088.34515,6088.35715,1,voc,182650354,182650714,360,spec2/voc/Bl122_182650354.jpg,Bl122,1
11152.67418,11152.71518,1,voc,334580225,334581455,1230,spec2/voc/Bl122_334580225.jpg,Bl122,1
10929.148807,10929.151807,1,voc,327874464,327874554,90,spec2/voc/Bl122_327874464.jpg,Bl122,1
14812.196551,14812.206551,1,voc,444365896,444366196,300,spec2/voc/Bl122_444365896.jpg,Bl122,1
13815.640617,13815.662617,1,voc,414469218,414469878,660,spec2/voc/Bl122_414469218.jpg,Bl122,1
5977.997256,5978.033256,1,voc,179339917,179340997,1080,spec2/voc/Bl122_179339917.jpg,Bl122,1
6120.390706,6120.392706,1,voc,183611721,183611781,60,spec2/voc/Bl122_183611721.jpg,Bl122,1
14821.411551,14821.627551,1,voc,444642346,444648826,6480,spec2/voc/Bl122_444642346.jpg,Bl122,1
5973.338256,5973.344256,1,voc,179200147,179200327,180,spec2/voc/Bl122_179200147.jpg,Bl122,1
3846.605415,3846.608415,1,voc,115398162,115398252,90,spec2/voc/Bl122_115398162.jpg,Bl122,1
7959.776748,7959.780748,1,voc,238793302,238793422,120,spec2/voc/Bl122_238793302.jpg,Bl122,1
13584.870236,13585.196236,1,voc,407546107,407555887,9780,spec2/voc/Bl122_407546107.jpg,Bl122,1
5997.026256,5997.035256,1,voc,179910787,179911057,270,spec2/voc/Bl122_179910787.jpg,Bl122,1
11154.34318,11154.35918,1,voc,334630295,334630775,480,spec2/voc/Bl122_334630295.jpg,Bl122,1
3852.389415,3852.397415,1,voc,115571682,115571922,240,spec2/voc/Bl122_115571682.jpg,Bl122,1
8966.708712,8966.713712,1,voc,269001261,269001411,150,spec2/voc/Bl122_269001261.jpg,Bl122,1
13599.210736,13599.232736,1,voc,407976322,407976982,660,spec2/voc/Bl122_407976322.jpg,Bl122,1
9053.572241,9053.578241,1,voc,271607167,271607347,180,spec2/voc/Bl122_271607167.jpg,Bl122,1
7915.542931,7915.602931,1,voc,237466287,237468087,1800,spec2/voc/Bl122_237466287.jpg,Bl122,1
6170.533327,6170.546327,1,voc,185115999,185116389,390,spec2/voc/Bl122_185115999.jpg,Bl122,1
10930.458807,10930.496807,1,voc,327913764,327914904,1140,spec2/voc/Bl122_327913764.jpg,Bl122,1
9049.509241,9049.517241,1,voc,271485277,271485517,240,spec2/voc/Bl122_271485277.jpg,Bl122,1
3791.956649,3792.015649,1,voc,113758699,113760469,1770,spec2/voc/Bl122_113758699.jpg,Bl122,1
6048.8492,6048.9422,1,voc,181465476,181468266,2790,spec2/voc/Bl122_181465476.jpg,Bl122,1
14784.235465,14784.243465,1,voc,443527063,443527303,240,spec2/voc/Bl122_443527063.jpg,Bl122,1
5935.176256,5935.224256,1,voc,178055287,178056727,1440,spec2/voc/Bl122_178055287.jpg,Bl122,1
6222.605295,6222.610295,1,voc,186678158,186678308,150,spec2/voc/Bl122_186678158.jpg,Bl122,1
5981.975256,5981.979256,1,voc,179459257,179459377,120,spec2/voc/Bl122_179459257.jpg,Bl122,1
7812.822748,7812.833748,1,voc,234384682,234385012,330,spec2/voc/Bl122_234384682.jpg,Bl122,1
9076.407241,9076.415241,1,voc,272292217,272292457,240,spec2/voc/Bl122_272292217.jpg,Bl122,1
6069.754705,6069.758705,1,voc,182092641,182092761,120,spec2/voc/Bl122_182092641.jpg,Bl122,1
3838.902415,3838.916415,1,voc,115167072,115167492,420,spec2/voc/Bl122_115167072.jpg,Bl122,1
7860.735748,7860.752748,1,voc,235822072,235822582,510,spec2/voc/Bl122_235822072.jpg,Bl122,1
7923.290748,7923.295748,1,voc,237698722,237698872,150,spec2/voc/Bl122_237698722.jpg,Bl122,1
11981.043066,11981.229066,1,voc,359431291,359436871,5580,spec2/voc/Bl122_359431291.jpg,Bl122,1
6189.221327,6189.238327,1,voc,185676639,185677149,510,spec2/voc/Bl122_185676639.jpg,Bl122,1
6125.064706,6125.125706,1,voc,183751941,183753771,1830,spec2/voc/Bl122_183751941.jpg,Bl122,1
5985.006256,5985.019256,1,voc,179550187,179550577,390,spec2/voc/Bl122_179550187.jpg,Bl122,1
13966.348352,13966.443352,1,voc,418990450,418993300,2850,spec2/voc/Bl122_418990450.jpg,Bl122,1
13915.792392,13915.804392,1,voc,417473771,417474131,360,spec2/voc/Bl122_417473771.jpg,Bl122,1
9056.583241,9056.627241,1,voc,271697497,271698817,1320,spec2/voc/Bl122_271697497.jpg,Bl122,1
8915.931773,8915.956773,1,voc,267477953,267478703,750,spec2/voc/Bl122_267477953.jpg,Bl122,1
3827.042649,3827.066649,1,voc,114811279,114811999,720,spec2/voc/Bl122_114811279.jpg,Bl122,1
13826.03422,13826.04122,1,voc,414781026,414781236,210,spec2/voc/Bl122_414781026.jpg,Bl122,1
3897.383652,3897.433652,1,voc,116921509,116923009,1500,spec2/voc/Bl122_116921509.jpg,Bl122,1
9123.555182,9123.580182,1,voc,273706655,273707405,750,spec2/voc/Bl122_273706655.jpg,Bl122,1
7885.974748,7886.065748,1,voc,236579242,236581972,2730,spec2/voc/Bl122_236579242.jpg,Bl122,1
11194.55318,11194.59018,1,voc,335836595,335837705,1110,spec2/voc/Bl122_335836595.jpg,Bl122,1
6153.949349,6153.955349,1,voc,184618480,184618660,180,spec2/voc/Bl122_184618480.jpg,Bl122,1
7973.609748,7973.615748,1,voc,239208292,239208472,180,spec2/voc/Bl122_239208292.jpg,Bl122,1
6025.868533,6025.984533,1,voc,180776055,180779535,3480,spec2/voc/Bl122_180776055.jpg,Bl122,1
5950.792256,5950.818256,1,voc,178523767,178524547,780,spec2/voc/Bl122_178523767.jpg,Bl122,1
9026.639241,9026.652241,1,voc,270799177,270799567,390,spec2/voc/Bl122_270799177.jpg,Bl122,1
7928.467748,7928.476748,1,voc,237854032,237854302,270,spec2/voc/Bl122_237854032.jpg,Bl122,1
3870.518367,3870.547367,1,voc,116115551,116116421,870,spec2/voc/Bl122_116115551.jpg,Bl122,1
6107.553706,6107.710706,1,voc,183226611,183231321,4710,spec2/voc/Bl122_183226611.jpg,Bl122,1
5975.052256,5975.088256,1,voc,179251567,179252647,1080,spec2/voc/Bl122_179251567.jpg,Bl122,1
8981.387025,8981.399025,1,voc,269441610,269441970,360,spec2/voc/Bl122_269441610.jpg,Bl122,1
6223.740295,6223.843295,1,voc,186712208,186715298,3090,spec2/voc/Bl122_186712208.jpg,Bl122,1
9002.541241,9002.565241,1,voc,270076237,270076957,720,spec2/voc/Bl122_270076237.jpg,Bl122,1
8948.212967,8948.417967,1,voc,268446389,268452539,6150,spec2/voc/Bl122_268446389.jpg,Bl122,1
5973.465256,5973.477256,1,voc,179203957,179204317,360,spec2/voc/Bl122_179203957.jpg,Bl122,1
13922.099981,13922.105981,1,voc,417662999,417663179,180,spec2/voc/Bl122_417662999.jpg,Bl122,1
13989.993864,13989.998864,1,voc,419699815,419699965,150,spec2/voc/Bl122_419699815.jpg,Bl122,1
6017.975533,6017.984533,1,voc,180539265,180539535,270,spec2/voc/Bl122_180539265.jpg,Bl122,1
7876.905748,7876.934748,1,voc,236307172,236308042,870,spec2/voc/Bl122_236307172.jpg,Bl122,1
9127.596981,9127.599981,1,voc,273827909,273827999,90,spec2/voc/Bl122_273827909.jpg,Bl122,1
3828.946649,3829.020649,1,voc,114868399,114870619,2220,spec2/voc/Bl122_114868399.jpg,Bl122,1
8946.936967,8946.962967,1,voc,268408109,268408889,780,spec2/voc/Bl122_268408109.jpg,Bl122,1
7976.069748,7976.078748,1,voc,239282092,239282362,270,spec2/voc/Bl122_239282092.jpg,Bl122,1
8195.71275,8195.72375,1,voc,245871382,245871712,330,spec2/voc/Bl122_245871382.jpg,Bl122,1
9085.950241,9086.113241,1,voc,272578507,272583397,4890,spec2/voc/Bl122_272578507.jpg,Bl122,1
8921.985773,8922.001773,1,voc,267659573,267660053,480,spec2/voc/Bl122_267659573.jpg,Bl122,1
3847.684415,3847.688415,1,voc,115430532,115430652,120,spec2/voc/Bl122_115430532.jpg,Bl122,1
10945.203807,10945.264807,1,voc,328356114,328357944,1830,spec2/voc/Bl122_328356114.jpg,Bl122,1
14202.241387,14202.247387,1,voc,426067241,426067421,180,spec2/voc/Bl122_426067241.jpg,Bl122,1
6184.322327,6184.325327,1,voc,185529669,185529759,90,spec2/voc/Bl122_185529669.jpg,Bl122,1
3819.147649,3819.173649,1,voc,114574429,114575209,780,spec2/voc/Bl122_114574429.jpg,Bl122,1
3829.437649,3829.480649,1,voc,114883129,114884419,1290,spec2/voc/Bl122_114883129.jpg,Bl122,1
5979.533256,5979.552256,1,voc,179385997,179386567,570,spec2/voc/Bl122_179385997.jpg,Bl122,1
8022.564748,8022.592748,1,voc,240676942,240677782,840,spec2/voc/Bl122_240676942.jpg,Bl122,1
7933.088748,7933.118748,1,voc,237992662,237993562,900,spec2/voc/Bl122_237992662.jpg,Bl122,1
13946.103911,13946.107911,1,voc,418383117,418383237,120,spec2/voc/Bl122_418383117.jpg,Bl122,1
13926.710536,13926.715536,1,voc,417801316,417801466,150,spec2/voc/Bl122_417801316.jpg,Bl122,1
3808.726649,3808.746649,1,voc,114261799,114262399,600,spec2/voc/Bl122_114261799.jpg,Bl122,1
7833.370748,7833.376748,1,voc,235001122,235001302,180,spec2/voc/Bl122_235001122.jpg,Bl122,1
11898.469298,11898.640298,1,voc,356954078,356959208,5130,spec2/voc/Bl122_356954078.jpg,Bl122,1
6022.079533,6022.126533,1,voc,180662385,180663795,1410,spec2/voc/Bl122_180662385.jpg,Bl122,1
5965.108256,5965.310256,1,voc,178953247,178959307,6060,spec2/voc/Bl122_178953247.jpg,Bl122,1
6125.674706,6125.712706,1,voc,183770241,183771381,1140,spec2/voc/Bl122_183770241.jpg,Bl122,1
7962.492748,7962.501748,1,voc,238874782,238875052,270,spec2/voc/Bl122_238874782.jpg,Bl122,1
13224.095389,13224.108389,1,voc,396722861,396723251,390,spec2/voc/Bl122_396722861.jpg,Bl122,1
7885.128748,7885.131748,1,voc,236553862,236553952,90,spec2/voc/Bl122_236553862.jpg,Bl122,1
7845.509748,7845.514748,1,voc,235365292,235365442,150,spec2/voc/Bl122_235365292.jpg,Bl122,1
6171.372327,6171.404327,1,voc,185141169,185142129,960,spec2/voc/Bl122_185141169.jpg,Bl122,1
14334.910707,14334.973707,1,voc,430047321,430049211,1890,spec2/voc/Bl122_430047321.jpg,Bl122,1
10938.425807,10938.599807,1,voc,328152774,328157994,5220,spec2/voc/Bl122_328152774.jpg,Bl122,1
3883.330062,3883.352062,1,voc,116499901,116500561,660,spec2/voc/Bl122_116499901.jpg,Bl122,1
5933.706256,5933.930256,1,voc,178011187,178017907,6720,spec2/voc/Bl122_178011187.jpg,Bl122,1
8367.161166,8367.198166,1,voc,251014834,251015944,1110,spec2/voc/Bl122_251014834.jpg,Bl122,1
9095.984241,9096.006241,1,voc,272879527,272880187,660,spec2/voc/Bl122_272879527.jpg,Bl122,1
10906.445825,10906.607825,1,voc,327193374,327198234,4860,spec2/voc/Bl122_327193374.jpg,Bl122,1
7957.844748,7957.867748,1,voc,238735342,238736032,690,spec2/voc/Bl122_238735342.jpg,Bl122,1
10921.504807,10921.525807,1,voc,327645144,327645774,630,spec2/voc/Bl122_327645144.jpg,Bl122,1
3809.905649,3810.067649,1,voc,114297169,114302029,4860,spec2/voc/Bl122_114297169.jpg,Bl122,1
12591.584947,12591.588947,1,voc,377747548,377747668,120,spec2/voc/Bl122_377747548.jpg,Bl122,1
14809.252551,14809.301551,1,voc,444277576,444279046,1470,spec2/voc/Bl122_444277576.jpg,Bl122,1
6205.452327,6205.457327,1,voc,186163569,186163719,150,spec2/voc/Bl122_186163569.jpg,Bl122,1
5978.464256,5978.474256,1,voc,179353927,179354227,300,spec2/voc/Bl122_179353927.jpg,Bl122,1
11141.942955,11141.989955,1,voc,334258288,334259698,1410,spec2/voc/Bl122_334258288.jpg,Bl122,1
10940.749807,10940.760807,1,voc,328222494,328222824,330,spec2/voc/Bl122_328222494.jpg,Bl122,1
6107.439706,6107.467706,1,voc,183223191,183224031,840,spec2/voc/Bl122_183223191.jpg,Bl122,1
7965.784748,7965.786748,1,voc,238973542,238973602,60,spec2/voc/Bl122_238973542.jpg,Bl122,1
10964.899807,10964.932807,1,voc,328946994,328947984,990,spec2/voc/Bl122_328946994.jpg,Bl122,1
8939.177967,8939.301967,1,voc,268175339,268179059,3720,spec2/voc/Bl122_268175339.jpg,Bl122,1
5932.383256,5932.665256,1,voc,177971497,177979957,8460,spec2/voc/Bl122_177971497.jpg,Bl122,1
13200.622389,13200.662389,1,voc,396018671,396019871,1200,spec2/voc/Bl122_396018671.jpg,Bl122,1
6109.607706,6109.630706,1,voc,183288231,183288921,690,spec2/voc/Bl122_183288231.jpg,Bl122,1
14838.375682,14838.404682,1,voc,445151270,445152140,870,spec2/voc/Bl122_445151270.jpg,Bl122,1
9054.679241,9054.697241,1,voc,271640377,271640917,540,spec2/voc/Bl122_271640377.jpg,Bl122,1
10932.994807,10932.998807,1,voc,327989844,327989964,120,spec2/voc/Bl122_327989844.jpg,Bl122,1
11156.29818,11156.32118,1,voc,334688945,334689635,690,spec2/voc/Bl122_334688945.jpg,Bl122,1
6028.298533,6028.309533,1,voc,180848955,180849285,330,spec2/voc/Bl122_180848955.jpg,Bl122,1
10735.88064,10735.92464,1,voc,322076419,322077739,1320,spec2/voc/Bl122_322076419.jpg,Bl122,1
5931.480256,5931.510256,1,voc,177944407,177945307,900,spec2/voc/Bl122_177944407.jpg,Bl122,1
13939.2649,13939.2749,1,voc,418177947,418178247,300,spec2/voc/Bl122_418177947.jpg,Bl122,1
6222.403295,6222.414295,1,voc,186672098,186672428,330,spec2/voc/Bl122_186672098.jpg,Bl122,1
7999.374748,7999.377748,1,voc,239981242,239981332,90,spec2/voc/Bl122_239981242.jpg,Bl122,1
9033.722241,9033.761241,1,voc,271011667,271012837,1170,spec2/voc/Bl122_271011667.jpg,Bl122,1
7825.573748,7825.585748,1,voc,234767212,234767572,360,spec2/voc/Bl122_234767212.jpg,Bl122,1
9003.695241,9003.711241,1,voc,270110857,270111337,480,spec2/voc/Bl122_270110857.jpg,Bl122,1
9083.472241,9083.479241,1,voc,272504167,272504377,210,spec2/voc/Bl122_272504167.jpg,Bl122,1
13587.227236,13587.392236,1,voc,407616817,407621767,4950,spec2/voc/Bl122_407616817.jpg,Bl122,1
9029.532241,9029.770241,1,voc,270885967,270893107,7140,spec2/voc/Bl122_270885967.jpg,Bl122,1
5998.966256,5999.081256,1,voc,179968987,179972437,3450,spec2/voc/Bl122_179968987.jpg,Bl122,1
6183.302327,6183.345327,1,voc,185499069,185500359,1290,spec2/voc/Bl122_185499069.jpg,Bl122,1
9192.92898,9193.05798,1,voc,275787869,275791739,3870,spec2/voc/Bl122_275787869.jpg,Bl122,1
3819.331649,3819.555649,1,voc,114579949,114586669,6720,spec2/voc/Bl122_114579949.jpg,Bl122,1
13179.116701,13179.126701,1,voc,395373501,395373801,300,spec2/voc/Bl122_395373501.jpg,Bl122,1
10938.787807,10938.797807,1,voc,328163634,328163934,300,spec2/voc/Bl122_328163634.jpg,Bl122,1
13212.105389,13212.309389,1,voc,396363161,396369281,6120,spec2/voc/Bl122_396363161.jpg,Bl122,1
9128.641981,9128.803981,1,voc,273859259,273864119,4860,spec2/voc/Bl122_273859259.jpg,Bl122,1
5968.721256,5968.942256,1,voc,179061637,179068267,6630,spec2/voc/Bl122_179061637.jpg,Bl122,1
13829.633664,13829.721664,1,voc,414889009,414891649,2640,spec2/voc/Bl122_414889009.jpg,Bl122,1
5960.273256,5960.456256,1,voc,178808197,178813687,5490,spec2/voc/Bl122_178808197.jpg,Bl122,1
8361.120263,8361.125263,1,voc,250833607,250833757,150,spec2/voc/Bl122_250833607.jpg,Bl122,1
14139.054112,14139.297112,1,voc,424171623,424178913,7290,spec2/voc/Bl122_424171623.jpg,Bl122,1
10903.795825,10903.797825,1,voc,327113874,327113934,60,spec2/voc/Bl122_327113874.jpg,Bl122,1
9076.697241,9076.731241,1,voc,272300917,272301937,1020,spec2/voc/Bl122_272300917.jpg,Bl122,1
6223.503295,6223.540295,1,voc,186705098,186706208,1110,spec2/voc/Bl122_186705098.jpg,Bl122,1
5945.436256,5945.456256,1,voc,178363087,178363687,600,spec2/voc/Bl122_178363087.jpg,Bl122,1
12640.555849,12640.557849,1,voc,379216675,379216735,60,spec2/voc/Bl122_379216675.jpg,Bl122,1
8969.106712,8969.115712,1,voc,269073201,269073471,270,spec2/voc/Bl122_269073201.jpg,Bl122,1
8985.578025,8985.610025,1,voc,269567340,269568300,960,spec2/voc/Bl122_269567340.jpg,Bl122,1
6132.214293,6132.303293,1,voc,183966428,183969098,2670,spec2/voc/Bl122_183966428.jpg,Bl122,1
12639.128849,12639.204849,1,voc,379173865,379176145,2280,spec2/voc/Bl122_379173865.jpg,Bl122,1
9082.242241,9082.248241,1,voc,272467267,272467447,180,spec2/voc/Bl122_272467267.jpg,Bl122,1
6105.699706,6105.774706,1,voc,183170991,183173241,2250,spec2/voc/Bl122_183170991.jpg,Bl122,1
6156.757349,6156.843349,1,voc,184702720,184705300,2580,spec2/voc/Bl122_184702720.jpg,Bl122,1
14825.172551,14825.361551,1,voc,444755176,444760846,5670,spec2/voc/Bl122_444755176.jpg,Bl122,1
10946.799807,10946.805807,1,voc,328403994,328404174,180,spec2/voc/Bl122_328403994.jpg,Bl122,1
7973.115748,7973.117748,1,voc,239193472,239193532,60,spec2/voc/Bl122_239193472.jpg,Bl122,1
9037.200241,9037.209241,1,voc,271116007,271116277,270,spec2/voc/Bl122_271116007.jpg,Bl122,1
3869.816367,3869.821367,1,voc,116094491,116094641,150,spec2/voc/Bl122_116094491.jpg,Bl122,1
3816.482649,3816.487649,1,voc,114494479,114494629,150,spec2/voc/Bl122_114494479.jpg,Bl122,1
3896.140652,3896.146652,1,voc,116884219,116884399,180,spec2/voc/Bl122_116884219.jpg,Bl122,1
8017.141748,8017.144748,1,voc,240514252,240514342,90,spec2/voc/Bl122_240514252.jpg,Bl122,1
13203.072389,13203.172389,1,voc,396092171,396095171,3000,spec2/voc/Bl122_396092171.jpg,Bl122,1
13599.793736,13599.881736,1,voc,407993812,407996452,2640,spec2/voc/Bl122_407993812.jpg,Bl122,1
3394.907689,3394.921689,1,voc,101847230,101847650,420,spec2/voc/Bl122_101847230.jpg,Bl122,1
10931.520807,10931.634807,1,voc,327945624,327949044,3420,spec2/voc/Bl122_327945624.jpg,Bl122,1
3886.765062,3886.795062,1,voc,116602951,116603851,900,spec2/voc/Bl122_116602951.jpg,Bl122,1
5972.219256,5972.291256,1,voc,179166577,179168737,2160,spec2/voc/Bl122_179166577.jpg,Bl122,1
3883.950062,3883.953062,1,voc,116518501,116518591,90,spec2/voc/Bl122_116518501.jpg,Bl122,1
13659.800334,13659.825334,1,voc,409794010,409794760,750,spec2/voc/Bl122_409794010.jpg,Bl122,1
10959.145807,10959.163807,1,voc,328774374,328774914,540,spec2/voc/Bl122_328774374.jpg,Bl122,1
11160.48018,11160.48618,1,voc,334814405,334814585,180,spec2/voc/Bl122_334814405.jpg,Bl122,1
12672.623513,12672.645513,1,voc,380178705,380179365,660,spec2/voc/Bl122_380178705.jpg,Bl122,1
13960.727384,13960.757384,1,voc,418821821,418822721,900,spec2/voc/Bl122_418821821.jpg,Bl122,1
5959.372256,5959.398256,1,voc,178781167,178781947,780,spec2/voc/Bl122_178781167.jpg,Bl122,1
13826.29622,13826.31922,1,voc,414788886,414789576,690,spec2/voc/Bl122_414788886.jpg,Bl122,1
14155.178825,14155.237825,1,voc,424655364,424657134,1770,spec2/voc/Bl122_424655364.jpg,Bl122,1
12627.540577,12627.597577,1,voc,378826217,378827927,1710,spec2/voc/Bl122_378826217.jpg,Bl122,1
6011.670533,6011.677533,1,voc,180350115,180350325,210,spec2/voc/Bl122_180350115.jpg,Bl122,1
13546.833973,13546.841973,1,voc,406405019,406405259,240,spec2/voc/Bl122_406405019.jpg,Bl122,1
6035.690533,6035.928533,1,voc,181070715,181077855,7140,spec2/voc/Bl122_181070715.jpg,Bl122,1
6117.403706,6117.426706,1,voc,183522111,183522801,690,spec2/voc/Bl122_183522111.jpg,Bl122,1
3848.346415,3848.350415,1,voc,115450392,115450512,120,spec2/voc/Bl122_115450392.jpg,Bl122,1
6098.87115,6098.90315,1,voc,182966134,182967094,960,spec2/voc/Bl122_182966134.jpg,Bl122,1
3807.604649,3807.608649,1,voc,114228139,114228259,120,spec2/voc/Bl122_114228139.jpg,Bl122,1
6092.58815,6092.59615,1,voc,182777644,182777884,240,spec2/voc/Bl122_182777644.jpg,Bl122,1
11050.824,11050.963,1,voc,331524720,331528890,4170,spec2/voc/Bl122_331524720.jpg,Bl122,1
9096.138241,9096.146241,1,voc,272884147,272884387,240,spec2/voc/Bl122_272884147.jpg,Bl122,1
11135.705005,11135.747005,1,voc,334071150,334072410,1260,spec2/voc/Bl122_334071150.jpg,Bl122,1
8195.72875,8195.78175,1,voc,245871862,245873452,1590,spec2/voc/Bl122_245871862.jpg,Bl122,1
7942.880748,7942.906748,1,voc,238286422,238287202,780,spec2/voc/Bl122_238286422.jpg,Bl122,1
10964.797807,10964.828807,1,voc,328943934,328944864,930,spec2/voc/Bl122_328943934.jpg,Bl122,1
14801.730551,14801.757551,1,voc,444051916,444052726,810,spec2/voc/Bl122_444051916.jpg,Bl122,1
3828.039649,3828.225649,1,voc,114841189,114846769,5580,spec2/voc/Bl122_114841189.jpg,Bl122,1
11050.099,11050.152,1,voc,331502970,331504560,1590,spec2/voc/Bl122_331502970.jpg,Bl122,1
7844.781748,7844.787748,1,voc,235343452,235343632,180,spec2/voc/Bl122_235343452.jpg,Bl122,1
13983.372943,13983.632943,1,voc,419501188,419508988,7800,spec2/voc/Bl122_419501188.jpg,Bl122,1
13961.037384,13961.042384,1,voc,418831121,418831271,150,spec2/voc/Bl122_418831121.jpg,Bl122,1
14797.650551,14797.685551,1,voc,443929516,443930566,1050,spec2/voc/Bl122_443929516.jpg,Bl122,1
3795.325649,3795.335649,1,voc,113859769,113860069,300,spec2/voc/Bl122_113859769.jpg,Bl122,1
10937.433807,10937.440807,1,voc,328123014,328123224,210,spec2/voc/Bl122_328123014.jpg,Bl122,1
6119.159706,6119.234706,1,voc,183574791,183577041,2250,spec2/voc/Bl122_183574791.jpg,Bl122,1
9123.657182,9123.680182,1,voc,273709715,273710405,690,spec2/voc/Bl122_273709715.jpg,Bl122,1
7912.075748,7912.103748,1,voc,237362272,237363112,840,spec2/voc/Bl122_237362272.jpg,Bl122,1
13976.443117,13976.447117,1,voc,419293293,419293413,120,spec2/voc/Bl122_419293293.jpg,Bl122,1
8196.31775,8196.39375,1,voc,245889532,245891812,2280,spec2/voc/Bl122_245889532.jpg,Bl122,1
3839.704415,3839.732415,1,voc,115191132,115191972,840,spec2/voc/Bl122_115191132.jpg,Bl122,1
3830.237649,3830.427649,1,voc,114907129,114912829,5700,spec2/voc/Bl122_114907129.jpg,Bl122,1
6187.982327,6187.991327,1,voc,185639469,185639739,270,spec2/voc/Bl122_185639469.jpg,Bl122,1
11193.91918,11193.92418,1,voc,335817575,335817725,150,spec2/voc/Bl122_335817575.jpg,Bl122,1
13743.309896,13743.348896,1,voc,412299296,412300466,1170,spec2/voc/Bl122_412299296.jpg,Bl122,1
5957.977256,5958.002256,1,voc,178739317,178740067,750,spec2/voc/Bl122_178739317.jpg,Bl122,1
9066.285241,9066.394241,1,voc,271988557,271991827,3270,spec2/voc/Bl122_271988557.jpg,Bl122,1
5953.163256,5953.175256,1,voc,178594897,178595257,360,spec2/voc/Bl122_178594897.jpg,Bl122,1
9056.461241,9056.502241,1,voc,271693837,271695067,1230,spec2/voc/Bl122_271693837.jpg,Bl122,1
3850.148415,3850.320415,1,voc,115504452,115509612,5160,spec2/voc/Bl122_115504452.jpg,Bl122,1
9076.449241,9076.452241,1,voc,272293477,272293567,90,spec2/voc/Bl122_272293477.jpg,Bl122,1
8018.301748,8018.305748,1,voc,240549052,240549172,120,spec2/voc/Bl122_240549052.jpg,Bl122,1
11046.385537,11046.432537,1,voc,331391566,331392976,1410,spec2/voc/Bl122_331391566.jpg,Bl122,1
11174.38318,11174.41318,1,voc,335231495,335232395,900,spec2/voc/Bl122_335231495.jpg,Bl122,1
7973.298748,7973.303748,1,voc,239198962,239199112,150,spec2/voc/Bl122_239198962.jpg,Bl122,1
14814.559551,14814.752551,1,voc,444436786,444442576,5790,spec2/voc/Bl122_444436786.jpg,Bl122,1
13155.966066,13155.987066,1,voc,394678981,394679611,630,spec2/voc/Bl122_394678981.jpg,Bl122,1
14792.919551,14792.925551,1,voc,443787586,443787766,180,spec2/voc/Bl122_443787586.jpg,Bl122,1
7876.044748,7876.053748,1,voc,236281342,236281612,270,spec2/voc/Bl122_236281342.jpg,Bl122,1
8012.981748,8012.988748,1,voc,240389452,240389662,210,spec2/voc/Bl122_240389452.jpg,Bl122,1
14817.468551,14817.493551,1,voc,444524056,444524806,750,spec2/voc/Bl122_444524056.jpg,Bl122,1
3805.885649,3806.036649,1,voc,114176569,114181099,4530,spec2/voc/Bl122_114176569.jpg,Bl122,1
6157.675349,6157.768349,1,voc,184730260,184733050,2790,spec2/voc/Bl122_184730260.jpg,Bl122,1
5961.288256,5961.343256,1,voc,178838647,178840297,1650,spec2/voc/Bl122_178838647.jpg,Bl122,1
5986.117256,5986.166256,1,voc,179583517,179584987,1470,spec2/voc/Bl122_179583517.jpg,Bl122,1
10926.141807,10926.153807,1,voc,327784254,327784614,360,spec2/voc/Bl122_327784254.jpg,Bl122,1
14794.986551,14794.988551,1,voc,443849596,443849656,60,spec2/voc/Bl122_443849596.jpg,Bl122,1
7875.153748,7875.161748,1,voc,236254612,236254852,240,spec2/voc/Bl122_236254612.jpg,Bl122,1
13189.575662,13189.579662,1,voc,395687269,395687389,120,spec2/voc/Bl122_395687269.jpg,Bl122,1
6000.856256,6000.954256,1,voc,180025687,180028627,2940,spec2/voc/Bl122_180025687.jpg,Bl122,1
9072.251241,9072.259241,1,voc,272167537,272167777,240,spec2/voc/Bl122_272167537.jpg,Bl122,1
7870.279748,7870.282748,1,voc,236108392,236108482,90,spec2/voc/Bl122_236108392.jpg,Bl122,1
13554.762188,13554.765188,1,voc,406642865,406642955,90,spec2/voc/Bl122_406642865.jpg,Bl122,1
6009.253533,6009.280533,1,voc,180277605,180278415,810,spec2/voc/Bl122_180277605.jpg,Bl122,1
8928.237773,8928.244773,1,voc,267847133,267847343,210,spec2/voc/Bl122_267847133.jpg,Bl122,1
13922.111981,13922.263981,1,voc,417663359,417667919,4560,spec2/voc/Bl122_417663359.jpg,Bl122,1
14825.143551,14825.150551,1,voc,444754306,444754516,210,spec2/voc/Bl122_444754306.jpg,Bl122,1
6030.495533,6030.511533,1,voc,180914865,180915345,480,spec2/voc/Bl122_180914865.jpg,Bl122,1
5970.247256,5970.291256,1,voc,179107417,179108737,1320,spec2/voc/Bl122_179107417.jpg,Bl122,1
7842.476748,7842.515748,1,voc,235274302,235275472,1170,spec2/voc/Bl122_235274302.jpg,Bl122,1
13172.318701,13172.323701,1,voc,395169561,395169711,150,spec2/voc/Bl122_395169561.jpg,Bl122,1
9108.269935,9108.329935,1,voc,273248098,273249898,1800,spec2/voc/Bl122_273248098.jpg,Bl122,1
13967.355352,13967.367352,1,voc,419020660,419021020,360,spec2/voc/Bl122_419020660.jpg,Bl122,1
3795.395649,3795.399649,1,voc,113861869,113861989,120,spec2/voc/Bl122_113861869.jpg,Bl122,1
5965.028256,5965.034256,1,voc,178950847,178951027,180,spec2/voc/Bl122_178950847.jpg,Bl122,1
10920.016807,10920.033807,1,voc,327600504,327601014,510,spec2/voc/Bl122_327600504.jpg,Bl122,1
5928.314748,5928.341748,1,voc,177849442,177850252,810,spec2/voc/Bl122_177849442.jpg,Bl122,1
7988.445748,7988.479748,1,voc,239653372,239654392,1020,spec2/voc/Bl122_239653372.jpg,Bl122,1
6052.9202,6052.9882,1,voc,181587606,181589646,2040,spec2/voc/Bl122_181587606.jpg,Bl122,1
14825.993551,14826.065551,1,voc,444779806,444781966,2160,spec2/voc/Bl122_444779806.jpg,Bl122,1
11178.51118,11178.53718,1,voc,335355335,335356115,780,spec2/voc/Bl122_335355335.jpg,Bl122,1
14801.881551,14801.888551,1,voc,444056446,444056656,210,spec2/voc/Bl122_444056446.jpg,Bl122,1
7969.424748,7969.431748,1,voc,239082742,239082952,210,spec2/voc/Bl122_239082742.jpg,Bl122,1
9009.462241,9009.475241,1,voc,270283867,270284257,390,spec2/voc/Bl122_270283867.jpg,Bl122,1
7882.903748,7882.915748,1,voc,236487112,236487472,360,spec2/voc/Bl122_236487112.jpg,Bl122,1
9028.246241,9028.371241,1,voc,270847387,270851137,3750,spec2/voc/Bl122_270847387.jpg,Bl122,1
5930.391256,5930.393256,1,voc,177911737,177911797,60,spec2/voc/Bl122_177911737.jpg,Bl122,1
6095.51315,6095.57815,1,voc,182865394,182867344,1950,spec2/voc/Bl122_182865394.jpg,Bl122,1
14004.353779,14004.525779,1,voc,420130613,420135773,5160,spec2/voc/Bl122_420130613.jpg,Bl122,1
5972.878256,5972.883256,1,voc,179186347,179186497,150,spec2/voc/Bl122_179186347.jpg,Bl122,1
9000.043241,9000.062241,1,voc,270001297,270001867,570,spec2/voc/Bl122_270001297.jpg,Bl122,1
13177.487701,13177.549701,1,voc,395324631,395326491,1860,spec2/voc/Bl122_395324631.jpg,Bl122,1
10926.727807,10926.755807,1,voc,327801834,327802674,840,spec2/voc/Bl122_327801834.jpg,Bl122,1
13565.786867,13565.849867,1,voc,406973606,406975496,1890,spec2/voc/Bl122_406973606.jpg,Bl122,1
13973.428117,13973.430117,1,voc,419202843,419202903,60,spec2/voc/Bl122_419202843.jpg,Bl122,1
5986.169256,5986.217256,1,voc,179585077,179586517,1440,spec2/voc/Bl122_179585077.jpg,Bl122,1
9060.646241,9060.650241,1,voc,271819387,271819507,120,spec2/voc/Bl122_271819387.jpg,Bl122,1
13968.971352,13968.974352,1,voc,419069140,419069230,90,spec2/voc/Bl122_419069140.jpg,Bl122,1
7919.195748,7919.205748,1,voc,237575872,237576172,300,spec2/voc/Bl122_237575872.jpg,Bl122,1
6187.374327,6187.552327,1,voc,185621229,185626569,5340,spec2/voc/Bl122_185621229.jpg,Bl122,1
13998.660512,13998.674512,1,voc,419959815,419960235,420,spec2/voc/Bl122_419959815.jpg,Bl122,1
14822.652551,14822.722551,1,voc,444679576,444681676,2100,spec2/voc/Bl122_444679576.jpg,Bl122,1
5969.688256,5969.692256,1,voc,179090647,179090767,120,spec2/voc/Bl122_179090647.jpg,Bl122,1
11163.21218,11163.22318,1,voc,334896365,334896695,330,spec2/voc/Bl122_334896365.jpg,Bl122,1
10938.339807,10938.366807,1,voc,328150194,328151004,810,spec2/voc/Bl122_328150194.jpg,Bl122,1
5992.386256,5992.414256,1,voc,179771587,179772427,840,spec2/voc/Bl122_179771587.jpg,Bl122,1
5958.052256,5958.085256,1,voc,178741567,178742557,990,spec2/voc/Bl122_178741567.jpg,Bl122,1
8207.293882,8207.360882,1,voc,246218816,246220826,2010,spec2/voc/Bl122_246218816.jpg,Bl122,1
5954.450256,5954.469256,1,voc,178633507,178634077,570,spec2/voc/Bl122_178633507.jpg,Bl122,1
10920.065807,10920.069807,1,voc,327601974,327602094,120,spec2/voc/Bl122_327601974.jpg,Bl122,1
9025.775241,9025.918241,1,voc,270773257,270777547,4290,spec2/voc/Bl122_270773257.jpg,Bl122,1
7984.077748,7984.086748,1,voc,239522332,239522602,270,spec2/voc/Bl122_239522332.jpg,Bl122,1
6026.050533,6026.055533,1,voc,180781515,180781665,150,spec2/voc/Bl122_180781515.jpg,Bl122,1
14810.516551,14810.711551,1,voc,444315496,444321346,5850,spec2/voc/Bl122_444315496.jpg,Bl122,1
5972.425256,5972.435256,1,voc,179172757,179173057,300,spec2/voc/Bl122_179172757.jpg,Bl122,1
13965.928352,13966.088352,1,voc,418977850,418982650,4800,spec2/voc/Bl122_418977850.jpg,Bl122,1
7886.723748,7886.749748,1,voc,236601712,236602492,780,spec2/voc/Bl122_236601712.jpg,Bl122,1
5946.949256,5946.952256,1,voc,178408477,178408567,90,spec2/voc/Bl122_178408477.jpg,Bl122,1
8993.270241,8993.475241,1,voc,269798107,269804257,6150,spec2/voc/Bl122_269798107.jpg,Bl122,1
8952.111967,8952.132967,1,voc,268563359,268563989,630,spec2/voc/Bl122_268563359.jpg,Bl122,1
10956.014807,10956.050807,1,voc,328680444,328681524,1080,spec2/voc/Bl122_328680444.jpg,Bl122,1
10940.293807,10940.299807,1,voc,328208814,328208994,180,spec2/voc/Bl122_328208814.jpg,Bl122,1
9028.481241,9028.484241,1,voc,270854437,270854527,90,spec2/voc/Bl122_270854437.jpg,Bl122,1
5985.031256,5985.243256,1,voc,179550937,179557297,6360,spec2/voc/Bl122_179550937.jpg,Bl122,1
3839.741415,3839.747415,1,voc,115192242,115192422,180,spec2/voc/Bl122_115192242.jpg,Bl122,1
11141.595955,11141.616955,1,voc,334247878,334248508,630,spec2/voc/Bl122_334247878.jpg,Bl122,1
7911.709748,7911.726748,1,voc,237351292,237351802,510,spec2/voc/Bl122_237351292.jpg,Bl122,1
6090.82015,6090.85915,1,voc,182724604,182725774,1170,spec2/voc/Bl122_182724604.jpg,Bl122,1
6109.771706,6109.776706,1,voc,183293151,183293301,150,spec2/voc/Bl122_183293151.jpg,Bl122,1
3884.055062,3884.057062,1,voc,116521651,116521711,60,spec2/voc/Bl122_116521651.jpg,Bl122,1
7906.665748,7906.689748,1,voc,237199972,237200692,720,spec2/voc/Bl122_237199972.jpg,Bl122,1
3888.822652,3889.144652,1,voc,116664679,116674339,9660,spec2/voc/Bl122_116664679.jpg,Bl122,1
3821.821649,3821.883649,1,voc,114654649,114656509,1860,spec2/voc/Bl122_114654649.jpg,Bl122,1
13812.515352,13812.609352,1,voc,414375460,414378280,2820,spec2/voc/Bl122_414375460.jpg,Bl122,1
9100.737241,9100.761241,1,voc,273022117,273022837,720,spec2/voc/Bl122_273022117.jpg,Bl122,1
5954.426256,5954.443256,1,voc,178632787,178633297,510,spec2/voc/Bl122_178632787.jpg,Bl122,1
14794.238551,14794.249551,1,voc,443827156,443827486,330,spec2/voc/Bl122_443827156.jpg,Bl122,1
10750.055932,10750.155932,1,voc,322501677,322504677,3000,spec2/voc/Bl122_322501677.jpg,Bl122,1
13219.694389,13219.697389,1,voc,396590831,396590921,90,spec2/voc/Bl122_396590831.jpg,Bl122,1
3840.161415,3840.246415,1,voc,115204842,115207392,2550,spec2/voc/Bl122_115204842.jpg,Bl122,1
11189.30218,11189.34118,1,voc,335679065,335680235,1170,spec2/voc/Bl122_335679065.jpg,Bl122,1
13558.554616,13558.739616,1,voc,406756638,406762188,5550,spec2/voc/Bl122_406756638.jpg,Bl122,1
7987.721748,7987.726748,1,voc,239631652,239631802,150,spec2/voc/Bl122_239631652.jpg,Bl122,1
9020.885241,9020.908241,1,voc,270626557,270627247,690,spec2/voc/Bl122_270626557.jpg,Bl122,1
7878.596748,7878.602748,1,voc,236357902,236358082,180,spec2/voc/Bl122_236357902.jpg,Bl122,1
6097.75015,6097.75715,1,voc,182932504,182932714,210,spec2/voc/Bl122_182932504.jpg,Bl122,1
5978.477256,5978.502256,1,voc,179354317,179355067,750,spec2/voc/Bl122_179354317.jpg,Bl122,1
9124.486182,9124.578182,1,voc,273734585,273737345,2760,spec2/voc/Bl122_273734585.jpg,Bl122,1
9012.561241,9012.760241,1,voc,270376837,270382807,5970,spec2/voc/Bl122_270376837.jpg,Bl122,1
7856.301748,7856.308748,1,voc,235689052,235689262,210,spec2/voc/Bl122_235689052.jpg,Bl122,1
12598.306308,12598.376308,1,voc,377949189,377951289,2100,spec2/voc/Bl122_377949189.jpg,Bl122,1
11177.21418,11177.21718,1,voc,335316425,335316515,90,spec2/voc/Bl122_335316425.jpg,Bl122,1
12939.264352,12939.287352,1,voc,388177930,388178620,690,spec2/voc/Bl122_388177930.jpg,Bl122,1
6144.637349,6144.643349,1,voc,184339120,184339300,180,spec2/voc/Bl122_184339120.jpg,Bl122,1
3828.920649,3828.933649,1,voc,114867619,114868009,390,spec2/voc/Bl122_114867619.jpg,Bl122,1
8949.104967,8949.135967,1,voc,268473149,268474079,930,spec2/voc/Bl122_268473149.jpg,Bl122,1
9013.500241,9013.505241,1,voc,270405007,270405157,150,spec2/voc/Bl122_270405007.jpg,Bl122,1
10959.838807,10959.845807,1,voc,328795164,328795374,210,spec2/voc/Bl122_328795164.jpg,Bl122,1
10914.440807,10914.447807,1,voc,327433224,327433434,210,spec2/voc/Bl122_327433224.jpg,Bl122,1
6118.501706,6118.504706,1,voc,183555051,183555141,90,spec2/voc/Bl122_183555051.jpg,Bl122,1
13546.800973,13546.814973,1,voc,406404029,406404449,420,spec2/voc/Bl122_406404029.jpg,Bl122,1
7855.046748,7855.055748,1,voc,235651402,235651672,270,spec2/voc/Bl122_235651402.jpg,Bl122,1
6144.678349,6144.688349,1,voc,184340350,184340650,300,spec2/voc/Bl122_184340350.jpg,Bl122,1
14844.035682,14844.043682,1,voc,445321070,445321310,240,spec2/voc/Bl122_445321070.jpg,Bl122,1
7789.446748,7789.453748,1,voc,233683402,233683612,210,spec2/voc/Bl122_233683402.jpg,Bl122,1
7860.858748,7860.901748,1,voc,235825762,235827052,1290,spec2/voc/Bl122_235825762.jpg,Bl122,1
5955.415256,5955.621256,1,voc,178662457,178668637,6180,spec2/voc/Bl122_178662457.jpg,Bl122,1
6028.023533,6028.048533,1,voc,180840705,180841455,750,spec2/voc/Bl122_180840705.jpg,Bl122,1
13984.244943,13984.248943,1,voc,419527348,419527468,120,spec2/voc/Bl122_419527348.jpg,Bl122,1
5977.249256,5977.257256,1,voc,179317477,179317717,240,spec2/voc/Bl122_179317477.jpg,Bl122,1
9007.347241,9007.356241,1,voc,270220417,270220687,270,spec2/voc/Bl122_270220417.jpg,Bl122,1
13221.081389,13221.088389,1,voc,396632441,396632651,210,spec2/voc/Bl122_396632441.jpg,Bl122,1
6228.117295,6228.137295,1,voc,186843518,186844118,600,spec2/voc/Bl122_186843518.jpg,Bl122,1
8991.950241,8992.013241,1,voc,269758507,269760397,1890,spec2/voc/Bl122_269758507.jpg,Bl122,1
3839.795415,3840.126415,1,voc,115193862,115203792,9930,spec2/voc/Bl122_115193862.jpg,Bl122,1
14792.928551,14792.963551,1,voc,443787856,443788906,1050,spec2/voc/Bl122_443787856.jpg,Bl122,1
9054.739241,9054.781241,1,voc,271642177,271643437,1260,spec2/voc/Bl122_271642177.jpg,Bl122,1
6121.572706,6121.670706,1,voc,183647181,183650121,2940,spec2/voc/Bl122_183647181.jpg,Bl122,1
13816.752617,13816.823617,1,voc,414502578,414504708,2130,spec2/voc/Bl122_414502578.jpg,Bl122,1
7798.913748,7798.916748,1,voc,233967412,233967502,90,spec2/voc/Bl122_233967412.jpg,Bl122,1
3829.077649,3829.113649,1,voc,114872329,114873409,1080,spec2/voc/Bl122_114872329.jpg,Bl122,1
3817.025649,3817.259649,1,voc,114510769,114517789,7020,spec2/voc/Bl122_114510769.jpg,Bl122,1
6092.93115,6092.93515,1,voc,182787934,182788054,120,spec2/voc/Bl122_182787934.jpg,Bl122,1
13554.897188,13554.899188,1,voc,406646915,406646975,60,spec2/voc/Bl122_406646915.jpg,Bl122,1
7886.846748,7886.851748,1,voc,236605402,236605552,150,spec2/voc/Bl122_236605402.jpg,Bl122,1
6096.60415,6096.73415,1,voc,182898124,182902024,3900,spec2/voc/Bl122_182898124.jpg,Bl122,1
5983.978256,5984.212256,1,voc,179519347,179526367,7020,spec2/voc/Bl122_179519347.jpg,Bl122,1
6160.786349,6160.847349,1,voc,184823590,184825420,1830,spec2/voc/Bl122_184823590.jpg,Bl122,1
6068.338705,6068.344705,1,voc,182050161,182050341,180,spec2/voc/Bl122_182050161.jpg,Bl122,1
6025.690533,6025.817533,1,voc,180770715,180774525,3810,spec2/voc/Bl122_180770715.jpg,Bl122,1
5983.879256,5983.882256,1,voc,179516377,179516467,90,spec2/voc/Bl122_179516377.jpg,Bl122,1
11138.032955,11138.150955,1,voc,334140988,334144528,3540,spec2/voc/Bl122_334140988.jpg,Bl122,1
5977.088256,5977.243256,1,voc,179312647,179317297,4650,spec2/voc/Bl122_179312647.jpg,Bl122,1
11129.838005,11129.841005,1,voc,333895140,333895230,90,spec2/voc/Bl122_333895140.jpg,Bl122,1
7777.249748,7777.251748,1,voc,233317492,233317552,60,spec2/voc/Bl122_233317492.jpg,Bl122,1
7853.352748,7853.515748,1,voc,235600582,235605472,4890,spec2/voc/Bl122_235600582.jpg,Bl122,1
9077.176241,9077.215241,1,voc,272315287,272316457,1170,spec2/voc/Bl122_272315287.jpg,Bl122,1
9093.696241,9093.702241,1,voc,272810887,272811067,180,spec2/voc/Bl122_272810887.jpg,Bl122,1
9077.434241,9077.440241,1,voc,272323027,272323207,180,spec2/voc/Bl122_272323027.jpg,Bl122,1
13912.501482,13912.512482,1,voc,417375044,417375374,330,spec2/voc/Bl122_417375044.jpg,Bl122,1
7828.557748,7828.589748,1,voc,234856732,234857692,960,spec2/voc/Bl122_234856732.jpg,Bl122,1
9043.307241,9043.311241,1,voc,271299217,271299337,120,spec2/voc/Bl122_271299217.jpg,Bl122,1
3881.254062,3881.300062,1,voc,116437621,116439001,1380,spec2/voc/Bl122_116437621.jpg,Bl122,1
8208.248882,8208.316882,1,voc,246247466,246249506,2040,spec2/voc/Bl122_246247466.jpg,Bl122,1
13163.554891,13163.557891,1,voc,394906646,394906736,90,spec2/voc/Bl122_394906646.jpg,Bl122,1
13818.467617,13818.469617,1,voc,414554028,414554088,60,spec2/voc/Bl122_414554028.jpg,Bl122,1
6097.54315,6097.55815,1,voc,182926294,182926744,450,spec2/voc/Bl122_182926294.jpg,Bl122,1
10937.451807,10937.465807,1,voc,328123554,328123974,420,spec2/voc/Bl122_328123554.jpg,Bl122,1
13581.444236,13581.578236,1,voc,407443327,407447347,4020,spec2/voc/Bl122_407443327.jpg,Bl122,1
13204.384389,13204.407389,1,voc,396131531,396132221,690,spec2/voc/Bl122_396131531.jpg,Bl122,1
7854.309748,7854.349748,1,voc,235629292,235630492,1200,spec2/voc/Bl122_235629292.jpg,Bl122,1
13580.101236,13580.119236,1,voc,407403037,407403577,540,spec2/voc/Bl122_407403037.jpg,Bl122,1
5959.468256,5959.495256,1,voc,178784047,178784857,810,spec2/voc/Bl122_178784047.jpg,Bl122,1
3894.135652,3894.143652,1,voc,116824069,116824309,240,spec2/voc/Bl122_116824069.jpg,Bl122,1
13984.360943,13984.362943,1,voc,419530828,419530888,60,spec2/voc/Bl122_419530828.jpg,Bl122,1
5978.313256,5978.342256,1,voc,179349397,179350267,870,spec2/voc/Bl122_179349397.jpg,Bl122,1
10947.081807,10947.084807,1,voc,328412454,328412544,90,spec2/voc/Bl122_328412454.jpg,Bl122,1
11209.747894,11209.767894,1,voc,336292436,336293036,600,spec2/voc/Bl122_336292436.jpg,Bl122,1
3795.406649,3795.647649,1,voc,113862199,113869429,7230,spec2/voc/Bl122_113862199.jpg,Bl122,1
8921.097773,8921.106773,1,voc,267632933,267633203,270,spec2/voc/Bl122_267632933.jpg,Bl122,1
9096.810241,9096.942241,1,voc,272904307,272908267,3960,spec2/voc/Bl122_272904307.jpg,Bl122,1
5952.412256,5952.417256,1,voc,178572367,178572517,150,spec2/voc/Bl122_178572367.jpg,Bl122,1
10887.906136,10888.000136,1,voc,326637184,326640004,2820,spec2/voc/Bl122_326637184.jpg,Bl122,1
7937.627748,7937.653748,1,voc,238128832,238129612,780,spec2/voc/Bl122_238128832.jpg,Bl122,1
5937.931256,5937.988256,1,voc,178137937,178139647,1710,spec2/voc/Bl122_178137937.jpg,Bl122,1
7907.989748,7908.005748,1,voc,237239692,237240172,480,spec2/voc/Bl122_237239692.jpg,Bl122,1
7812.671748,7812.683748,1,voc,234380152,234380512,360,spec2/voc/Bl122_234380152.jpg,Bl122,1
13819.343617,13819.378617,1,voc,414580308,414581358,1050,spec2/voc/Bl122_414580308.jpg,Bl122,1
13956.337384,13956.358384,1,voc,418690121,418690751,630,spec2/voc/Bl122_418690121.jpg,Bl122,1
10898.11156,10898.11456,1,voc,326943346,326943436,90,spec2/voc/Bl122_326943346.jpg,Bl122,1
3808.838649,3808.860649,1,voc,114265159,114265819,660,spec2/voc/Bl122_114265159.jpg,Bl122,1
7908.258748,7908.281748,1,voc,237247762,237248452,690,spec2/voc/Bl122_237247762.jpg,Bl122,1
10957.445807,10957.567807,1,voc,328723374,328727034,3660,spec2/voc/Bl122_328723374.jpg,Bl122,1
6097.71615,6097.73715,1,voc,182931484,182932114,630,spec2/voc/Bl122_182931484.jpg,Bl122,1
3801.223649,3801.361649,1,voc,114036709,114040849,4140,spec2/voc/Bl122_114036709.jpg,Bl122,1
9094.166241,9094.552241,1,voc,272824987,272836567,11580,spec2/voc/Bl122_272824987.jpg,Bl122,1
5954.005256,5954.059256,1,voc,178620157,178621777,1620,spec2/voc/Bl122_178620157.jpg,Bl122,1
3824.428649,3824.549649,1,voc,114732859,114736489,3630,spec2/voc/Bl122_114732859.jpg,Bl122,1
6003.766256,6003.768256,1,voc,180112987,180113047,60,spec2/voc/Bl122_180112987.jpg,Bl122,1
8927.128773,8927.134773,1,voc,267813863,267814043,180,spec2/voc/Bl122_267813863.jpg,Bl122,1
12639.637849,12639.704849,1,voc,379189135,379191145,2010,spec2/voc/Bl122_379189135.jpg,Bl122,1
10856.043233,10856.045233,1,voc,325681296,325681356,60,spec2/voc/Bl122_325681296.jpg,Bl122,1
10915.205807,10915.214807,1,voc,327456174,327456444,270,spec2/voc/Bl122_327456174.jpg,Bl122,1
8355.672686,8355.773686,1,voc,250670180,250673210,3030,spec2/voc/Bl122_250670180.jpg,Bl122,1
3846.833415,3846.859415,1,voc,115405002,115405782,780,spec2/voc/Bl122_115405002.jpg,Bl122,1
12614.885964,12614.962964,1,voc,378446578,378448888,2310,spec2/voc/Bl122_378446578.jpg,Bl122,1
13659.656334,13659.725334,1,voc,409789690,409791760,2070,spec2/voc/Bl122_409789690.jpg,Bl122,1
14841.761682,14841.770682,1,voc,445252850,445253120,270,spec2/voc/Bl122_445252850.jpg,Bl122,1
6157.639349,6157.665349,1,voc,184729180,184729960,780,spec2/voc/Bl122_184729180.jpg,Bl122,1
11133.910005,11134.048005,1,voc,334017300,334021440,4140,spec2/voc/Bl122_334017300.jpg,Bl122,1
10937.414807,10937.430807,1,voc,328122444,328122924,480,spec2/voc/Bl122_328122444.jpg,Bl122,1
3798.005649,3798.012649,1,voc,113940169,113940379,210,spec2/voc/Bl122_113940169.jpg,Bl122,1
3830.844649,3831.177649,1,voc,114925339,114935329,9990,spec2/voc/Bl122_114925339.jpg,Bl122,1
3807.616649,3807.646649,1,voc,114228499,114229399,900,spec2/voc/Bl122_114228499.jpg,Bl122,1
5980.418256,5980.434256,1,voc,179412547,179413027,480,spec2/voc/Bl122_179412547.jpg,Bl122,1
13168.083658,13168.110658,1,voc,395042509,395043319,810,spec2/voc/Bl122_395042509.jpg,Bl122,1
5940.849256,5940.858256,1,voc,178225477,178225747,270,spec2/voc/Bl122_178225477.jpg,Bl122,1
7907.917748,7907.957748,1,voc,237237532,237238732,1200,spec2/voc/Bl122_237237532.jpg,Bl122,1
7921.312748,7921.315748,1,voc,237639382,237639472,90,spec2/voc/Bl122_237639382.jpg,Bl122,1
7983.683748,7983.727748,1,voc,239510512,239511832,1320,spec2/voc/Bl122_239510512.jpg,Bl122,1
9095.243241,9095.476241,1,voc,272857297,272864287,6990,spec2/voc/Bl122_272857297.jpg,Bl122,1
6125.149706,6125.174706,1,voc,183754491,183755241,750,spec2/voc/Bl122_183754491.jpg,Bl122,1
6047.3712,6047.4012,1,voc,181421136,181422036,900,spec2/voc/Bl122_181421136.jpg,Bl122,1
6125.021706,6125.030706,1,voc,183750651,183750921,270,spec2/voc/Bl122_183750651.jpg,Bl122,1
13949.532911,13949.605911,1,voc,418485987,418488177,2190,spec2/voc/Bl122_418485987.jpg,Bl122,1
13570.103052,13570.162052,1,voc,407103091,407104861,1770,spec2/voc/Bl122_407103091.jpg,Bl122,1
13208.813389,13208.817389,1,voc,396264401,396264521,120,spec2/voc/Bl122_396264401.jpg,Bl122,1
7993.670748,7993.694748,1,voc,239810122,239810842,720,spec2/voc/Bl122_239810122.jpg,Bl122,1
9072.333241,9072.336241,1,voc,272169997,272170087,90,spec2/voc/Bl122_272169997.jpg,Bl122,1
10950.743807,10950.985807,1,voc,328522314,328529574,7260,spec2/voc/Bl122_328522314.jpg,Bl122,1
3808.777649,3808.792649,1,voc,114263329,114263779,450,spec2/voc/Bl122_114263329.jpg,Bl122,1
3846.088415,3846.122415,1,voc,115382652,115383672,1020,spec2/voc/Bl122_115382652.jpg,Bl122,1
6141.378349,6141.452349,1,voc,184241350,184243570,2220,spec2/voc/Bl122_184241350.jpg,Bl122,1
12591.110947,12591.115947,1,voc,377733328,377733478,150,spec2/voc/Bl122_377733328.jpg,Bl122,1
14794.350551,14794.357551,1,voc,443830516,443830726,210,spec2/voc/Bl122_443830516.jpg,Bl122,1
7884.517748,7884.528748,1,voc,236535532,236535862,330,spec2/voc/Bl122_236535532.jpg,Bl122,1
7955.616748,7955.645748,1,voc,238668502,238669372,870,spec2/voc/Bl122_238668502.jpg,Bl122,1
14708.622469,14708.624469,1,voc,441258674,441258734,60,spec2/voc/Bl122_441258674.jpg,Bl122,1
14814.233551,14814.346551,1,voc,444427006,444430396,3390,spec2/voc/Bl122_444427006.jpg,Bl122,1
6056.416705,6056.418705,1,voc,181692501,181692561,60,spec2/voc/Bl122_181692501.jpg,Bl122,1
13732.244497,13732.277497,1,voc,411967334,411968324,990,spec2/voc/Bl122_411967334.jpg,Bl122,1
11167.24218,11167.26418,1,voc,335017265,335017925,660,spec2/voc/Bl122_335017265.jpg,Bl122,1
3820.267649,3820.282649,1,voc,114608029,114608479,450,spec2/voc/Bl122_114608029.jpg,Bl122,1
6067.013705,6067.107705,1,voc,182010411,182013231,2820,spec2/voc/Bl122_182010411.jpg,Bl122,1
7962.042748,7962.068748,1,voc,238861282,238862062,780,spec2/voc/Bl122_238861282.jpg,Bl122,1
3807.058649,3807.069649,1,voc,114211759,114212089,330,spec2/voc/Bl122_114211759.jpg,Bl122,1
5990.900256,5990.914256,1,voc,179727007,179727427,420,spec2/voc/Bl122_179727007.jpg,Bl122,1
9061.614241,9061.620241,1,voc,271848427,271848607,180,spec2/voc/Bl122_271848427.jpg,Bl122,1
7861.952748,7862.007748,1,voc,235858582,235860232,1650,spec2/voc/Bl122_235858582.jpg,Bl122,1
8012.750748,8012.767748,1,voc,240382522,240383032,510,spec2/voc/Bl122_240382522.jpg,Bl122,1
13221.031389,13221.050389,1,voc,396630941,396631511,570,spec2/voc/Bl122_396630941.jpg,Bl122,1
9161.354057,9161.443057,1,voc,274840621,274843291,2670,spec2/voc/Bl122_274840621.jpg,Bl122,1
13918.880483,13919.068483,1,voc,417566414,417572054,5640,spec2/voc/Bl122_417566414.jpg,Bl122,1
10944.075807,10944.302807,1,voc,328322274,328329084,6810,spec2/voc/Bl122_328322274.jpg,Bl122,1
13915.617392,13915.781392,1,voc,417468521,417473441,4920,spec2/voc/Bl122_417468521.jpg,Bl122,1
7897.066748,7897.115748,1,voc,236912002,236913472,1470,spec2/voc/Bl122_236912002.jpg,Bl122,1
3865.152367,3865.159367,1,voc,115954571,115954781,210,spec2/voc/Bl122_115954571.jpg,Bl122,1
6058.299705,6058.317705,1,voc,181748991,181749531,540,spec2/voc/Bl122_181748991.jpg,Bl122,1
7885.851748,7885.865748,1,voc,236575552,236575972,420,spec2/voc/Bl122_236575552.jpg,Bl122,1
7940.789748,7940.810748,1,voc,238223692,238224322,630,spec2/voc/Bl122_238223692.jpg,Bl122,1
9077.786241,9077.828241,1,voc,272333587,272334847,1260,spec2/voc/Bl122_272333587.jpg,Bl122,1
6132.322293,6132.334293,1,voc,183969668,183970028,360,spec2/voc/Bl122_183969668.jpg,Bl122,1
11195.46818,11195.49018,1,voc,335864045,335864705,660,spec2/voc/Bl122_335864045.jpg,Bl122,1
10956.898807,10956.922807,1,voc,328706964,328707684,720,spec2/voc/Bl122_328706964.jpg,Bl122,1
13222.381389,13222.401389,1,voc,396671441,396672041,600,spec2/voc/Bl122_396671441.jpg,Bl122,1
8011.564748,8011.569748,1,voc,240346942,240347092,150,spec2/voc/Bl122_240346942.jpg,Bl122,1
7785.777748,7785.783748,1,voc,233573332,233573512,180,spec2/voc/Bl122_233573332.jpg,Bl122,1
13211.922389,13211.968389,1,voc,396357671,396359051,1380,spec2/voc/Bl122_396357671.jpg,Bl122,1
12582.513041,12582.520041,1,voc,377475391,377475601,210,spec2/voc/Bl122_377475391.jpg,Bl122,1
10942.654807,10942.709807,1,voc,328279644,328281294,1650,spec2/voc/Bl122_328279644.jpg,Bl122,1
6172.973327,6173.263327,1,voc,185189199,185197899,8700,spec2/voc/Bl122_185189199.jpg,Bl122,1
5957.680256,5957.925256,1,voc,178730407,178737757,7350,spec2/voc/Bl122_178730407.jpg,Bl122,1
3819.578649,3819.585649,1,voc,114587359,114587569,210,spec2/voc/Bl122_114587359.jpg,Bl122,1
6048.1502,6048.1652,1,voc,181444506,181444956,450,spec2/voc/Bl122_181444506.jpg,Bl122,1
3810.997649,3811.003649,1,voc,114329929,114330109,180,spec2/voc/Bl122_114329929.jpg,Bl122,1
5992.877256,5992.907256,1,voc,179786317,179787217,900,spec2/voc/Bl122_179786317.jpg,Bl122,1
6029.563533,6029.600533,1,voc,180886905,180888015,1110,spec2/voc/Bl122_180886905.jpg,Bl122,1
6148.995349,6148.999349,1,voc,184469860,184469980,120,spec2/voc/Bl122_184469860.jpg,Bl122,1
6109.742706,6109.744706,1,voc,183292281,183292341,60,spec2/voc/Bl122_183292281.jpg,Bl122,1
13180.075701,13180.157701,1,voc,395402271,395404731,2460,spec2/voc/Bl122_395402271.jpg,Bl122,1
12670.580513,12670.830513,1,voc,380117415,380124915,7500,spec2/voc/Bl122_380117415.jpg,Bl122,1
6004.911256,6004.934256,1,voc,180147337,180148027,690,spec2/voc/Bl122_180147337.jpg,Bl122,1
11162.17018,11162.26418,1,voc,334865105,334867925,2820,spec2/voc/Bl122_334865105.jpg,Bl122,1
9004.621241,9004.637241,1,voc,270138637,270139117,480,spec2/voc/Bl122_270138637.jpg,Bl122,1
13199.973389,13199.975389,1,voc,395999201,395999261,60,spec2/voc/Bl122_395999201.jpg,Bl122,1
8917.062773,8917.189773,1,voc,267511883,267515693,3810,spec2/voc/Bl122_267511883.jpg,Bl122,1
6020.074533,6020.081533,1,voc,180602235,180602445,210,spec2/voc/Bl122_180602235.jpg,Bl122,1
6132.951293,6132.996293,1,voc,183988538,183989888,1350,spec2/voc/Bl122_183988538.jpg,Bl122,1
6103.108706,6103.390706,1,voc,183093261,183101721,8460,spec2/voc/Bl122_183093261.jpg,Bl122,1
12685.374186,12685.455186,1,voc,380561225,380563655,2430,spec2/voc/Bl122_380561225.jpg,Bl122,1
10749.672932,10750.052932,1,voc,322490187,322501587,11400,spec2/voc/Bl122_322490187.jpg,Bl122,1
9128.838981,9128.909981,1,voc,273865169,273867299,2130,spec2/voc/Bl122_273865169.jpg,Bl122,1
9060.667241,9060.697241,1,voc,271820017,271820917,900,spec2/voc/Bl122_271820017.jpg,Bl122,1
13958.849384,13958.862384,1,voc,418765481,418765871,390,spec2/voc/Bl122_418765481.jpg,Bl122,1
6062.141705,6062.337705,1,voc,181864251,181870131,5880,spec2/voc/Bl122_181864251.jpg,Bl122,1
7876.981748,7876.983748,1,voc,236309452,236309512,60,spec2/voc/Bl122_236309452.jpg,Bl122,1
3810.134649,3810.139649,1,voc,114304039,114304189,150,spec2/voc/Bl122_114304039.jpg,Bl122,1
14793.058551,14793.462551,1,voc,443791756,443803876,12120,spec2/voc/Bl122_443791756.jpg,Bl122,1
14838.648682,14838.701682,1,voc,445159460,445161050,1590,spec2/voc/Bl122_445159460.jpg,Bl122,1
13973.283117,13973.286117,1,voc,419198493,419198583,90,spec2/voc/Bl122_419198493.jpg,Bl122,1
13789.95646,13789.95946,1,voc,413698693,413698783,90,spec2/voc/Bl122_413698693.jpg,Bl122,1
3805.568649,3805.599649,1,voc,114167059,114167989,930,spec2/voc/Bl122_114167059.jpg,Bl122,1
10965.177807,10965.382807,1,voc,328955334,328961484,6150,spec2/voc/Bl122_328955334.jpg,Bl122,1
5966.802256,5966.806256,1,voc,179004067,179004187,120,spec2/voc/Bl122_179004067.jpg,Bl122,1
6108.003706,6108.014706,1,voc,183240111,183240441,330,spec2/voc/Bl122_183240111.jpg,Bl122,1
7876.440748,7876.480748,1,voc,236293222,236294422,1200,spec2/voc/Bl122_236293222.jpg,Bl122,1
6084.01215,6084.13115,1,voc,182520364,182523934,3570,spec2/voc/Bl122_182520364.jpg,Bl122,1
8026.834748,8026.838748,1,voc,240805042,240805162,120,spec2/voc/Bl122_240805042.jpg,Bl122,1
8018.461748,8018.473748,1,voc,240553852,240554212,360,spec2/voc/Bl122_240553852.jpg,Bl122,1
6086.80515,6086.97915,1,voc,182604154,182609374,5220,spec2/voc/Bl122_182604154.jpg,Bl122,1
7856.727748,7856.809748,1,voc,235701832,235704292,2460,spec2/voc/Bl122_235701832.jpg,Bl122,1
7983.135748,7983.154748,1,voc,239494072,239494642,570,spec2/voc/Bl122_239494072.jpg,Bl122,1
6150.484349,6150.491349,1,voc,184514530,184514740,210,spec2/voc/Bl122_184514530.jpg,Bl122,1
9078.945241,9078.950241,1,voc,272368357,272368507,150,spec2/voc/Bl122_272368357.jpg,Bl122,1
6015.122533,6015.226533,1,voc,180453675,180456795,3120,spec2/voc/Bl122_180453675.jpg,Bl122,1
10924.381807,10924.386807,1,voc,327731454,327731604,150,spec2/voc/Bl122_327731454.jpg,Bl122,1
3844.950415,3844.953415,1,voc,115348512,115348602,90,spec2/voc/Bl122_115348512.jpg,Bl122,1
6191.369327,6191.374327,1,voc,185741079,185741229,150,spec2/voc/Bl122_185741079.jpg,Bl122,1
13193.369662,13193.379662,1,voc,395801089,395801389,300,spec2/voc/Bl122_395801089.jpg,Bl122,1
6158.288349,6158.526349,1,voc,184748650,184755790,7140,spec2/voc/Bl122_184748650.jpg,Bl122,1
14175.356361,14175.565361,1,voc,425260690,425266960,6270,spec2/voc/Bl122_425260690.jpg,Bl122,1
5950.889256,5951.139256,1,voc,178526677,178534177,7500,spec2/voc/Bl122_178526677.jpg,Bl122,1
14799.961551,14799.965551,1,voc,443998846,443998966,120,spec2/voc/Bl122_443998846.jpg,Bl122,1
9070.833241,9070.841241,1,voc,272124997,272125237,240,spec2/voc/Bl122_272124997.jpg,Bl122,1
9058.239241,9058.243241,1,voc,271747177,271747297,120,spec2/voc/Bl122_271747177.jpg,Bl122,1
13169.679701,13169.702701,1,voc,395090391,395091081,690,spec2/voc/Bl122_395090391.jpg,Bl122,1
7881.933748,7881.953748,1,voc,236458012,236458612,600,spec2/voc/Bl122_236458012.jpg,Bl122,1
5949.313256,5949.318256,1,voc,178479397,178479547,150,spec2/voc/Bl122_178479397.jpg,Bl122,1
14835.787682,14835.793682,1,voc,445073630,445073810,180,spec2/voc/Bl122_445073630.jpg,Bl122,1
6033.101533,6033.170533,1,voc,180993045,180995115,2070,spec2/voc/Bl122_180993045.jpg,Bl122,1
6117.431706,6117.441706,1,voc,183522951,183523251,300,spec2/voc/Bl122_183522951.jpg,Bl122,1
6063.908705,6063.933705,1,voc,181917261,181918011,750,spec2/voc/Bl122_181917261.jpg,Bl122,1
13210.474389,13210.909389,1,voc,396314231,396327281,13050,spec2/voc/Bl122_396314231.jpg,Bl122,1
14149.232855,14149.235855,1,voc,424476985,424477075,90,spec2/voc/Bl122_424476985.jpg,Bl122,1
7798.144748,7798.157748,1,voc,233944342,233944732,390,spec2/voc/Bl122_233944342.jpg,Bl122,1
14811.067551,14811.070551,1,voc,444332026,444332116,90,spec2/voc/Bl122_444332026.jpg,Bl122,1
8921.181773,8921.378773,1,voc,267635453,267641363,5910,spec2/voc/Bl122_267635453.jpg,Bl122,1
13580.545236,13580.549236,1,voc,407416357,407416477,120,spec2/voc/Bl122_407416357.jpg,Bl122,1
6061.358705,6061.513705,1,voc,181840761,181845411,4650,spec2/voc/Bl122_181840761.jpg,Bl122,1
13947.181911,13947.321911,1,voc,418415457,418419657,4200,spec2/voc/Bl122_418415457.jpg,Bl122,1
6068.365705,6068.388705,1,voc,182050971,182051661,690,spec2/voc/Bl122_182050971.jpg,Bl122,1
13733.315497,13733.339497,1,voc,411999464,412000184,720,spec2/voc/Bl122_411999464.jpg,Bl122,1
5979.240256,5979.258256,1,voc,179377207,179377747,540,spec2/voc/Bl122_179377207.jpg,Bl122,1
13207.093389,13207.098389,1,voc,396212801,396212951,150,spec2/voc/Bl122_396212801.jpg,Bl122,1
7923.271748,7923.277748,1,voc,237698152,237698332,180,spec2/voc/Bl122_237698152.jpg,Bl122,1
9167.771604,9167.780604,1,voc,275033148,275033418,270,spec2/voc/Bl122_275033148.jpg,Bl122,1
13827.56722,13827.58922,1,voc,414827016,414827676,660,spec2/voc/Bl122_414827016.jpg,Bl122,1
10912.227807,10912.232807,1,voc,327366834,327366984,150,spec2/voc/Bl122_327366834.jpg,Bl122,1
6198.891327,6198.895327,1,voc,185966739,185966859,120,spec2/voc/Bl122_185966739.jpg,Bl122,1
12598.386308,12598.390308,1,voc,377951589,377951709,120,spec2/voc/Bl122_377951589.jpg,Bl122,1
5945.616256,5945.688256,1,voc,178368487,178370647,2160,spec2/voc/Bl122_178368487.jpg,Bl122,1
7973.626748,7973.630748,1,voc,239208802,239208922,120,spec2/voc/Bl122_239208802.jpg,Bl122,1
9123.405182,9123.443182,1,voc,273702155,273703295,1140,spec2/voc/Bl122_273702155.jpg,Bl122,1
7961.579748,7961.586748,1,voc,238847392,238847602,210,spec2/voc/Bl122_238847392.jpg,Bl122,1
6097.56115,6097.57115,1,voc,182926834,182927134,300,spec2/voc/Bl122_182926834.jpg,Bl122,1
8014.126748,8014.214748,1,voc,240423802,240426442,2640,spec2/voc/Bl122_240423802.jpg,Bl122,1
6098.34415,6098.36715,1,voc,182950324,182951014,690,spec2/voc/Bl122_182950324.jpg,Bl122,1
13244.255606,13244.260606,1,voc,397327668,397327818,150,spec2/voc/Bl122_397327668.jpg,Bl122,1
14836.109682,14836.167682,1,voc,445083290,445085030,1740,spec2/voc/Bl122_445083290.jpg,Bl122,1
6004.755256,6004.879256,1,voc,180142657,180146377,3720,spec2/voc/Bl122_180142657.jpg,Bl122,1
13606.110736,13606.118736,1,voc,408183322,408183562,240,spec2/voc/Bl122_408183322.jpg,Bl122,1
13950.507911,13950.590911,1,voc,418515237,418517727,2490,spec2/voc/Bl122_418515237.jpg,Bl122,1
9025.472241,9025.492241,1,voc,270764167,270764767,600,spec2/voc/Bl122_270764167.jpg,Bl122,1
13951.576911,13951.603911,1,voc,418547307,418548117,810,spec2/voc/Bl122_418547307.jpg,Bl122,1
8957.587967,8957.600967,1,voc,268727639,268728029,390,spec2/voc/Bl122_268727639.jpg,Bl122,1
5963.349256,5963.369256,1,voc,178900477,178901077,600,spec2/voc/Bl122_178900477.jpg,Bl122,1
7923.373748,7923.389748,1,voc,237701212,237701692,480,spec2/voc/Bl122_237701212.jpg,Bl122,1
9056.879241,9056.930241,1,voc,271706377,271707907,1530,spec2/voc/Bl122_271706377.jpg,Bl122,1
8949.879967,8949.922967,1,voc,268496399,268497689,1290,spec2/voc/Bl122_268496399.jpg,Bl122,1
6057.399705,6057.407705,1,voc,181721991,181722231,240,spec2/voc/Bl122_181721991.jpg,Bl122,1
9003.847241,9003.852241,1,voc,270115417,270115567,150,spec2/voc/Bl122_270115417.jpg,Bl122,1
10905.599825,10905.673825,1,voc,327167994,327170214,2220,spec2/voc/Bl122_327167994.jpg,Bl122,1
12591.590947,12591.603947,1,voc,377747728,377748118,390,spec2/voc/Bl122_377747728.jpg,Bl122,1
13244.767606,13244.839606,1,voc,397343028,397345188,2160,spec2/voc/Bl122_397343028.jpg,Bl122,1
14322.047978,14322.052978,1,voc,429661439,429661589,150,spec2/voc/Bl122_429661439.jpg,Bl122,1
10960.386807,10960.392807,1,voc,328811604,328811784,180,spec2/voc/Bl122_328811604.jpg,Bl122,1
8993.889241,8993.900241,1,voc,269816677,269817007,330,spec2/voc/Bl122_269816677.jpg,Bl122,1
8922.654773,8922.657773,1,voc,267679643,267679733,90,spec2/voc/Bl122_267679643.jpg,Bl122,1
3829.388649,3829.413649,1,voc,114881659,114882409,750,spec2/voc/Bl122_114881659.jpg,Bl122,1
6058.507705,6058.723705,1,voc,181755231,181761711,6480,spec2/voc/Bl122_181755231.jpg,Bl122,1
6108.766706,6108.772706,1,voc,183263001,183263181,180,spec2/voc/Bl122_183263001.jpg,Bl122,1
6080.725511,6080.792511,1,voc,182421765,182423775,2010,spec2/voc/Bl122_182421765.jpg,Bl122,1
13951.213911,13951.230911,1,voc,418536417,418536927,510,spec2/voc/Bl122_418536417.jpg,Bl122,1
6036.152533,6036.158533,1,voc,181084575,181084755,180,spec2/voc/Bl122_181084575.jpg,Bl122,1
9064.528241,9064.551241,1,voc,271935847,271936537,690,spec2/voc/Bl122_271935847.jpg,Bl122,1
3839.452415,3839.559415,1,voc,115183572,115186782,3210,spec2/voc/Bl122_115183572.jpg,Bl122,1
9089.689241,9089.890241,1,voc,272690677,272696707,6030,spec2/voc/Bl122_272690677.jpg,Bl122,1
6149.635349,6149.742349,1,voc,184489060,184492270,3210,spec2/voc/Bl122_184489060.jpg,Bl122,1
8202.413005,8202.535005,1,voc,246072390,246076050,3660,spec2/voc/Bl122_246072390.jpg,Bl122,1
3883.941062,3883.946062,1,voc,116518231,116518381,150,spec2/voc/Bl122_116518231.jpg,Bl122,1
9073.007241,9073.009241,1,voc,272190217,272190277,60,spec2/voc/Bl122_272190217.jpg,Bl122,1
7876.822748,7876.845748,1,voc,236304682,236305372,690,spec2/voc/Bl122_236304682.jpg,Bl122,1
13582.249236,13582.365236,1,voc,407467477,407470957,3480,spec2/voc/Bl122_407467477.jpg,Bl122,1
7929.190748,7929.208748,1,voc,237875722,237876262,540,spec2/voc/Bl122_237875722.jpg,Bl122,1
8365.157015,8365.201015,1,voc,250954710,250956030,1320,spec2/voc/Bl122_250954710.jpg,Bl122,1
6110.320706,6110.334706,1,voc,183309621,183310041,420,spec2/voc/Bl122_183309621.jpg,Bl122,1
7932.140748,7932.203748,1,voc,237964222,237966112,1890,spec2/voc/Bl122_237964222.jpg,Bl122,1
5949.820256,5950.047256,1,voc,178494607,178501417,6810,spec2/voc/Bl122_178494607.jpg,Bl122,1
13929.610797,13929.771797,1,voc,417888323,417893153,4830,spec2/voc/Bl122_417888323.jpg,Bl122,1
11211.192894,11211.216894,1,voc,336335786,336336506,720,spec2/voc/Bl122_336335786.jpg,Bl122,1
6021.853533,6021.863533,1,voc,180655605,180655905,300,spec2/voc/Bl122_180655605.jpg,Bl122,1
13946.922911,13947.073911,1,voc,418407687,418412217,4530,spec2/voc/Bl122_418407687.jpg,Bl122,1
6062.777705,6062.811705,1,voc,181883331,181884351,1020,spec2/voc/Bl122_181883331.jpg,Bl122,1
3852.305415,3852.317415,1,voc,115569162,115569522,360,spec2/voc/Bl122_115569162.jpg,Bl122,1
3841.502415,3841.535415,1,voc,115245072,115246062,990,spec2/voc/Bl122_115245072.jpg,Bl122,1
6022.262533,6022.284533,1,voc,180667875,180668535,660,spec2/voc/Bl122_180667875.jpg,Bl122,1
7843.650748,7843.673748,1,voc,235309522,235310212,690,spec2/voc/Bl122_235309522.jpg,Bl122,1
3896.791652,3896.807652,1,voc,116903749,116904229,480,spec2/voc/Bl122_116903749.jpg,Bl122,1
8019.494748,8019.532748,1,voc,240584842,240585982,1140,spec2/voc/Bl122_240584842.jpg,Bl122,1
3859.493367,3859.571367,1,voc,115784801,115787141,2340,spec2/voc/Bl122_115784801.jpg,Bl122,1
13156.411066,13156.424066,1,voc,394692331,394692721,390,spec2/voc/Bl122_394692331.jpg,Bl122,1
14314.836024,14315.006024,1,voc,429445080,429450180,5100,spec2/voc/Bl122_429445080.jpg,Bl122,1
13156.444066,13156.515066,1,voc,394693321,394695451,2130,spec2/voc/Bl122_394693321.jpg,Bl122,1
10947.181807,10947.203807,1,voc,328415454,328416114,660,spec2/voc/Bl122_328415454.jpg,Bl122,1
10907.086825,10907.116825,1,voc,327212604,327213504,900,spec2/voc/Bl122_327212604.jpg,Bl122,1
8038.897748,8038.899748,1,voc,241166932,241166992,60,spec2/voc/Bl122_241166932.jpg,Bl122,1
8926.254773,8926.438773,1,voc,267787643,267793163,5520,spec2/voc/Bl122_267787643.jpg,Bl122,1
8938.290967,8938.294967,1,voc,268148729,268148849,120,spec2/voc/Bl122_268148729.jpg,Bl122,1
12661.203535,12661.269535,1,voc,379836106,379838086,1980,spec2/voc/Bl122_379836106.jpg,Bl122,1
14805.073551,14805.078551,1,voc,444152206,444152356,150,spec2/voc/Bl122_444152206.jpg,Bl122,1
3863.978367,3864.015367,1,voc,115919351,115920461,1110,spec2/voc/Bl122_115919351.jpg,Bl122,1
13244.531606,13244.572606,1,voc,397335948,397337178,1230,spec2/voc/Bl122_397335948.jpg,Bl122,1
11173.23318,11173.27618,1,voc,335196995,335198285,1290,spec2/voc/Bl122_335196995.jpg,Bl122,1
7877.034748,7877.044748,1,voc,236311042,236311342,300,spec2/voc/Bl122_236311042.jpg,Bl122,1
6101.909706,6101.915706,1,voc,183057291,183057471,180,spec2/voc/Bl122_183057291.jpg,Bl122,1
8027.914748,8027.928748,1,voc,240837442,240837862,420,spec2/voc/Bl122_240837442.jpg,Bl122,1
9007.909241,9008.075241,1,voc,270237277,270242257,4980,spec2/voc/Bl122_270237277.jpg,Bl122,1
14825.375551,14825.425551,1,voc,444761266,444762766,1500,spec2/voc/Bl122_444761266.jpg,Bl122,1
3807.545649,3807.592649,1,voc,114226369,114227779,1410,spec2/voc/Bl122_114226369.jpg,Bl122,1
6140.666349,6140.746349,1,voc,184219990,184222390,2400,spec2/voc/Bl122_184219990.jpg,Bl122,1
11124.364005,11124.370005,1,voc,333730920,333731100,180,spec2/voc/Bl122_333730920.jpg,Bl122,1
3394.809689,3394.850689,1,voc,101844290,101845520,1230,spec2/voc/Bl122_101844290.jpg,Bl122,1
13966.238352,13966.245352,1,voc,418987150,418987360,210,spec2/voc/Bl122_418987150.jpg,Bl122,1
13218.651389,13218.666389,1,voc,396559541,396559991,450,spec2/voc/Bl122_396559541.jpg,Bl122,1
10906.676825,10906.681825,1,voc,327200304,327200454,150,spec2/voc/Bl122_327200304.jpg,Bl122,1
6069.438705,6069.462705,1,voc,182083161,182083881,720,spec2/voc/Bl122_182083161.jpg,Bl122,1
10959.166807,10959.203807,1,voc,328775004,328776114,1110,spec2/voc/Bl122_328775004.jpg,Bl122,1
14790.310551,14790.504551,1,voc,443709316,443715136,5820,spec2/voc/Bl122_443709316.jpg,Bl122,1
6055.796705,6055.846705,1,voc,181673901,181675401,1500,spec2/voc/Bl122_181673901.jpg,Bl122,1
3810.787649,3810.952649,1,voc,114323629,114328579,4950,spec2/voc/Bl122_114323629.jpg,Bl122,1
13220.363389,13220.371389,1,voc,396610901,396611141,240,spec2/voc/Bl122_396610901.jpg,Bl122,1
11100.052855,11100.093855,1,voc,333001585,333002815,1230,spec2/voc/Bl122_333001585.jpg,Bl122,1
9143.162757,9143.207757,1,voc,274294882,274296232,1350,spec2/voc/Bl122_274294882.jpg,Bl122,1
11915.379799,11915.443799,1,voc,357461393,357463313,1920,spec2/voc/Bl122_357461393.jpg,Bl122,1
6075.456705,6075.458705,1,voc,182263701,182263761,60,spec2/voc/Bl122_182263701.jpg,Bl122,1
7970.151748,7970.154748,1,voc,239104552,239104642,90,spec2/voc/Bl122_239104552.jpg,Bl122,1
14796.090551,14796.099551,1,voc,443882716,443882986,270,spec2/voc/Bl122_443882716.jpg,Bl122,1
13221.010389,13221.013389,1,voc,396630311,396630401,90,spec2/voc/Bl122_396630311.jpg,Bl122,1
6068.349705,6068.360705,1,voc,182050491,182050821,330,spec2/voc/Bl122_182050491.jpg,Bl122,1
3883.358062,3883.507062,1,voc,116500741,116505211,4470,spec2/voc/Bl122_116500741.jpg,Bl122,1
6221.782295,6221.792295,1,voc,186653468,186653768,300,spec2/voc/Bl122_186653468.jpg,Bl122,1
14183.321102,14183.323102,1,voc,425499633,425499693,60,spec2/voc/Bl122_425499633.jpg,Bl122,1
5944.382256,5944.384256,1,voc,178331467,178331527,60,spec2/voc/Bl122_178331467.jpg,Bl122,1
13967.317352,13967.327352,1,voc,419019520,419019820,300,spec2/voc/Bl122_419019520.jpg,Bl122,1
8968.733712,8968.871712,1,voc,269062011,269066151,4140,spec2/voc/Bl122_269062011.jpg,Bl122,1
13961.558384,13961.659384,1,voc,418846751,418849781,3030,spec2/voc/Bl122_418846751.jpg,Bl122,1
6066.035705,6066.070705,1,voc,181981071,181982121,1050,spec2/voc/Bl122_181981071.jpg,Bl122,1
13976.241117,13976.400117,1,voc,419287233,419292003,4770,spec2/voc/Bl122_419287233.jpg,Bl122,1
8018.560748,8018.562748,1,voc,240556822,240556882,60,spec2/voc/Bl122_240556822.jpg,Bl122,1
11208.663894,11208.677894,1,voc,336259916,336260336,420,spec2/voc/Bl122_336259916.jpg,Bl122,1
6060.169705,6060.203705,1,voc,181805091,181806111,1020,spec2/voc/Bl122_181805091.jpg,Bl122,1
9057.623241,9057.640241,1,voc,271728697,271729207,510,spec2/voc/Bl122_271728697.jpg,Bl122,1
3798.308649,3798.323649,1,voc,113949259,113949709,450,spec2/voc/Bl122_113949259.jpg,Bl122,1
6176.188327,6176.293327,1,voc,185285649,185288799,3150,spec2/voc/Bl122_185285649.jpg,Bl122,1
5995.081256,5995.196256,1,voc,179852437,179855887,3450,spec2/voc/Bl122_179852437.jpg,Bl122,1
8911.921773,8912.090773,1,voc,267357653,267362723,5070,spec2/voc/Bl122_267357653.jpg,Bl122,1
3806.646649,3806.694649,1,voc,114199399,114200839,1440,spec2/voc/Bl122_114199399.jpg,Bl122,1
8001.938748,8001.944748,1,voc,240058162,240058342,180,spec2/voc/Bl122_240058162.jpg,Bl122,1
10957.302807,10957.313807,1,voc,328719084,328719414,330,spec2/voc/Bl122_328719084.jpg,Bl122,1
14800.034551,14800.068551,1,voc,444001036,444002056,1020,spec2/voc/Bl122_444001036.jpg,Bl122,1
6027.829533,6028.020533,1,voc,180834885,180840615,5730,spec2/voc/Bl122_180834885.jpg,Bl122,1
5976.652256,5976.738256,1,voc,179299567,179302147,2580,spec2/voc/Bl122_179299567.jpg,Bl122,1
8213.492724,8213.805724,1,voc,246404781,246414171,9390,spec2/voc/Bl122_246404781.jpg,Bl122,1
6033.842533,6033.854533,1,voc,181015275,181015635,360,spec2/voc/Bl122_181015275.jpg,Bl122,1
7871.446748,7871.455748,1,voc,236143402,236143672,270,spec2/voc/Bl122_236143402.jpg,Bl122,1
14805.099551,14805.112551,1,voc,444152986,444153376,390,spec2/voc/Bl122_444152986.jpg,Bl122,1
14838.292682,14838.329682,1,voc,445148780,445149890,1110,spec2/voc/Bl122_445148780.jpg,Bl122,1
11032.355132,11032.661132,1,voc,330970653,330979833,9180,spec2/voc/Bl122_330970653.jpg,Bl122,1
11194.83418,11194.87518,1,voc,335845025,335846255,1230,spec2/voc/Bl122_335845025.jpg,Bl122,1
3826.681649,3826.686649,1,voc,114800449,114800599,150,spec2/voc/Bl122_114800449.jpg,Bl122,1
14812.998551,14813.205551,1,voc,444389956,444396166,6210,spec2/voc/Bl122_444389956.jpg,Bl122,1
6182.653327,6182.696327,1,voc,185479599,185480889,1290,spec2/voc/Bl122_185479599.jpg,Bl122,1
5944.142256,5944.148256,1,voc,178324267,178324447,180,spec2/voc/Bl122_178324267.jpg,Bl122,1
7983.601748,7983.640748,1,voc,239508052,239509222,1170,spec2/voc/Bl122_239508052.jpg,Bl122,1
9088.220241,9088.225241,1,voc,272646607,272646757,150,spec2/voc/Bl122_272646607.jpg,Bl122,1
7823.860748,7823.880748,1,voc,234715822,234716422,600,spec2/voc/Bl122_234715822.jpg,Bl122,1
9051.570241,9051.577241,1,voc,271547107,271547317,210,spec2/voc/Bl122_271547107.jpg,Bl122,1
3840.746415,3840.838415,1,voc,115222392,115225152,2760,spec2/voc/Bl122_115222392.jpg,Bl122,1
10939.749807,10939.766807,1,voc,328192494,328193004,510,spec2/voc/Bl122_328192494.jpg,Bl122,1
10925.615807,10925.617807,1,voc,327768474,327768534,60,spec2/voc/Bl122_327768474.jpg,Bl122,1
6094.13415,6094.27215,1,voc,182824024,182828164,4140,spec2/voc/Bl122_182824024.jpg,Bl122,1
11193.75118,11193.78318,1,voc,335812535,335813495,960,spec2/voc/Bl122_335812535.jpg,Bl122,1
6060.664705,6060.680705,1,voc,181819941,181820421,480,spec2/voc/Bl122_181819941.jpg,Bl122,1
7977.849748,7977.853748,1,voc,239335492,239335612,120,spec2/voc/Bl122_239335492.jpg,Bl122,1
7823.767748,7823.784748,1,voc,234713032,234713542,510,spec2/voc/Bl122_234713032.jpg,Bl122,1
7920.194748,7920.208748,1,voc,237605842,237606262,420,spec2/voc/Bl122_237605842.jpg,Bl122,1
8927.919773,8927.961773,1,voc,267837593,267838853,1260,spec2/voc/Bl122_267837593.jpg,Bl122,1
7952.943748,7952.955748,1,voc,238588312,238588672,360,spec2/voc/Bl122_238588312.jpg,Bl122,1
6135.533293,6135.626293,1,voc,184065998,184068788,2790,spec2/voc/Bl122_184065998.jpg,Bl122,1
8036.796748,8036.800748,1,voc,241103902,241104022,120,spec2/voc/Bl122_241103902.jpg,Bl122,1
14781.880844,14782.029844,1,voc,443456425,443460895,4470,spec2/voc/Bl122_443456425.jpg,Bl122,1
14149.323855,14149.327855,1,voc,424479715,424479835,120,spec2/voc/Bl122_424479715.jpg,Bl122,1
14818.421551,14818.444551,1,voc,444552646,444553336,690,spec2/voc/Bl122_444552646.jpg,Bl122,1
7794.084748,7794.087748,1,voc,233822542,233822632,90,spec2/voc/Bl122_233822542.jpg,Bl122,1
13965.885352,13965.925352,1,voc,418976560,418977760,1200,spec2/voc/Bl122_418976560.jpg,Bl122,1
13214.801389,13214.808389,1,voc,396444041,396444251,210,spec2/voc/Bl122_396444041.jpg,Bl122,1
9050.913241,9051.071241,1,voc,271527397,271532137,4740,spec2/voc/Bl122_271527397.jpg,Bl122,1
9081.734241,9081.752241,1,voc,272452027,272452567,540,spec2/voc/Bl122_272452027.jpg,Bl122,1
5961.369256,5961.445256,1,voc,178841077,178843357,2280,spec2/voc/Bl122_178841077.jpg,Bl122,1
5842.641221,5842.701221,1,voc,175279236,175281036,1800,spec2/voc/Bl122_175279236.jpg,Bl122,1
3809.561649,3809.629649,1,voc,114286849,114288889,2040,spec2/voc/Bl122_114286849.jpg,Bl122,1
9096.237241,9096.246241,1,voc,272887117,272887387,270,spec2/voc/Bl122_272887117.jpg,Bl122,1
11139.608955,11139.762955,1,voc,334188268,334192888,4620,spec2/voc/Bl122_334188268.jpg,Bl122,1
6190.756327,6190.993327,1,voc,185722689,185729799,7110,spec2/voc/Bl122_185722689.jpg,Bl122,1
13244.379606,13244.411606,1,voc,397331388,397332348,960,spec2/voc/Bl122_397331388.jpg,Bl122,1
9096.166241,9096.168241,1,voc,272884987,272885047,60,spec2/voc/Bl122_272884987.jpg,Bl122,1
5937.383256,5937.413256,1,voc,178121497,178122397,900,spec2/voc/Bl122_178121497.jpg,Bl122,1
9167.822604,9167.828604,1,voc,275034678,275034858,180,spec2/voc/Bl122_275034678.jpg,Bl122,1
7934.004748,7934.027748,1,voc,238020142,238020832,690,spec2/voc/Bl122_238020142.jpg,Bl122,1
9060.517241,9060.520241,1,voc,271815517,271815607,90,spec2/voc/Bl122_271815517.jpg,Bl122,1
3827.623649,3827.627649,1,voc,114828709,114828829,120,spec2/voc/Bl122_114828709.jpg,Bl122,1
12003.162987,12003.213987,1,voc,360094889,360096419,1530,spec2/voc/Bl122_360094889.jpg,Bl122,1
8921.682773,8921.715773,1,voc,267650483,267651473,990,spec2/voc/Bl122_267650483.jpg,Bl122,1
5975.131256,5975.138256,1,voc,179253937,179254147,210,spec2/voc/Bl122_179253937.jpg,Bl122,1
9038.645241,9038.653241,1,voc,271159357,271159597,240,spec2/voc/Bl122_271159357.jpg,Bl122,1
8983.715025,8983.717025,1,voc,269511450,269511510,60,spec2/voc/Bl122_269511450.jpg,Bl122,1
6056.319705,6056.369705,1,voc,181689591,181691091,1500,spec2/voc/Bl122_181689591.jpg,Bl122,1
5956.469256,5956.473256,1,voc,178694077,178694197,120,spec2/voc/Bl122_178694077.jpg,Bl122,1
3826.314649,3826.322649,1,voc,114789439,114789679,240,spec2/voc/Bl122_114789439.jpg,Bl122,1
3813.315649,3813.383649,1,voc,114399469,114401509,2040,spec2/voc/Bl122_114399469.jpg,Bl122,1
6107.881706,6107.906706,1,voc,183236451,183237201,750,spec2/voc/Bl122_183236451.jpg,Bl122,1
5961.058256,5961.064256,1,voc,178831747,178831927,180,spec2/voc/Bl122_178831747.jpg,Bl122,1
6057.909705,6057.914705,1,voc,181737291,181737441,150,spec2/voc/Bl122_181737291.jpg,Bl122,1
14142.043259,14142.049259,1,voc,424261297,424261477,180,spec2/voc/Bl122_424261297.jpg,Bl122,1
13819.328617,13819.338617,1,voc,414579858,414580158,300,spec2/voc/Bl122_414579858.jpg,Bl122,1
7833.567748,7833.601748,1,voc,235007032,235008052,1020,spec2/voc/Bl122_235007032.jpg,Bl122,1
14155.099825,14155.105825,1,voc,424652994,424653174,180,spec2/voc/Bl122_424652994.jpg,Bl122,1
6045.1712,6045.4682,1,voc,181355136,181364046,8910,spec2/voc/Bl122_181355136.jpg,Bl122,1
11163.32718,11163.41918,1,voc,334899815,334902575,2760,spec2/voc/Bl122_334899815.jpg,Bl122,1
8022.635748,8022.660748,1,voc,240679072,240679822,750,spec2/voc/Bl122_240679072.jpg,Bl122,1
11141.478955,11141.534955,1,voc,334244368,334246048,1680,spec2/voc/Bl122_334244368.jpg,Bl122,1
13959.375384,13959.379384,1,voc,418781261,418781381,120,spec2/voc/Bl122_418781261.jpg,Bl122,1
6000.668256,6000.832256,1,voc,180020047,180024967,4920,spec2/voc/Bl122_180020047.jpg,Bl122,1
5988.560256,5988.665256,1,voc,179656807,179659957,3150,spec2/voc/Bl122_179656807.jpg,Bl122,1
6124.693706,6124.714706,1,voc,183740811,183741441,630,spec2/voc/Bl122_183740811.jpg,Bl122,1
7961.698748,7961.708748,1,voc,238850962,238851262,300,spec2/voc/Bl122_238850962.jpg,Bl122,1
5981.993256,5981.996256,1,voc,179459797,179459887,90,spec2/voc/Bl122_179459797.jpg,Bl122,1
7966.293748,7966.326748,1,voc,238988812,238989802,990,spec2/voc/Bl122_238988812.jpg,Bl122,1
7919.674748,7919.729748,1,voc,237590242,237591892,1650,spec2/voc/Bl122_237590242.jpg,Bl122,1
6057.386705,6057.389705,1,voc,181721601,181721691,90,spec2/voc/Bl122_181721601.jpg,Bl122,1
6093.01815,6093.02015,1,voc,182790544,182790604,60,spec2/voc/Bl122_182790544.jpg,Bl122,1
14635.767984,14635.929984,1,voc,439073039,439077899,4860,spec2/voc/Bl122_439073039.jpg,Bl122,1
13774.824473,13774.830473,1,voc,413244734,413244914,180,spec2/voc/Bl122_413244734.jpg,Bl122,1
10906.770825,10906.777825,1,voc,327203124,327203334,210,spec2/voc/Bl122_327203124.jpg,Bl122,1
5990.636256,5990.645256,1,voc,179719087,179719357,270,spec2/voc/Bl122_179719087.jpg,Bl122,1
6040.154065,6040.204065,1,voc,181204621,181206121,1500,spec2/voc/Bl122_181204621.jpg,Bl122,1
6031.885533,6031.892533,1,voc,180956565,180956775,210,spec2/voc/Bl122_180956565.jpg,Bl122,1
3838.888415,3838.899415,1,voc,115166652,115166982,330,spec2/voc/Bl122_115166652.jpg,Bl122,1
6191.384327,6191.492327,1,voc,185741529,185744769,3240,spec2/voc/Bl122_185741529.jpg,Bl122,1
9038.255241,9038.411241,1,voc,271147657,271152337,4680,spec2/voc/Bl122_271147657.jpg,Bl122,2
8924.240773,8924.245773,1,voc,267727223,267727373,150,spec2/voc/Bl122_267727223.jpg,Bl122,2
8025.481748,8025.486748,1,voc,240764452,240764602,150,spec2/voc/Bl122_240764452.jpg,Bl122,2
10922.716807,10922.724807,1,voc,327681504,327681744,240,spec2/voc/Bl122_327681504.jpg,Bl122,2
7872.132748,7872.142748,1,voc,236163982,236164282,300,spec2/voc/Bl122_236163982.jpg,Bl122,2
3861.808367,3861.811367,1,voc,115854251,115854341,90,spec2/voc/Bl122_115854251.jpg,Bl122,2
5976.611256,5976.648256,1,voc,179298337,179299447,1110,spec2/voc/Bl122_179298337.jpg,Bl122,2
10951.086807,10951.122807,1,voc,328532604,328533684,1080,spec2/voc/Bl122_328532604.jpg,Bl122,2
14840.101682,14840.157682,1,voc,445203050,445204730,1680,spec2/voc/Bl122_445203050.jpg,Bl122,2
14811.072551,14811.079551,1,voc,444332176,444332386,210,spec2/voc/Bl122_444332176.jpg,Bl122,2
8027.863748,8027.870748,1,voc,240835912,240836122,210,spec2/voc/Bl122_240835912.jpg,Bl122,2
10920.367807,10920.374807,1,voc,327611034,327611244,210,spec2/voc/Bl122_327611034.jpg,Bl122,2
9158.999796,9159.334796,1,voc,274769993,274780043,10050,spec2/voc/Bl122_274769993.jpg,Bl122,2
8999.361241,8999.378241,1,voc,269980837,269981347,510,spec2/voc/Bl122_269980837.jpg,Bl122,2
5962.812256,5963.045256,1,voc,178884367,178891357,6990,spec2/voc/Bl122_178884367.jpg,Bl122,2
8207.437882,8207.439882,1,voc,246223136,246223196,60,spec2/voc/Bl122_246223136.jpg,Bl122,2
7911.251748,7911.255748,1,voc,237337552,237337672,120,spec2/voc/Bl122_237337552.jpg,Bl122,2
10965.401807,10965.495807,1,voc,328962054,328964874,2820,spec2/voc/Bl122_328962054.jpg,Bl122,2
5960.251256,5960.265256,1,voc,178807537,178807957,420,spec2/voc/Bl122_178807537.jpg,Bl122,2
13958.764384,13958.842384,1,voc,418762931,418765271,2340,spec2/voc/Bl122_418762931.jpg,Bl122,2
11205.344894,11205.418894,1,voc,336160346,336162566,2220,spec2/voc/Bl122_336160346.jpg,Bl122,2
14798.925551,14799.012551,1,voc,443967766,443970376,2610,spec2/voc/Bl122_443967766.jpg,Bl122,2
7922.982748,7922.984748,1,voc,237689482,237689542,60,spec2/voc/Bl122_237689482.jpg,Bl122,2
5982.154256,5982.208256,1,voc,179464627,179466247,1620,spec2/voc/Bl122_179464627.jpg,Bl122,2
6122.081706,6122.127706,1,voc,183662451,183663831,1380,spec2/voc/Bl122_183662451.jpg,Bl122,2
6171.727327,6171.852327,1,voc,185151819,185155569,3750,spec2/voc/Bl122_185151819.jpg,Bl122,2
13208.823389,13208.834389,1,voc,396264701,396265031,330,spec2/voc/Bl122_396264701.jpg,Bl122,2
6205.397327,6205.419327,1,voc,186161919,186162579,660,spec2/voc/Bl122_186161919.jpg,Bl122,2
14822.560551,14822.567551,1,voc,444676816,444677026,210,spec2/voc/Bl122_444676816.jpg,Bl122,2
3865.344367,3865.397367,1,voc,115960331,115961921,1590,spec2/voc/Bl122_115960331.jpg,Bl122,2
13569.113052,13569.161052,1,voc,407073391,407074831,1440,spec2/voc/Bl122_407073391.jpg,Bl122,2
5941.532256,5941.540256,1,voc,178245967,178246207,240,spec2/voc/Bl122_178245967.jpg,Bl122,2
10914.417807,10914.438807,1,voc,327432534,327433164,630,spec2/voc/Bl122_327432534.jpg,Bl122,2
11156.14918,11156.17418,1,voc,334684475,334685225,750,spec2/voc/Bl122_334684475.jpg,Bl122,2
7962.002748,7962.012748,1,voc,238860082,238860382,300,spec2/voc/Bl122_238860082.jpg,Bl122,2
3849.574415,3849.737415,1,voc,115487232,115492122,4890,spec2/voc/Bl122_115487232.jpg,Bl122,2
6229.344295,6229.395295,1,voc,186880328,186881858,1530,spec2/voc/Bl122_186880328.jpg,Bl122,2
3842.345415,3842.356415,1,voc,115270362,115270692,330,spec2/voc/Bl122_115270362.jpg,Bl122,2
6074.324705,6074.329705,1,voc,182229741,182229891,150,spec2/voc/Bl122_182229741.jpg,Bl122,2
8037.781748,8037.783748,1,voc,241133452,241133512,60,spec2/voc/Bl122_241133452.jpg,Bl122,2
7782.418748,7782.424748,1,voc,233472562,233472742,180,spec2/voc/Bl122_233472562.jpg,Bl122,2
10962.573807,10962.660807,1,voc,328877214,328879824,2610,spec2/voc/Bl122_328877214.jpg,Bl122,2
13170.403701,13170.586701,1,voc,395112111,395117601,5490,spec2/voc/Bl122_395112111.jpg,Bl122,2
14155.364825,14155.480825,1,voc,424660944,424664424,3480,spec2/voc/Bl122_424660944.jpg,Bl122,2
11159.01918,11159.03718,1,voc,334770575,334771115,540,spec2/voc/Bl122_334770575.jpg,Bl122,2
10915.678807,10915.688807,1,voc,327470364,327470664,300,spec2/voc/Bl122_327470364.jpg,Bl122,2
11157.06518,11157.07018,1,voc,334711955,334712105,150,spec2/voc/Bl122_334711955.jpg,Bl122,2
6047.7332,6047.7392,1,voc,181431996,181432176,180,spec2/voc/Bl122_181431996.jpg,Bl122,2
10936.075807,10936.243807,1,voc,328082274,328087314,5040,spec2/voc/Bl122_328082274.jpg,Bl122,2
14842.204682,14842.212682,1,voc,445266140,445266380,240,spec2/voc/Bl122_445266140.jpg,Bl122,2
7976.055748,7976.060748,1,voc,239281672,239281822,150,spec2/voc/Bl122_239281672.jpg,Bl122,2
13205.191389,13205.195389,1,voc,396155741,396155861,120,spec2/voc/Bl122_396155741.jpg,Bl122,2
9000.509241,9000.647241,1,voc,270015277,270019417,4140,spec2/voc/Bl122_270015277.jpg,Bl122,2
8919.569773,8919.598773,1,voc,267587093,267587963,870,spec2/voc/Bl122_267587093.jpg,Bl122,2
6073.936705,6074.078705,1,voc,182218101,182222361,4260,spec2/voc/Bl122_182218101.jpg,Bl122,2
8031.482748,8031.489748,1,voc,240944482,240944692,210,spec2/voc/Bl122_240944482.jpg,Bl122,2
7983.211748,7983.222748,1,voc,239496352,239496682,330,spec2/voc/Bl122_239496352.jpg,Bl122,2
13214.771389,13214.799389,1,voc,396443141,396443981,840,spec2/voc/Bl122_396443141.jpg,Bl122,2
13207.154389,13207.164389,1,voc,396214631,396214931,300,spec2/voc/Bl122_396214631.jpg,Bl122,2
13999.129512,13999.195512,1,voc,419973885,419975865,1980,spec2/voc/Bl122_419973885.jpg,Bl122,2
14825.439551,14825.460551,1,voc,444763186,444763816,630,spec2/voc/Bl122_444763186.jpg,Bl122,2
13213.398389,13213.405389,1,voc,396401951,396402161,210,spec2/voc/Bl122_396401951.jpg,Bl122,2
11165.99418,11166.06418,1,voc,334979825,334981925,2100,spec2/voc/Bl122_334979825.jpg,Bl122,2
9063.762241,9063.767241,1,voc,271912867,271913017,150,spec2/voc/Bl122_271912867.jpg,Bl122,2
3897.770652,3897.822652,1,voc,116933119,116934679,1560,spec2/voc/Bl122_116933119.jpg,Bl122,2
8018.918748,8018.921748,1,voc,240567562,240567652,90,spec2/voc/Bl122_240567562.jpg,Bl122,2
5973.987256,5974.013256,1,voc,179219617,179220397,780,spec2/voc/Bl122_179219617.jpg,Bl122,2
6023.362533,6023.367533,1,voc,180700875,180701025,150,spec2/voc/Bl122_180700875.jpg,Bl122,2
8367.459166,8367.461166,1,voc,251023774,251023834,60,spec2/voc/Bl122_251023774.jpg,Bl122,2
6012.861533,6012.868533,1,voc,180385845,180386055,210,spec2/voc/Bl122_180385845.jpg,Bl122,2
5978.256256,5978.269256,1,voc,179347687,179348077,390,spec2/voc/Bl122_179347687.jpg,Bl122,2
11180.83418,11180.87218,1,voc,335425025,335426165,1140,spec2/voc/Bl122_335425025.jpg,Bl122,2
13733.498497,13733.509497,1,voc,412004954,412005284,330,spec2/voc/Bl122_412004954.jpg,Bl122,2
3894.194652,3894.225652,1,voc,116825839,116826769,930,spec2/voc/Bl122_116825839.jpg,Bl122,2
3893.999652,3894.007652,1,voc,116819989,116820229,240,spec2/voc/Bl122_116819989.jpg,Bl122,2
9150.336842,9150.371842,1,voc,274510105,274511155,1050,spec2/voc/Bl122_274510105.jpg,Bl122,2
5977.295256,5977.333256,1,voc,179318857,179319997,1140,spec2/voc/Bl122_179318857.jpg,Bl122,2
3854.208415,3854.219415,1,voc,115626252,115626582,330,spec2/voc/Bl122_115626252.jpg,Bl122,2
11207.078894,11207.409894,1,voc,336212366,336222296,9930,spec2/voc/Bl122_336212366.jpg,Bl122,2
11182.47018,11182.49718,1,voc,335474105,335474915,810,spec2/voc/Bl122_335474105.jpg,Bl122,2
11211.515894,11211.561894,1,voc,336345476,336346856,1380,spec2/voc/Bl122_336345476.jpg,Bl122,2
6070.722705,6070.727705,1,voc,182121681,182121831,150,spec2/voc/Bl122_182121681.jpg,Bl122,2
6101.920706,6101.967706,1,voc,183057621,183059031,1410,spec2/voc/Bl122_183057621.jpg,Bl122,2
11164.50818,11164.55818,1,voc,334935245,334936745,1500,spec2/voc/Bl122_334935245.jpg,Bl122,2
5977.608256,5977.636256,1,voc,179328247,179329087,840,spec2/voc/Bl122_179328247.jpg,Bl122,2
7853.641748,7853.662748,1,voc,235609252,235609882,630,spec2/voc/Bl122_235609252.jpg,Bl122,2
13976.183117,13976.212117,1,voc,419285493,419286363,870,spec2/voc/Bl122_419285493.jpg,Bl122,2
7876.298748,7876.305748,1,voc,236288962,236289172,210,spec2/voc/Bl122_236288962.jpg,Bl122,2
11100.265855,11100.268855,1,voc,333007975,333008065,90,spec2/voc/Bl122_333007975.jpg,Bl122,2
12591.570947,12591.572947,1,voc,377747128,377747188,60,spec2/voc/Bl122_377747128.jpg,Bl122,2
6196.467327,6196.594327,1,voc,185894019,185897829,3810,spec2/voc/Bl122_185894019.jpg,Bl122,2
12649.637264,12649.810264,1,voc,379489117,379494307,5190,spec2/voc/Bl122_379489117.jpg,Bl122,2
7896.864748,7896.879748,1,voc,236905942,236906392,450,spec2/voc/Bl122_236905942.jpg,Bl122,2
9058.717241,9058.739241,1,voc,271761517,271762177,660,spec2/voc/Bl122_271761517.jpg,Bl122,2
8039.459748,8039.467748,1,voc,241183792,241184032,240,spec2/voc/Bl122_241183792.jpg,Bl122,2
9030.116241,9030.126241,1,voc,270903487,270903787,300,spec2/voc/Bl122_270903487.jpg,Bl122,2
10921.665807,10921.787807,1,voc,327649974,327653634,3660,spec2/voc/Bl122_327649974.jpg,Bl122,2
10915.060807,10915.067807,1,voc,327451824,327452034,210,spec2/voc/Bl122_327451824.jpg,Bl122,2
14820.912551,14820.920551,1,voc,444627376,444627616,240,spec2/voc/Bl122_444627376.jpg,Bl122,2
12671.564513,12671.594513,1,voc,380146935,380147835,900,spec2/voc/Bl122_380146935.jpg,Bl122,2
9082.181241,9082.197241,1,voc,272465437,272465917,480,spec2/voc/Bl122_272465437.jpg,Bl122,2
11163.86918,11163.88418,1,voc,334916075,334916525,450,spec2/voc/Bl122_334916075.jpg,Bl122,2
14349.592116,14349.614116,1,voc,430487763,430488423,660,spec2/voc/Bl122_430487763.jpg,Bl122,2
8022.618748,8022.632748,1,voc,240678562,240678982,420,spec2/voc/Bl122_240678562.jpg,Bl122,2
5947.343256,5947.535256,1,voc,178420297,178426057,5760,spec2/voc/Bl122_178420297.jpg,Bl122,2
6113.279706,6113.370706,1,voc,183398391,183401121,2730,spec2/voc/Bl122_183398391.jpg,Bl122,2
11968.442795,11968.453795,1,voc,359053283,359053613,330,spec2/voc/Bl122_359053283.jpg,Bl122,2
7856.692748,7856.722748,1,voc,235700782,235701682,900,spec2/voc/Bl122_235700782.jpg,Bl122,2
13160.975891,13160.980891,1,voc,394829276,394829426,150,spec2/voc/Bl122_394829276.jpg,Bl122,2
12621.952161,12622.015161,1,voc,378658564,378660454,1890,spec2/voc/Bl122_378658564.jpg,Bl122,2
6084.87915,6085.11015,1,voc,182546374,182553304,6930,spec2/voc/Bl122_182546374.jpg,Bl122,2
11185.07718,11185.15018,1,voc,335552315,335554505,2190,spec2/voc/Bl122_335552315.jpg,Bl122,2
7813.458748,7813.463748,1,voc,234403762,234403912,150,spec2/voc/Bl122_234403762.jpg,Bl122,2
7962.082748,7962.093748,1,voc,238862482,238862812,330,spec2/voc/Bl122_238862482.jpg,Bl122,2
8914.884773,8914.909773,1,voc,267446543,267447293,750,spec2/voc/Bl122_267446543.jpg,Bl122,2
7919.328748,7919.351748,1,voc,237579862,237580552,690,spec2/voc/Bl122_237579862.jpg,Bl122,2
5934.409256,5934.415256,1,voc,178032277,178032457,180,spec2/voc/Bl122_178032277.jpg,Bl122,2
10903.970825,10904.029825,1,voc,327119124,327120894,1770,spec2/voc/Bl122_327119124.jpg,Bl122,2
5951.711256,5951.747256,1,voc,178551337,178552417,1080,spec2/voc/Bl122_178551337.jpg,Bl122,2
6096.77215,6096.77615,1,voc,182903164,182903284,120,spec2/voc/Bl122_182903164.jpg,Bl122,2
10945.719807,10945.726807,1,voc,328371594,328371804,210,spec2/voc/Bl122_328371594.jpg,Bl122,2
5937.502256,5937.529256,1,voc,178125067,178125877,810,spec2/voc/Bl122_178125067.jpg,Bl122,2
7994.434748,7994.440748,1,voc,239833042,239833222,180,spec2/voc/Bl122_239833042.jpg,Bl122,2
9034.172241,9034.183241,1,voc,271025167,271025497,330,spec2/voc/Bl122_271025167.jpg,Bl122,2
7837.732748,7837.759748,1,voc,235131982,235132792,810,spec2/voc/Bl122_235131982.jpg,Bl122,2
6014.199533,6014.204533,1,voc,180425985,180426135,150,spec2/voc/Bl122_180425985.jpg,Bl122,2
9122.426182,9122.609182,1,voc,273672785,273678275,5490,spec2/voc/Bl122_273672785.jpg,Bl122,2
10904.745825,10905.059825,1,voc,327142374,327151794,9420,spec2/voc/Bl122_327142374.jpg,Bl122,2
6039.965065,6039.970065,1,voc,181198951,181199101,150,spec2/voc/Bl122_181198951.jpg,Bl122,2
9092.853241,9093.096241,1,voc,272785597,272792887,7290,spec2/voc/Bl122_272785597.jpg,Bl122,2
9052.340241,9052.355241,1,voc,271570207,271570657,450,spec2/voc/Bl122_271570207.jpg,Bl122,2
11173.18818,11173.22918,1,voc,335195645,335196875,1230,spec2/voc/Bl122_335195645.jpg,Bl122,2
7885.104748,7885.118748,1,voc,236553142,236553562,420,spec2/voc/Bl122_236553142.jpg,Bl122,2
9147.015342,9147.178342,1,voc,274410460,274415350,4890,spec2/voc/Bl122_274410460.jpg,Bl122,2
11181.04418,11181.10218,1,voc,335431325,335433065,1740,spec2/voc/Bl122_335431325.jpg,Bl122,2
7860.946748,7860.957748,1,voc,235828402,235828732,330,spec2/voc/Bl122_235828402.jpg,Bl122,2
3334.836784,3335.057784,1,voc,100045103,100051733,6630,spec2/voc/Bl122_100045103.jpg,Bl122,2
13818.651617,13818.655617,1,voc,414559548,414559668,120,spec2/voc/Bl122_414559548.jpg,Bl122,2
10964.517807,10964.574807,1,voc,328935534,328937244,1710,spec2/voc/Bl122_328935534.jpg,Bl122,2
5980.380256,5980.402256,1,voc,179411407,179412067,660,spec2/voc/Bl122_179411407.jpg,Bl122,2
7907.436748,7907.442748,1,voc,237223102,237223282,180,spec2/voc/Bl122_237223102.jpg,Bl122,2
7887.367748,7887.383748,1,voc,236621032,236621512,480,spec2/voc/Bl122_236621032.jpg,Bl122,2
12634.404885,12634.406885,1,voc,379032146,379032206,60,spec2/voc/Bl122_379032146.jpg,Bl122,2
7976.993748,7977.009748,1,voc,239309812,239310292,480,spec2/voc/Bl122_239309812.jpg,Bl122,2
9011.556241,9011.799241,1,voc,270346687,270353977,7290,spec2/voc/Bl122_270346687.jpg,Bl122,2
11173.02018,11173.02718,1,voc,335190605,335190815,210,spec2/voc/Bl122_335190605.jpg,Bl122,2
13818.556617,13818.596617,1,voc,414556698,414557898,1200,spec2/voc/Bl122_414556698.jpg,Bl122,2
3861.356367,3861.414367,1,voc,115840691,115842431,1740,spec2/voc/Bl122_115840691.jpg,Bl122,2
13477.315365,13477.328365,1,voc,404319460,404319850,390,spec2/voc/Bl122_404319460.jpg,Bl122,2
13193.402662,13193.420662,1,voc,395802079,395802619,540,spec2/voc/Bl122_395802079.jpg,Bl122,2
6025.273533,6025.288533,1,voc,180758205,180758655,450,spec2/voc/Bl122_180758205.jpg,Bl122,2
9009.732241,9009.933241,1,voc,270291967,270297997,6030,spec2/voc/Bl122_270291967.jpg,Bl122,2
6012.783533,6012.796533,1,voc,180383505,180383895,390,spec2/voc/Bl122_180383505.jpg,Bl122,2
10925.514807,10925.521807,1,voc,327765444,327765654,210,spec2/voc/Bl122_327765444.jpg,Bl122,2
9138.852255,9139.017255,1,voc,274165567,274170517,4950,spec2/voc/Bl122_274165567.jpg,Bl122,2
5960.972256,5961.009256,1,voc,178829167,178830277,1110,spec2/voc/Bl122_178829167.jpg,Bl122,2
6026.090533,6026.128533,1,voc,180782715,180783855,1140,spec2/voc/Bl122_180782715.jpg,Bl122,2
6114.806706,6114.809706,1,voc,183444201,183444291,90,spec2/voc/Bl122_183444201.jpg,Bl122,2
6138.825293,6139.010293,1,voc,184164758,184170308,5550,spec2/voc/Bl122_184164758.jpg,Bl122,2
11166.57218,11166.57418,1,voc,334997165,334997225,60,spec2/voc/Bl122_334997165.jpg,Bl122,2
13815.271617,13815.479617,1,voc,414458148,414464388,6240,spec2/voc/Bl122_414458148.jpg,Bl122,2
9080.578241,9080.584241,1,voc,272417347,272417527,180,spec2/voc/Bl122_272417347.jpg,Bl122,2
13818.146617,13818.249617,1,voc,414544398,414547488,3090,spec2/voc/Bl122_414544398.jpg,Bl122,2
6047.4802,6047.4882,1,voc,181424406,181424646,240,spec2/voc/Bl122_181424406.jpg,Bl122,2
9095.490241,9095.494241,1,voc,272864707,272864827,120,spec2/voc/Bl122_272864707.jpg,Bl122,2
14835.569682,14835.578682,1,voc,445067090,445067360,270,spec2/voc/Bl122_445067090.jpg,Bl122,2
9072.710241,9072.714241,1,voc,272181307,272181427,120,spec2/voc/Bl122_272181307.jpg,Bl122,2
6057.065705,6057.086705,1,voc,181711971,181712601,630,spec2/voc/Bl122_181711971.jpg,Bl122,2
9085.546241,9085.548241,1,voc,272566387,272566447,60,spec2/voc/Bl122_272566387.jpg,Bl122,2
13984.217943,13984.235943,1,voc,419526538,419527078,540,spec2/voc/Bl122_419526538.jpg,Bl122,2
3845.610415,3845.647415,1,voc,115368312,115369422,1110,spec2/voc/Bl122_115368312.jpg,Bl122,2
8990.475241,8990.513241,1,voc,269714257,269715397,1140,spec2/voc/Bl122_269714257.jpg,Bl122,2
10908.000825,10908.002825,1,voc,327240024,327240084,60,spec2/voc/Bl122_327240024.jpg,Bl122,2
5974.929256,5974.941256,1,voc,179247877,179248237,360,spec2/voc/Bl122_179247877.jpg,Bl122,2
7975.428748,7975.477748,1,voc,239262862,239264332,1470,spec2/voc/Bl122_239262862.jpg,Bl122,2
3804.346649,3804.366649,1,voc,114130399,114130999,600,spec2/voc/Bl122_114130399.jpg,Bl122,2
12611.966692,12612.143692,1,voc,378359000,378364310,5310,spec2/voc/Bl122_378359000.jpg,Bl122,2
3884.702062,3884.706062,1,voc,116541061,116541181,120,spec2/voc/Bl122_116541061.jpg,Bl122,2
6160.254349,6160.261349,1,voc,184807630,184807840,210,spec2/voc/Bl122_184807630.jpg,Bl122,2
9035.768241,9036.161241,1,voc,271073047,271084837,11790,spec2/voc/Bl122_271073047.jpg,Bl122,2
6098.52815,6098.66815,1,voc,182955844,182960044,4200,spec2/voc/Bl122_182955844.jpg,Bl122,2
7789.395748,7789.400748,1,voc,233681872,233682022,150,spec2/voc/Bl122_233681872.jpg,Bl122,2
6011.435533,6011.528533,1,voc,180343065,180345855,2790,spec2/voc/Bl122_180343065.jpg,Bl122,2
11191.96718,11192.01518,1,voc,335759015,335760455,1440,spec2/voc/Bl122_335759015.jpg,Bl122,2
7992.424748,7992.457748,1,voc,239772742,239773732,990,spec2/voc/Bl122_239772742.jpg,Bl122,2
10926.071807,10926.092807,1,voc,327782154,327782784,630,spec2/voc/Bl122_327782154.jpg,Bl122,2
6181.044327,6181.144327,1,voc,185431329,185434329,3000,spec2/voc/Bl122_185431329.jpg,Bl122,2
5948.273256,5948.284256,1,voc,178448197,178448527,330,spec2/voc/Bl122_178448197.jpg,Bl122,2
6038.120533,6038.134533,1,voc,181143615,181144035,420,spec2/voc/Bl122_181143615.jpg,Bl122,2
11195.01518,11195.04018,1,voc,335850455,335851205,750,spec2/voc/Bl122_335850455.jpg,Bl122,2
7845.886748,7845.892748,1,voc,235376602,235376782,180,spec2/voc/Bl122_235376602.jpg,Bl122,2
7932.403748,7932.407748,1,voc,237972112,237972232,120,spec2/voc/Bl122_237972112.jpg,Bl122,2
6123.652706,6123.710706,1,voc,183709581,183711321,1740,spec2/voc/Bl122_183709581.jpg,Bl122,2
9149.613842,9149.902842,1,voc,274488415,274497085,8670,spec2/voc/Bl122_274488415.jpg,Bl122,2
7973.879748,7973.901748,1,voc,239216392,239217052,660,spec2/voc/Bl122_239216392.jpg,Bl122,2
10944.923807,10944.955807,1,voc,328347714,328348674,960,spec2/voc/Bl122_328347714.jpg,Bl122,2
13733.823497,13733.835497,1,voc,412014704,412015064,360,spec2/voc/Bl122_412014704.jpg,Bl122,2
9095.222241,9095.232241,1,voc,272856667,272856967,300,spec2/voc/Bl122_272856667.jpg,Bl122,2
13947.969911,13948.268911,1,voc,418439097,418448067,8970,spec2/voc/Bl122_418439097.jpg,Bl122,2
11138.158955,11138.173955,1,voc,334144768,334145218,450,spec2/voc/Bl122_334144768.jpg,Bl122,2
13988.610864,13988.617864,1,voc,419658325,419658535,210,spec2/voc/Bl122_419658325.jpg,Bl122,2
10841.899842,10841.906842,1,voc,325256995,325257205,210,spec2/voc/Bl122_325256995.jpg,Bl122,2
7817.078748,7817.086748,1,voc,234512362,234512602,240,spec2/voc/Bl122_234512362.jpg,Bl122,2
13732.064497,13732.069497,1,voc,411961934,411962084,150,spec2/voc/Bl122_411961934.jpg,Bl122,2
6022.362533,6022.378533,1,voc,180670875,180671355,480,spec2/voc/Bl122_180670875.jpg,Bl122,2
5992.183256,5992.224256,1,voc,179765497,179766727,1230,spec2/voc/Bl122_179765497.jpg,Bl122,2
9096.947241,9097.103241,1,voc,272908417,272913097,4680,spec2/voc/Bl122_272908417.jpg,Bl122,2
5958.930256,5958.933256,1,voc,178767907,178767997,90,spec2/voc/Bl122_178767907.jpg,Bl122,2
7983.486748,7983.489748,1,voc,239504602,239504692,90,spec2/voc/Bl122_239504602.jpg,Bl122,2
13974.376117,13974.443117,1,voc,419231283,419233293,2010,spec2/voc/Bl122_419231283.jpg,Bl122,2
11171.23818,11171.29318,1,voc,335137145,335138795,1650,spec2/voc/Bl122_335137145.jpg,Bl122,2
9129.248981,9129.415981,1,voc,273877469,273882479,5010,spec2/voc/Bl122_273877469.jpg,Bl122,2
6115.641706,6115.700706,1,voc,183469251,183471021,1770,spec2/voc/Bl122_183469251.jpg,Bl122,2
9075.205241,9075.209241,1,voc,272256157,272256277,120,spec2/voc/Bl122_272256157.jpg,Bl122,2
5944.282256,5944.331256,1,voc,178328467,178329937,1470,spec2/voc/Bl122_178328467.jpg,Bl122,2
7860.287748,7860.411748,1,voc,235808632,235812352,3720,spec2/voc/Bl122_235808632.jpg,Bl122,2
3819.192649,3819.234649,1,voc,114575779,114577039,1260,spec2/voc/Bl122_114575779.jpg,Bl122,2
6022.393533,6022.455533,1,voc,180671805,180673665,1860,spec2/voc/Bl122_180671805.jpg,Bl122,2
11190.09618,11190.13718,1,voc,335702885,335704115,1230,spec2/voc/Bl122_335702885.jpg,Bl122,2
6050.1712,6050.1982,1,voc,181505136,181505946,810,spec2/voc/Bl122_181505136.jpg,Bl122,2
9033.620241,9033.688241,1,voc,271008607,271010647,2040,spec2/voc/Bl122_271008607.jpg,Bl122,2
8936.645967,8936.755967,1,voc,268099379,268102679,3300,spec2/voc/Bl122_268099379.jpg,Bl122,2
3818.216649,3818.224649,1,voc,114546499,114546739,240,spec2/voc/Bl122_114546499.jpg,Bl122,2
6024.592533,6024.616533,1,voc,180737775,180738495,720,spec2/voc/Bl122_180737775.jpg,Bl122,2
6050.4572,6050.4732,1,voc,181513716,181514196,480,spec2/voc/Bl122_181513716.jpg,Bl122,2
7847.465748,7847.470748,1,voc,235423972,235424122,150,spec2/voc/Bl122_235423972.jpg,Bl122,2
9031.433241,9031.450241,1,voc,270942997,270943507,510,spec2/voc/Bl122_270942997.jpg,Bl122,2
8943.985967,8943.988967,1,voc,268319579,268319669,90,spec2/voc/Bl122_268319579.jpg,Bl122,2
3864.806367,3864.815367,1,voc,115944191,115944461,270,spec2/voc/Bl122_115944191.jpg,Bl122,2
13927.771536,13927.773536,1,voc,417833146,417833206,60,spec2/voc/Bl122_417833146.jpg,Bl122,2
6109.012706,6109.016706,1,voc,183270381,183270501,120,spec2/voc/Bl122_183270381.jpg,Bl122,2
11046.575537,11046.733537,1,voc,331397266,331402006,4740,spec2/voc/Bl122_331397266.jpg,Bl122,2
13200.248389,13200.297389,1,voc,396007451,396008921,1470,spec2/voc/Bl122_396007451.jpg,Bl122,2
7913.765748,7913.794748,1,voc,237412972,237413842,870,spec2/voc/Bl122_237412972.jpg,Bl122,2
13162.136891,13162.202891,1,voc,394864106,394866086,1980,spec2/voc/Bl122_394864106.jpg,Bl122,2
9015.474241,9015.528241,1,voc,270464227,270465847,1620,spec2/voc/Bl122_270464227.jpg,Bl122,2
10943.080807,10943.092807,1,voc,328292424,328292784,360,spec2/voc/Bl122_328292424.jpg,Bl122,2
5936.647256,5936.659256,1,voc,178099417,178099777,360,spec2/voc/Bl122_178099417.jpg,Bl122,2
7798.465748,7798.495748,1,voc,233953972,233954872,900,spec2/voc/Bl122_233953972.jpg,Bl122,2
5991.354256,5991.388256,1,voc,179740627,179741647,1020,spec2/voc/Bl122_179740627.jpg,Bl122,2
10918.538807,10919.071807,1,voc,327556164,327572154,15990,spec2/voc/Bl122_327556164.jpg,Bl122,2
11130.867005,11130.900005,1,voc,333926010,333927000,990,spec2/voc/Bl122_333926010.jpg,Bl122,2
3801.413649,3801.444649,1,voc,114042409,114043339,930,spec2/voc/Bl122_114042409.jpg,Bl122,2
6110.535706,6110.542706,1,voc,183316071,183316281,210,spec2/voc/Bl122_183316071.jpg,Bl122,2
3865.204367,3865.208367,1,voc,115956131,115956251,120,spec2/voc/Bl122_115956131.jpg,Bl122,2
3881.120062,3881.160062,1,voc,116433601,116434801,1200,spec2/voc/Bl122_116433601.jpg,Bl122,2
10935.302807,10935.328807,1,voc,328059084,328059864,780,spec2/voc/Bl122_328059084.jpg,Bl122,2
10897.184557,10897.196557,1,voc,326915536,326915896,360,spec2/voc/Bl122_326915536.jpg,Bl122,2
9049.129241,9049.302241,1,voc,271473877,271479067,5190,spec2/voc/Bl122_271473877.jpg,Bl122,2
6021.809533,6021.842533,1,voc,180654285,180655275,990,spec2/voc/Bl122_180654285.jpg,Bl122,2
7802.594748,7802.601748,1,voc,234077842,234078052,210,spec2/voc/Bl122_234077842.jpg,Bl122,2
5974.691256,5974.702256,1,voc,179240737,179241067,330,spec2/voc/Bl122_179240737.jpg,Bl122,2
5942.247256,5942.276256,1,voc,178267417,178268287,870,spec2/voc/Bl122_178267417.jpg,Bl122,2
6124.952706,6124.958706,1,voc,183748581,183748761,180,spec2/voc/Bl122_183748581.jpg,Bl122,2
13195.233662,13195.256662,1,voc,395857009,395857699,690,spec2/voc/Bl122_395857009.jpg,Bl122,2
14822.961551,14823.232551,1,voc,444688846,444696976,8130,spec2/voc/Bl122_444688846.jpg,Bl122,2
9099.237241,9099.243241,1,voc,272977117,272977297,180,spec2/voc/Bl122_272977117.jpg,Bl122,2
8939.566967,8939.644967,1,voc,268187009,268189349,2340,spec2/voc/Bl122_268187009.jpg,Bl122,2
13193.588662,13193.672662,1,voc,395807659,395810179,2520,spec2/voc/Bl122_395807659.jpg,Bl122,2
7992.412748,7992.421748,1,voc,239772382,239772652,270,spec2/voc/Bl122_239772382.jpg,Bl122,2
10855.619233,10855.804233,1,voc,325668576,325674126,5550,spec2/voc/Bl122_325668576.jpg,Bl122,2
6096.04115,6096.14115,1,voc,182881234,182884234,3000,spec2/voc/Bl122_182881234.jpg,Bl122,2
9090.375241,9090.379241,1,voc,272711257,272711377,120,spec2/voc/Bl122_272711257.jpg,Bl122,2
13170.983701,13171.033701,1,voc,395129511,395131011,1500,spec2/voc/Bl122_395129511.jpg,Bl122,2
9036.414241,9036.420241,1,voc,271092427,271092607,180,spec2/voc/Bl122_271092427.jpg,Bl122,2
3806.702649,3806.744649,1,voc,114201079,114202339,1260,spec2/voc/Bl122_114201079.jpg,Bl122,2
8008.615748,8008.624748,1,voc,240258472,240258742,270,spec2/voc/Bl122_240258472.jpg,Bl122,2
6132.045293,6132.086293,1,voc,183961358,183962588,1230,spec2/voc/Bl122_183961358.jpg,Bl122,2
13173.238701,13173.243701,1,voc,395197161,395197311,150,spec2/voc/Bl122_395197161.jpg,Bl122,2
9138.415255,9138.538255,1,voc,274152457,274156147,3690,spec2/voc/Bl122_274152457.jpg,Bl122,2
8967.734712,8967.916712,1,voc,269032041,269037501,5460,spec2/voc/Bl122_269032041.jpg,Bl122,2
6175.228327,6175.325327,1,voc,185256849,185259759,2910,spec2/voc/Bl122_185256849.jpg,Bl122,2
3890.356652,3890.362652,1,voc,116710699,116710879,180,spec2/voc/Bl122_116710699.jpg,Bl122,2
8990.112241,8990.249241,1,voc,269703367,269707477,4110,spec2/voc/Bl122_269703367.jpg,Bl122,2
11863.412519,11863.521519,1,voc,355902375,355905645,3270,spec2/voc/Bl122_355902375.jpg,Bl122,2
14826.070551,14826.074551,1,voc,444782116,444782236,120,spec2/voc/Bl122_444782116.jpg,Bl122,2
9169.659604,9169.662604,1,voc,275089788,275089878,90,spec2/voc/Bl122_275089788.jpg,Bl122,2
14154.522825,14154.684825,1,voc,424635684,424640544,4860,spec2/voc/Bl122_424635684.jpg,Bl122,2
12640.745849,12640.750849,1,voc,379222375,379222525,150,spec2/voc/Bl122_379222375.jpg,Bl122,2
11131.567005,11131.605005,1,voc,333947010,333948150,1140,spec2/voc/Bl122_333947010.jpg,Bl122,2
13177.295701,13177.324701,1,voc,395318871,395319741,870,spec2/voc/Bl122_395318871.jpg,Bl122,2
6158.116349,6158.141349,1,voc,184743490,184744240,750,spec2/voc/Bl122_184743490.jpg,Bl122,2
14824.519551,14824.530551,1,voc,444735586,444735916,330,spec2/voc/Bl122_444735586.jpg,Bl122,2
7917.761748,7917.765748,1,voc,237532852,237532972,120,spec2/voc/Bl122_237532852.jpg,Bl122,2
6115.383706,6115.392706,1,voc,183461511,183461781,270,spec2/voc/Bl122_183461511.jpg,Bl122,2
6029.785533,6029.864533,1,voc,180893565,180895935,2370,spec2/voc/Bl122_180893565.jpg,Bl122,2
13177.144701,13177.148701,1,voc,395314341,395314461,120,spec2/voc/Bl122_395314341.jpg,Bl122,2
12606.174559,12606.339559,1,voc,378185236,378190186,4950,spec2/voc/Bl122_378185236.jpg,Bl122,2
13206.601389,13206.715389,1,voc,396198041,396201461,3420,spec2/voc/Bl122_396198041.jpg,Bl122,2
9064.647241,9064.654241,1,voc,271939417,271939627,210,spec2/voc/Bl122_271939417.jpg,Bl122,2
8940.866967,8941.095967,1,voc,268226009,268232879,6870,spec2/voc/Bl122_268226009.jpg,Bl122,2
7886.861748,7886.875748,1,voc,236605852,236606272,420,spec2/voc/Bl122_236605852.jpg,Bl122,2
6040.470065,6040.481065,1,voc,181214101,181214431,330,spec2/voc/Bl122_181214101.jpg,Bl122,2
3883.173062,3883.195062,1,voc,116495191,116495851,660,spec2/voc/Bl122_116495191.jpg,Bl122,2
6170.519327,6170.529327,1,voc,185115579,185115879,300,spec2/voc/Bl122_185115579.jpg,Bl122,2
7961.296748,7961.321748,1,voc,238838902,238839652,750,spec2/voc/Bl122_238838902.jpg,Bl122,2
8911.511773,8911.515773,1,voc,267345353,267345473,120,spec2/voc/Bl122_267345353.jpg,Bl122,2
11155.26218,11155.28218,1,voc,334657865,334658465,600,spec2/voc/Bl122_334657865.jpg,Bl122,2
9010.979241,9010.989241,1,voc,270329377,270329677,300,spec2/voc/Bl122_270329377.jpg,Bl122,2
9027.743241,9027.753241,1,voc,270832297,270832597,300,spec2/voc/Bl122_270832297.jpg,Bl122,2
10842.291842,10842.437842,1,voc,325268755,325273135,4380,spec2/voc/Bl122_325268755.jpg,Bl122,2
13220.508389,13220.614389,1,voc,396615251,396618431,3180,spec2/voc/Bl122_396615251.jpg,Bl122,2
3850.520415,3850.534415,1,voc,115515612,115516032,420,spec2/voc/Bl122_115515612.jpg,Bl122,2
5981.347256,5981.512256,1,voc,179440417,179445367,4950,spec2/voc/Bl122_179440417.jpg,Bl122,2
6022.496533,6022.500533,1,voc,180674895,180675015,120,spec2/voc/Bl122_180674895.jpg,Bl122,2
13721.650056,13721.687056,1,voc,411649501,411650611,1110,spec2/voc/Bl122_411649501.jpg,Bl122,2
6121.137706,6121.205706,1,voc,183634131,183636171,2040,spec2/voc/Bl122_183634131.jpg,Bl122,2
9083.481241,9083.584241,1,voc,272504437,272507527,3090,spec2/voc/Bl122_272504437.jpg,Bl122,2
11194.63618,11194.66818,1,voc,335839085,335840045,960,spec2/voc/Bl122_335839085.jpg,Bl122,2
14843.132682,14843.206682,1,voc,445293980,445296200,2220,spec2/voc/Bl122_445293980.jpg,Bl122,2
5951.208256,5951.221256,1,voc,178536247,178536637,390,spec2/voc/Bl122_178536247.jpg,Bl122,2
11197.40918,11197.46418,1,voc,335922275,335923925,1650,spec2/voc/Bl122_335922275.jpg,Bl122,2
6070.665705,6070.674705,1,voc,182119971,182120241,270,spec2/voc/Bl122_182119971.jpg,Bl122,2
8963.086712,8963.158712,1,voc,268892601,268894761,2160,spec2/voc/Bl122_268892601.jpg,Bl122,2
13589.390236,13589.395236,1,voc,407681707,407681857,150,spec2/voc/Bl122_407681707.jpg,Bl122,2
13920.887981,13920.897981,1,voc,417626639,417626939,300,spec2/voc/Bl122_417626639.jpg,Bl122,2
6131.949293,6131.995293,1,voc,183958478,183959858,1380,spec2/voc/Bl122_183958478.jpg,Bl122,2
13745.373896,13745.552896,1,voc,412361216,412366586,5370,spec2/voc/Bl122_412361216.jpg,Bl122,2
7983.385748,7983.394748,1,voc,239501572,239501842,270,spec2/voc/Bl122_239501572.jpg,Bl122,2
14825.901551,14825.904551,1,voc,444777046,444777136,90,spec2/voc/Bl122_444777046.jpg,Bl122,2
10918.432807,10918.441807,1,voc,327552984,327553254,270,spec2/voc/Bl122_327552984.jpg,Bl122,2
9114.778184,9114.796184,1,voc,273443345,273443885,540,spec2/voc/Bl122_273443345.jpg,Bl122,2
8014.736748,8014.833748,1,voc,240442102,240445012,2910,spec2/voc/Bl122_240442102.jpg,Bl122,2
10926.054807,10926.058807,1,voc,327781644,327781764,120,spec2/voc/Bl122_327781644.jpg,Bl122,2
11210.172894,11210.196894,1,voc,336305186,336305906,720,spec2/voc/Bl122_336305186.jpg,Bl122,2
3824.583649,3824.595649,1,voc,114737509,114737869,360,spec2/voc/Bl122_114737509.jpg,Bl122,2
8951.876967,8952.045967,1,voc,268556309,268561379,5070,spec2/voc/Bl122_268556309.jpg,Bl122,2
14796.585551,14796.590551,1,voc,443897566,443897716,150,spec2/voc/Bl122_443897566.jpg,Bl122,2
7775.594748,7775.619748,1,voc,233267842,233268592,750,spec2/voc/Bl122_233267842.jpg,Bl122,2
13173.288701,13173.291701,1,voc,395198661,395198751,90,spec2/voc/Bl122_395198661.jpg,Bl122,2
13200.831389,13200.837389,1,voc,396024941,396025121,180,spec2/voc/Bl122_396024941.jpg,Bl122,2
14710.520469,14710.611469,1,voc,441315614,441318344,2730,spec2/voc/Bl122_441315614.jpg,Bl122,2
12678.60917,12678.71217,1,voc,380358275,380361365,3090,spec2/voc/Bl122_380358275.jpg,Bl122,2
13823.57622,13823.62422,1,voc,414707286,414708726,1440,spec2/voc/Bl122_414707286.jpg,Bl122,2
13815.683617,13815.700617,1,voc,414470508,414471018,510,spec2/voc/Bl122_414470508.jpg,Bl122,2
6060.036705,6060.042705,1,voc,181801101,181801281,180,spec2/voc/Bl122_181801101.jpg,Bl122,2
6134.232293,6134.271293,1,voc,184026968,184028138,1170,spec2/voc/Bl122_184026968.jpg,Bl122,2
3803.932649,3803.935649,1,voc,114117979,114118069,90,spec2/voc/Bl122_114117979.jpg,Bl122,2
9070.527241,9070.539241,1,voc,272115817,272116177,360,spec2/voc/Bl122_272115817.jpg,Bl122,2
14818.366551,14818.390551,1,voc,444550996,444551716,720,spec2/voc/Bl122_444550996.jpg,Bl122,2
3889.655652,3889.673652,1,voc,116689669,116690209,540,spec2/voc/Bl122_116689669.jpg,Bl122,2
8938.217967,8938.232967,1,voc,268146539,268146989,450,spec2/voc/Bl122_268146539.jpg,Bl122,2
9069.205241,9069.216241,1,voc,272076157,272076487,330,spec2/voc/Bl122_272076157.jpg,Bl122,2
13659.939334,13659.960334,1,voc,409798180,409798810,630,spec2/voc/Bl122_409798180.jpg,Bl122,2
6151.311349,6151.382349,1,voc,184539340,184541470,2130,spec2/voc/Bl122_184539340.jpg,Bl122,2
10959.212807,10959.255807,1,voc,328776384,328777674,1290,spec2/voc/Bl122_328776384.jpg,Bl122,2
8212.875724,8212.948724,1,voc,246386271,246388461,2190,spec2/voc/Bl122_246386271.jpg,Bl122,2
11194.29718,11194.30018,1,voc,335828915,335829005,90,spec2/voc/Bl122_335828915.jpg,Bl122,2
8035.833748,8035.837748,1,voc,241075012,241075132,120,spec2/voc/Bl122_241075012.jpg,Bl122,2
6089.66415,6089.73515,1,voc,182689924,182692054,2130,spec2/voc/Bl122_182689924.jpg,Bl122,2
6208.678327,6208.718327,1,voc,186260349,186261549,1200,spec2/voc/Bl122_186260349.jpg,Bl122,2
13156.762066,13157.017066,1,voc,394702861,394710511,7650,spec2/voc/Bl122_394702861.jpg,Bl122,2
3795.957649,3795.961649,1,voc,113878729,113878849,120,spec2/voc/Bl122_113878729.jpg,Bl122,2
6118.358706,6118.362706,1,voc,183550761,183550881,120,spec2/voc/Bl122_183550761.jpg,Bl122,2
7921.268748,7921.292748,1,voc,237638062,237638782,720,spec2/voc/Bl122_237638062.jpg,Bl122,2
9046.721241,9046.798241,1,voc,271401637,271403947,2310,spec2/voc/Bl122_271401637.jpg,Bl122,2
7886.566748,7886.602748,1,voc,236597002,236598082,1080,spec2/voc/Bl122_236597002.jpg,Bl122,2
13583.785236,13583.793236,1,voc,407513557,407513797,240,spec2/voc/Bl122_407513557.jpg,Bl122,2
3815.721649,3815.792649,1,voc,114471649,114473779,2130,spec2/voc/Bl122_114471649.jpg,Bl122,2
6014.978533,6014.981533,1,voc,180449355,180449445,90,spec2/voc/Bl122_180449355.jpg,Bl122,2
5979.034256,5979.046256,1,voc,179371027,179371387,360,spec2/voc/Bl122_179371027.jpg,Bl122,2
13173.077701,13173.095701,1,voc,395192331,395192871,540,spec2/voc/Bl122_395192331.jpg,Bl122,2
6185.942327,6186.055327,1,voc,185578269,185581659,3390,spec2/voc/Bl122_185578269.jpg,Bl122,2
11040.728892,11040.776892,1,voc,331221866,331223306,1440,spec2/voc/Bl122_331221866.jpg,Bl122,2
12939.249352,12939.258352,1,voc,388177480,388177750,270,spec2/voc/Bl122_388177480.jpg,Bl122,2
11160.92118,11160.95218,1,voc,334827635,334828565,930,spec2/voc/Bl122_334827635.jpg,Bl122,2
3816.284649,3816.295649,1,voc,114488539,114488869,330,spec2/voc/Bl122_114488539.jpg,Bl122,2
8036.122748,8036.130748,1,voc,241083682,241083922,240,spec2/voc/Bl122_241083682.jpg,Bl122,2
7853.279748,7853.281748,1,voc,235598392,235598452,60,spec2/voc/Bl122_235598392.jpg,Bl122,2
5992.870256,5992.872256,1,voc,179786107,179786167,60,spec2/voc/Bl122_179786107.jpg,Bl122,2
6071.664705,6071.677705,1,voc,182149941,182150331,390,spec2/voc/Bl122_182149941.jpg,Bl122,2
9065.630241,9065.839241,1,voc,271968907,271975177,6270,spec2/voc/Bl122_271968907.jpg,Bl122,2
14839.402682,14839.536682,1,voc,445182080,445186100,4020,spec2/voc/Bl122_445182080.jpg,Bl122,2
7974.882748,7974.885748,1,voc,239246482,239246572,90,spec2/voc/Bl122_239246482.jpg,Bl122,2
3815.874649,3815.901649,1,voc,114476239,114477049,810,spec2/voc/Bl122_114476239.jpg,Bl122,2
12619.71299,12619.71999,1,voc,378591389,378591599,210,spec2/voc/Bl122_378591389.jpg,Bl122,2
10863.505845,10863.578845,1,voc,325905175,325907365,2190,spec2/voc/Bl122_325905175.jpg,Bl122,2
13825.34222,13825.47722,1,voc,414760266,414764316,4050,spec2/voc/Bl122_414760266.jpg,Bl122,2
10913.061807,10913.065807,1,voc,327391854,327391974,120,spec2/voc/Bl122_327391854.jpg,Bl122,2
5940.063256,5940.365256,1,voc,178201897,178210957,9060,spec2/voc/Bl122_178201897.jpg,Bl122,2
14709.902469,14710.357469,1,voc,441297074,441310724,13650,spec2/voc/Bl122_441297074.jpg,Bl122,2
5984.617256,5984.793256,1,voc,179538517,179543797,5280,spec2/voc/Bl122_179538517.jpg,Bl122,2
5962.294256,5962.302256,1,voc,178868827,178869067,240,spec2/voc/Bl122_178868827.jpg,Bl122,2
6077.631705,6077.633705,1,voc,182328951,182329011,60,spec2/voc/Bl122_182328951.jpg,Bl122,2
14817.237551,14817.240551,1,voc,444517126,444517216,90,spec2/voc/Bl122_444517126.jpg,Bl122,2
8927.869773,8927.908773,1,voc,267836093,267837263,1170,spec2/voc/Bl122_267836093.jpg,Bl122,2
9035.593241,9035.632241,1,voc,271067797,271068967,1170,spec2/voc/Bl122_271067797.jpg,Bl122,2
5934.726256,5934.865256,1,voc,178041787,178045957,4170,spec2/voc/Bl122_178041787.jpg,Bl122,2
9058.709241,9058.713241,1,voc,271761277,271761397,120,spec2/voc/Bl122_271761277.jpg,Bl122,2
8919.650773,8919.657773,1,voc,267589523,267589733,210,spec2/voc/Bl122_267589523.jpg,Bl122,2
3808.431649,3808.437649,1,voc,114252949,114253129,180,spec2/voc/Bl122_114252949.jpg,Bl122,2
3841.667415,3841.724415,1,voc,115250022,115251732,1710,spec2/voc/Bl122_115250022.jpg,Bl122,2
10899.49756,10899.58656,1,voc,326984926,326987596,2670,spec2/voc/Bl122_326984926.jpg,Bl122,2
7961.393748,7961.401748,1,voc,238841812,238842052,240,spec2/voc/Bl122_238841812.jpg,Bl122,2
14817.029551,14817.043551,1,voc,444510886,444511306,420,spec2/voc/Bl122_444510886.jpg,Bl122,2
7990.807748,7990.814748,1,voc,239724232,239724442,210,spec2/voc/Bl122_239724232.jpg,Bl122,2
9089.252241,9089.255241,1,voc,272677567,272677657,90,spec2/voc/Bl122_272677567.jpg,Bl122,2
9004.572241,9004.576241,1,voc,270137167,270137287,120,spec2/voc/Bl122_270137167.jpg,Bl122,2
11185.35218,11185.36118,1,voc,335560565,335560835,270,spec2/voc/Bl122_335560565.jpg,Bl122,2
3811.934649,3812.206649,1,voc,114358039,114366199,8160,spec2/voc/Bl122_114358039.jpg,Bl122,2
14812.670551,14812.786551,1,voc,444380116,444383596,3480,spec2/voc/Bl122_444380116.jpg,Bl122,2
7802.265748,7802.268748,1,voc,234067972,234068062,90,spec2/voc/Bl122_234067972.jpg,Bl122,2
6019.855533,6020.002533,1,voc,180595665,180600075,4410,spec2/voc/Bl122_180595665.jpg,Bl122,2
6008.553533,6008.562533,1,voc,180256605,180256875,270,spec2/voc/Bl122_180256605.jpg,Bl122,2
3842.471415,3842.782415,1,voc,115274142,115283472,9330,spec2/voc/Bl122_115274142.jpg,Bl122,2
12664.609938,12664.684938,1,voc,379938298,379940548,2250,spec2/voc/Bl122_379938298.jpg,Bl122,2
6024.628533,6024.687533,1,voc,180738855,180740625,1770,spec2/voc/Bl122_180738855.jpg,Bl122,2
11876.38389,11876.56589,1,voc,356291516,356296976,5460,spec2/voc/Bl122_356291516.jpg,Bl122,2
14122.83497,14123.06097,1,voc,423685049,423691829,6780,spec2/voc/Bl122_423685049.jpg,Bl122,2
6153.114349,6153.372349,1,voc,184593430,184601170,7740,spec2/voc/Bl122_184593430.jpg,Bl122,2
9057.592241,9057.616241,1,voc,271727767,271728487,720,spec2/voc/Bl122_271727767.jpg,Bl122,2
10931.766807,10931.829807,1,voc,327953004,327954894,1890,spec2/voc/Bl122_327953004.jpg,Bl122,2
5945.540256,5945.609256,1,voc,178366207,178368277,2070,spec2/voc/Bl122_178366207.jpg,Bl122,2
7866.121748,7866.127748,1,voc,235983652,235983832,180,spec2/voc/Bl122_235983652.jpg,Bl122,2
3334.828784,3334.831784,1,voc,100044863,100044953,90,spec2/voc/Bl122_100044863.jpg,Bl122,2
6065.150705,6065.180705,1,voc,181954521,181955421,900,spec2/voc/Bl122_181954521.jpg,Bl122,2
5842.496221,5842.550221,1,voc,175274886,175276506,1620,spec2/voc/Bl122_175274886.jpg,Bl122,2
6089.74115,6089.74715,1,voc,182692234,182692414,180,spec2/voc/Bl122_182692234.jpg,Bl122,2
11127.628005,11127.631005,1,voc,333828840,333828930,90,spec2/voc/Bl122_333828840.jpg,Bl122,2
9158.352796,9158.357796,1,voc,274750583,274750733,150,spec2/voc/Bl122_274750583.jpg,Bl122,2
6050.8982,6050.9012,1,voc,181526946,181527036,90,spec2/voc/Bl122_181526946.jpg,Bl122,2
13948.492911,13948.502911,1,voc,418454787,418455087,300,spec2/voc/Bl122_418454787.jpg,Bl122,2
8213.205724,8213.223724,1,voc,246396171,246396711,540,spec2/voc/Bl122_246396171.jpg,Bl122,2
13988.911864,13988.917864,1,voc,419667355,419667535,180,spec2/voc/Bl122_419667355.jpg,Bl122,2
8993.479241,8993.508241,1,voc,269804377,269805247,870,spec2/voc/Bl122_269804377.jpg,Bl122,2
5841.748221,5841.784221,1,voc,175252446,175253526,1080,spec2/voc/Bl122_175252446.jpg,Bl122,2
13774.492473,13774.494473,1,voc,413234774,413234834,60,spec2/voc/Bl122_413234774.jpg,Bl122,2
3807.221649,3807.363649,1,voc,114216649,114220909,4260,spec2/voc/Bl122_114216649.jpg,Bl122,2
6023.996533,6024.011533,1,voc,180719895,180720345,450,spec2/voc/Bl122_180719895.jpg,Bl122,2
5979.317256,5979.345256,1,voc,179379517,179380357,840,spec2/voc/Bl122_179379517.jpg,Bl122,2
6050.5092,6050.5152,1,voc,181515276,181515456,180,spec2/voc/Bl122_181515276.jpg,Bl122,2
13988.530864,13988.532864,1,voc,419655925,419655985,60,spec2/voc/Bl122_419655925.jpg,Bl122,2
9098.292241,9098.295241,1,voc,272948767,272948857,90,spec2/voc/Bl122_272948767.jpg,Bl122,2
5943.115256,5943.121256,1,voc,178293457,178293637,180,spec2/voc/Bl122_178293457.jpg,Bl122,2
14349.364116,14349.366116,1,voc,430480923,430480983,60,spec2/voc/Bl122_430480923.jpg,Bl122,2
9057.406241,9057.464241,1,voc,271722187,271723927,1740,spec2/voc/Bl122_271722187.jpg,Bl122,2
9082.846241,9083.036241,1,voc,272485387,272491087,5700,spec2/voc/Bl122_272485387.jpg,Bl122,2
12626.703577,12626.706577,1,voc,378801107,378801197,90,spec2/voc/Bl122_378801107.jpg,Bl122,2
3851.317415,3851.337415,1,voc,115539522,115540122,600,spec2/voc/Bl122_115539522.jpg,Bl122,2
6158.975349,6158.992349,1,voc,184769260,184769770,510,spec2/voc/Bl122_184769260.jpg,Bl122,2
6065.835705,6066.033705,1,voc,181975071,181981011,5940,spec2/voc/Bl122_181975071.jpg,Bl122,2
6153.628349,6153.845349,1,voc,184608850,184615360,6510,spec2/voc/Bl122_184608850.jpg,Bl122,2
14814.961551,14815.010551,1,voc,444448846,444450316,1470,spec2/voc/Bl122_444448846.jpg,Bl122,2
5948.140256,5948.233256,1,voc,178444207,178446997,2790,spec2/voc/Bl122_178444207.jpg,Bl122,2
11143.564955,11143.578955,1,voc,334306948,334307368,420,spec2/voc/Bl122_334306948.jpg,Bl122,2
8964.943712,8965.052712,1,voc,268948311,268951581,3270,spec2/voc/Bl122_268948311.jpg,Bl122,2
14174.320098,14174.509098,1,voc,425229602,425235272,5670,spec2/voc/Bl122_425229602.jpg,Bl122,2
14154.825825,14154.827825,1,voc,424644774,424644834,60,spec2/voc/Bl122_424644774.jpg,Bl122,2
6025.338533,6025.346533,1,voc,180760155,180760395,240,spec2/voc/Bl122_180760155.jpg,Bl122,2
12671.123513,12671.306513,1,voc,380133705,380139195,5490,spec2/voc/Bl122_380133705.jpg,Bl122,2
9038.448241,9038.458241,1,voc,271153447,271153747,300,spec2/voc/Bl122_271153447.jpg,Bl122,2
7891.251748,7891.263748,1,voc,236737552,236737912,360,spec2/voc/Bl122_236737552.jpg,Bl122,2
5970.732256,5970.739256,1,voc,179121967,179122177,210,spec2/voc/Bl122_179121967.jpg,Bl122,2
14796.111551,14796.169551,1,voc,443883346,443885086,1740,spec2/voc/Bl122_443883346.jpg,Bl122,2
10916.480807,10916.889807,1,voc,327494424,327506694,12270,spec2/voc/Bl122_327494424.jpg,Bl122,2
10931.837807,10931.851807,1,voc,327955134,327955554,420,spec2/voc/Bl122_327955134.jpg,Bl122,2
3896.375652,3896.405652,1,voc,116891269,116892169,900,spec2/voc/Bl122_116891269.jpg,Bl122,2
3867.415367,3867.586367,1,voc,116022461,116027591,5130,spec2/voc/Bl122_116022461.jpg,Bl122,2
3822.869649,3822.989649,1,voc,114686089,114689689,3600,spec2/voc/Bl122_114686089.jpg,Bl122,2
11203.003894,11203.025894,1,voc,336090116,336090776,660,spec2/voc/Bl122_336090116.jpg,Bl122,2
8916.068773,8916.092773,1,voc,267482063,267482783,720,spec2/voc/Bl122_267482063.jpg,Bl122,2
13178.611701,13178.665701,1,voc,395358351,395359971,1620,spec2/voc/Bl122_395358351.jpg,Bl122,2
11206.550894,11206.552894,1,voc,336196526,336196586,60,spec2/voc/Bl122_336196526.jpg,Bl122,2
13222.356389,13222.362389,1,voc,396670691,396670871,180,spec2/voc/Bl122_396670691.jpg,Bl122,2
8004.314748,8004.325748,1,voc,240129442,240129772,330,spec2/voc/Bl122_240129442.jpg,Bl122,2
5986.513256,5986.522256,1,voc,179595397,179595667,270,spec2/voc/Bl122_179595397.jpg,Bl122,2
3877.301848,3877.459848,1,voc,116319055,116323795,4740,spec2/voc/Bl122_116319055.jpg,Bl122,2
10854.526233,10854.581233,1,voc,325635786,325637436,1650,spec2/voc/Bl122_325635786.jpg,Bl122,2
7882.812748,7882.857748,1,voc,236484382,236485732,1350,spec2/voc/Bl122_236484382.jpg,Bl122,2
7885.704748,7885.724748,1,voc,236571142,236571742,600,spec2/voc/Bl122_236571142.jpg,Bl122,2
9038.870241,9038.957241,1,voc,271166107,271168717,2610,spec2/voc/Bl122_271166107.jpg,Bl122,2
3805.366649,3805.565649,1,voc,114160999,114166969,5970,spec2/voc/Bl122_114160999.jpg,Bl122,2
5938.778256,5938.815256,1,voc,178163347,178164457,1110,spec2/voc/Bl122_178163347.jpg,Bl122,2
7872.099748,7872.124748,1,voc,236162992,236163742,750,spec2/voc/Bl122_236162992.jpg,Bl122,2
7962.146748,7962.260748,1,voc,238864402,238867822,3420,spec2/voc/Bl122_238864402.jpg,Bl122,2
11891.017137,11891.188137,1,voc,356730514,356735644,5130,spec2/voc/Bl122_356730514.jpg,Bl122,2
5962.794256,5962.802256,1,voc,178883827,178884067,240,spec2/voc/Bl122_178883827.jpg,Bl122,2
11162.60218,11162.60818,1,voc,334878065,334878245,180,spec2/voc/Bl122_334878065.jpg,Bl122,2
7842.841748,7842.848748,1,voc,235285252,235285462,210,spec2/voc/Bl122_235285252.jpg,Bl122,2
13826.67022,13826.67322,1,voc,414800106,414800196,90,spec2/voc/Bl122_414800106.jpg,Bl122,2
3796.454649,3796.461649,1,voc,113893639,113893849,210,spec2/voc/Bl122_113893639.jpg,Bl122,2
8362.040263,8362.101263,1,voc,250861207,250863037,1830,spec2/voc/Bl122_250861207.jpg,Bl122,2
3829.029649,3829.050649,1,voc,114870889,114871519,630,spec2/voc/Bl122_114870889.jpg,Bl122,2
7860.030748,7860.107748,1,voc,235800922,235803232,2310,spec2/voc/Bl122_235800922.jpg,Bl122,2
5947.094256,5947.142256,1,voc,178412827,178414267,1440,spec2/voc/Bl122_178412827.jpg,Bl122,2
13189.998662,13190.000662,1,voc,395699959,395700019,60,spec2/voc/Bl122_395699959.jpg,Bl122,2
10951.356807,10951.362807,1,voc,328540704,328540884,180,spec2/voc/Bl122_328540704.jpg,Bl122,2
14825.464551,14825.501551,1,voc,444763936,444765046,1110,spec2/voc/Bl122_444763936.jpg,Bl122,2
14804.884551,14804.909551,1,voc,444146536,444147286,750,spec2/voc/Bl122_444146536.jpg,Bl122,2
9048.667241,9048.671241,1,voc,271460017,271460137,120,spec2/voc/Bl122_271460017.jpg,Bl122,2
6092.83015,6092.84215,1,voc,182784904,182785264,360,spec2/voc/Bl122_182784904.jpg,Bl122,2
5992.419256,5992.427256,1,voc,179772577,179772817,240,spec2/voc/Bl122_179772577.jpg,Bl122,2
6023.272533,6023.280533,1,voc,180698175,180698415,240,spec2/voc/Bl122_180698175.jpg,Bl122,2
8936.375967,8936.380967,1,voc,268091279,268091429,150,spec2/voc/Bl122_268091279.jpg,Bl122,2
3848.353415,3848.357415,1,voc,115450602,115450722,120,spec2/voc/Bl122_115450602.jpg,Bl122,2
7983.177748,7983.187748,1,voc,239495332,239495632,300,spec2/voc/Bl122_239495332.jpg,Bl122,2
10854.690233,10854.694233,1,voc,325640706,325640826,120,spec2/voc/Bl122_325640706.jpg,Bl122,2
9173.340287,9173.451287,1,voc,275200208,275203538,3330,spec2/voc/Bl122_275200208.jpg,Bl122,2
9044.434241,9044.823241,1,voc,271333027,271344697,11670,spec2/voc/Bl122_271333027.jpg,Bl122,2
6207.540327,6207.549327,1,voc,186226209,186226479,270,spec2/voc/Bl122_186226209.jpg,Bl122,2
9052.393241,9052.402241,1,voc,271571797,271572067,270,spec2/voc/Bl122_271571797.jpg,Bl122,2
8360.772263,8360.775263,1,voc,250823167,250823257,90,spec2/voc/Bl122_250823167.jpg,Bl122,2
3895.448652,3895.456652,1,voc,116863459,116863699,240,spec2/voc/Bl122_116863459.jpg,Bl122,2
14155.163825,14155.169825,1,voc,424654914,424655094,180,spec2/voc/Bl122_424654914.jpg,Bl122,2
13160.123891,13160.148891,1,voc,394803716,394804466,750,spec2/voc/Bl122_394803716.jpg,Bl122,2
14794.130551,14794.160551,1,voc,443823916,443824816,900,spec2/voc/Bl122_443823916.jpg,Bl122,2
10933.948807,10933.960807,1,voc,328018464,328018824,360,spec2/voc/Bl122_328018464.jpg,Bl122,2
10947.429807,10947.520807,1,voc,328422894,328425624,2730,spec2/voc/Bl122_328422894.jpg,Bl122,2
6107.807706,6107.865706,1,voc,183234231,183235971,1740,spec2/voc/Bl122_183234231.jpg,Bl122,2
10881.420609,10881.431609,1,voc,326442618,326442948,330,spec2/voc/Bl122_326442618.jpg,Bl122,2
3847.230415,3847.236415,1,voc,115416912,115417092,180,spec2/voc/Bl122_115416912.jpg,Bl122,2
6133.391293,6133.823293,1,voc,184001738,184014698,12960,spec2/voc/Bl122_184001738.jpg,Bl122,2
13169.961701,13169.963701,1,voc,395098851,395098911,60,spec2/voc/Bl122_395098851.jpg,Bl122,2
3176.592448,3176.605448,1,voc,95297773,95298163,390,spec2/voc/Bl122_95297773.jpg,Bl122,2
7899.093748,7899.137748,1,voc,236972812,236974132,1320,spec2/voc/Bl122_236972812.jpg,Bl122,2
14330.840456,14330.846456,1,voc,429925213,429925393,180,spec2/voc/Bl122_429925213.jpg,Bl122,2
7919.372748,7919.387748,1,voc,237581182,237581632,450,spec2/voc/Bl122_237581182.jpg,Bl122,2
9064.186241,9064.348241,1,voc,271925587,271930447,4860,spec2/voc/Bl122_271925587.jpg,Bl122,2
9067.059241,9067.073241,1,voc,272011777,272012197,420,spec2/voc/Bl122_272011777.jpg,Bl122,2
12619.49099,12619.54999,1,voc,378584729,378586499,1770,spec2/voc/Bl122_378584729.jpg,Bl122,2
13725.58941,13725.62241,1,voc,411767682,411768672,990,spec2/voc/Bl122_411767682.jpg,Bl122,2
5983.327256,5983.332256,1,voc,179499817,179499967,150,spec2/voc/Bl122_179499817.jpg,Bl122,2
3876.668848,3876.671848,1,voc,116300065,116300155,90,spec2/voc/Bl122_116300065.jpg,Bl122,2
14801.838551,14801.844551,1,voc,444055156,444055336,180,spec2/voc/Bl122_444055156.jpg,Bl122,2
5963.063256,5963.070256,1,voc,178891897,178892107,210,spec2/voc/Bl122_178891897.jpg,Bl122,2
7972.910748,7972.917748,1,voc,239187322,239187532,210,spec2/voc/Bl122_239187322.jpg,Bl122,2
7906.753748,7906.771748,1,voc,237202612,237203152,540,spec2/voc/Bl122_237202612.jpg,Bl122,2
8981.996025,8982.000025,1,voc,269459880,269460000,120,spec2/voc/Bl122_269459880.jpg,Bl122,2
9125.215182,9125.558182,1,voc,273756455,273766745,10290,spec2/voc/Bl122_273756455.jpg,Bl122,2
9070.943241,9071.147241,1,voc,272128297,272134417,6120,spec2/voc/Bl122_272128297.jpg,Bl122,2
6125.600706,6125.625706,1,voc,183768021,183768771,750,spec2/voc/Bl122_183768021.jpg,Bl122,2
5965.486256,5965.499256,1,voc,178964587,178964977,390,spec2/voc/Bl122_178964587.jpg,Bl122,2
6176.404327,6176.495327,1,voc,185292129,185294859,2730,spec2/voc/Bl122_185292129.jpg,Bl122,2
7881.783748,7881.790748,1,voc,236453512,236453722,210,spec2/voc/Bl122_236453512.jpg,Bl122,2
3852.569415,3852.656415,1,voc,115577082,115579692,2610,spec2/voc/Bl122_115577082.jpg,Bl122,2
9076.305241,9076.317241,1,voc,272289157,272289517,360,spec2/voc/Bl122_272289157.jpg,Bl122,2
5989.086256,5989.101256,1,voc,179672587,179673037,450,spec2/voc/Bl122_179672587.jpg,Bl122,2
6095.59415,6095.63415,1,voc,182867824,182869024,1200,spec2/voc/Bl122_182867824.jpg,Bl122,2
9057.140241,9057.180241,1,voc,271714207,271715407,1200,spec2/voc/Bl122_271714207.jpg,Bl122,2
11175.85518,11176.09418,1,voc,335275655,335282825,7170,spec2/voc/Bl122_335275655.jpg,Bl122,2
6200.365327,6200.369327,1,voc,186010959,186011079,120,spec2/voc/Bl122_186010959.jpg,Bl122,2
6033.579533,6033.588533,1,voc,181007385,181007655,270,spec2/voc/Bl122_181007385.jpg,Bl122,2
8919.246773,8919.300773,1,voc,267577403,267579023,1620,spec2/voc/Bl122_267577403.jpg,Bl122,2
9044.950241,9044.960241,1,voc,271348507,271348807,300,spec2/voc/Bl122_271348507.jpg,Bl122,2
13960.990384,13961.000384,1,voc,418829711,418830011,300,spec2/voc/Bl122_418829711.jpg,Bl122,2
5955.760256,5955.781256,1,voc,178672807,178673437,630,spec2/voc/Bl122_178672807.jpg,Bl122,2
14842.068682,14842.077682,1,voc,445262060,445262330,270,spec2/voc/Bl122_445262060.jpg,Bl122,2
5931.728256,5931.730256,1,voc,177951847,177951907,60,spec2/voc/Bl122_177951847.jpg,Bl122,2
11167.80618,11167.83718,1,voc,335034185,335035115,930,spec2/voc/Bl122_335034185.jpg,Bl122,2
13660.288334,13660.363334,1,voc,409808650,409810900,2250,spec2/voc/Bl122_409808650.jpg,Bl122,2
3831.323649,3831.347649,1,voc,114939709,114940429,720,spec2/voc/Bl122_114939709.jpg,Bl122,2
7908.386748,7908.427748,1,voc,237251602,237252832,1230,spec2/voc/Bl122_237251602.jpg,Bl122,2
6074.629705,6074.883705,1,voc,182238891,182246511,7620,spec2/voc/Bl122_182238891.jpg,Bl122,2
13973.382117,13973.426117,1,voc,419201463,419202783,1320,spec2/voc/Bl122_419201463.jpg,Bl122,2
3794.854649,3794.860649,1,voc,113845639,113845819,180,spec2/voc/Bl122_113845639.jpg,Bl122,2
9084.513241,9084.701241,1,voc,272535397,272541037,5640,spec2/voc/Bl122_272535397.jpg,Bl122,2
6121.207706,6121.217706,1,voc,183636231,183636531,300,spec2/voc/Bl122_183636231.jpg,Bl122,2
6170.451327,6170.461327,1,voc,185113539,185113839,300,spec2/voc/Bl122_185113539.jpg,Bl122,2
11125.334005,11125.337005,1,voc,333760020,333760110,90,spec2/voc/Bl122_333760020.jpg,Bl122,2
12595.012868,12595.091868,1,voc,377850386,377852756,2370,spec2/voc/Bl122_377850386.jpg,Bl122,2
9141.722757,9141.740757,1,voc,274251682,274252222,540,spec2/voc/Bl122_274251682.jpg,Bl122,2
8997.461241,8997.663241,1,voc,269923837,269929897,6060,spec2/voc/Bl122_269923837.jpg,Bl122,2
6185.081327,6185.084327,1,voc,185552439,185552529,90,spec2/voc/Bl122_185552439.jpg,Bl122,2
9146.017342,9146.089342,1,voc,274380520,274382680,2160,spec2/voc/Bl122_274380520.jpg,Bl122,2
3818.725649,3818.752649,1,voc,114561769,114562579,810,spec2/voc/Bl122_114561769.jpg,Bl122,2
5982.788256,5982.803256,1,voc,179483647,179484097,450,spec2/voc/Bl122_179483647.jpg,Bl122,2
7802.609748,7802.615748,1,voc,234078292,234078472,180,spec2/voc/Bl122_234078292.jpg,Bl122,2
7863.823748,7863.828748,1,voc,235914712,235914862,150,spec2/voc/Bl122_235914712.jpg,Bl122,2
9164.653604,9164.841604,1,voc,274939608,274945248,5640,spec2/voc/Bl122_274939608.jpg,Bl122,2
7844.004748,7844.072748,1,voc,235320142,235322182,2040,spec2/voc/Bl122_235320142.jpg,Bl122,2
8016.836748,8016.860748,1,voc,240505102,240505822,720,spec2/voc/Bl122_240505102.jpg,Bl122,2
14795.156551,14795.167551,1,voc,443854696,443855026,330,spec2/voc/Bl122_443854696.jpg,Bl122,2
9058.672241,9058.689241,1,voc,271760167,271760677,510,spec2/voc/Bl122_271760167.jpg,Bl122,2
6124.865706,6124.868706,1,voc,183745971,183746061,90,spec2/voc/Bl122_183745971.jpg,Bl122,2
6139.040293,6139.047293,1,voc,184171208,184171418,210,spec2/voc/Bl122_184171208.jpg,Bl122,2
11211.357894,11211.397894,1,voc,336340736,336341936,1200,spec2/voc/Bl122_336340736.jpg,Bl122,2
13589.399236,13589.409236,1,voc,407681977,407682277,300,spec2/voc/Bl122_407681977.jpg,Bl122,2
9089.538241,9089.559241,1,voc,272686147,272686777,630,spec2/voc/Bl122_272686147.jpg,Bl122,2
5945.498256,5945.504256,1,voc,178364947,178365127,180,spec2/voc/Bl122_178364947.jpg,Bl122,2
9108.953935,9108.965935,1,voc,273268618,273268978,360,spec2/voc/Bl122_273268618.jpg,Bl122,2
8980.711025,8980.751025,1,voc,269421330,269422530,1200,spec2/voc/Bl122_269421330.jpg,Bl122,2
8993.845241,8993.882241,1,voc,269815357,269816467,1110,spec2/voc/Bl122_269815357.jpg,Bl122,2
3814.824649,3814.868649,1,voc,114444739,114446059,1320,spec2/voc/Bl122_114444739.jpg,Bl122,2
9044.129241,9044.133241,1,voc,271323877,271323997,120,spec2/voc/Bl122_271323877.jpg,Bl122,2
14334.774707,14334.783707,1,voc,430043241,430043511,270,spec2/voc/Bl122_430043241.jpg,Bl122,2
13988.620864,13988.623864,1,voc,419658625,419658715,90,spec2/voc/Bl122_419658625.jpg,Bl122,2
12828.651025,12828.655025,1,voc,384859530,384859650,120,spec2/voc/Bl122_384859530.jpg,Bl122,2
9018.012241,9018.020241,1,voc,270540367,270540607,240,spec2/voc/Bl122_270540367.jpg,Bl122,2
7860.756748,7860.771748,1,voc,235822702,235823152,450,spec2/voc/Bl122_235822702.jpg,Bl122,2
6023.522533,6023.528533,1,voc,180705675,180705855,180,spec2/voc/Bl122_180705675.jpg,Bl122,2
7928.189748,7928.192748,1,voc,237845692,237845782,90,spec2/voc/Bl122_237845692.jpg,Bl122,2
13200.477389,13200.504389,1,voc,396014321,396015131,810,spec2/voc/Bl122_396014321.jpg,Bl122,2
6156.026349,6156.132349,1,voc,184680790,184683970,3180,spec2/voc/Bl122_184680790.jpg,Bl122,2
6014.412533,6014.442533,1,voc,180432375,180433275,900,spec2/voc/Bl122_180432375.jpg,Bl122,2
14801.622551,14801.629551,1,voc,444048676,444048886,210,spec2/voc/Bl122_444048676.jpg,Bl122,2
6097.05015,6097.11015,1,voc,182911504,182913304,1800,spec2/voc/Bl122_182911504.jpg,Bl122,2
13566.067867,13566.086867,1,voc,406982036,406982606,570,spec2/voc/Bl122_406982036.jpg,Bl122,2
14155.258825,14155.351825,1,voc,424657764,424660554,2790,spec2/voc/Bl122_424657764.jpg,Bl122,2
9162.100057,9162.108057,1,voc,274863001,274863241,240,spec2/voc/Bl122_274863001.jpg,Bl122,2
13580.121236,13580.130236,1,voc,407403637,407403907,270,spec2/voc/Bl122_407403637.jpg,Bl122,2
6051.0612,6051.1392,1,voc,181531836,181534176,2340,spec2/voc/Bl122_181531836.jpg,Bl122,2
3894.828652,3894.864652,1,voc,116844859,116845939,1080,spec2/voc/Bl122_116844859.jpg,Bl122,2
11126.017005,11126.022005,1,voc,333780510,333780660,150,spec2/voc/Bl122_333780510.jpg,Bl122,2
7995.251748,7995.259748,1,voc,239857552,239857792,240,spec2/voc/Bl122_239857552.jpg,Bl122,2
3057.667192,3057.671192,1,voc,91730015,91730135,120,spec2/voc/Bl122_91730015.jpg,Bl122,2
12672.896513,12672.914513,1,voc,380186895,380187435,540,spec2/voc/Bl122_380186895.jpg,Bl122,2
14804.315551,14804.352551,1,voc,444129466,444130576,1110,spec2/voc/Bl122_444129466.jpg,Bl122,2
3870.234367,3870.265367,1,voc,116107031,116107961,930,spec2/voc/Bl122_116107031.jpg,Bl122,2
11175.46418,11175.55418,1,voc,335263925,335266625,2700,spec2/voc/Bl122_335263925.jpg,Bl122,2
8985.867025,8985.920025,1,voc,269576010,269577600,1590,spec2/voc/Bl122_269576010.jpg,Bl122,2
5942.365256,5942.385256,1,voc,178270957,178271557,600,spec2/voc/Bl122_178270957.jpg,Bl122,2
8015.522748,8015.558748,1,voc,240465682,240466762,1080,spec2/voc/Bl122_240465682.jpg,Bl122,2
14799.924551,14799.952551,1,voc,443997736,443998576,840,spec2/voc/Bl122_443997736.jpg,Bl122,2
9006.982241,9007.017241,1,voc,270209467,270210517,1050,spec2/voc/Bl122_270209467.jpg,Bl122,2
6029.142533,6029.147533,1,voc,180874275,180874425,150,spec2/voc/Bl122_180874275.jpg,Bl122,2
7985.168748,7985.170748,1,voc,239555062,239555122,60,spec2/voc/Bl122_239555062.jpg,Bl122,2
7853.759748,7853.809748,1,voc,235612792,235614292,1500,spec2/voc/Bl122_235612792.jpg,Bl122,2
11192.92018,11192.95618,1,voc,335787605,335788685,1080,spec2/voc/Bl122_335787605.jpg,Bl122,2
3816.837649,3816.861649,1,voc,114505129,114505849,720,spec2/voc/Bl122_114505129.jpg,Bl122,2
13955.918384,13955.974384,1,voc,418677551,418679231,1680,spec2/voc/Bl122_418677551.jpg,Bl122,2
6075.236705,6075.384705,1,voc,182257101,182261541,4440,spec2/voc/Bl122_182257101.jpg,Bl122,2
7857.249748,7857.251748,1,voc,235717492,235717552,60,spec2/voc/Bl122_235717492.jpg,Bl122,2
14152.339278,14152.398278,1,voc,424570178,424571948,1770,spec2/voc/Bl122_424570178.jpg,Bl122,2
7940.030748,7940.033748,1,voc,238200922,238201012,90,spec2/voc/Bl122_238200922.jpg,Bl122,2
11210.807894,11210.831894,1,voc,336324236,336324956,720,spec2/voc/Bl122_336324236.jpg,Bl122,2
5997.046256,5997.049256,1,voc,179911387,179911477,90,spec2/voc/Bl122_179911387.jpg,Bl122,2
14155.507825,14155.511825,1,voc,424665234,424665354,120,spec2/voc/Bl122_424665234.jpg,Bl122,2
12627.211577,12627.216577,1,voc,378816347,378816497,150,spec2/voc/Bl122_378816347.jpg,Bl122,2
9038.515241,9038.519241,1,voc,271155457,271155577,120,spec2/voc/Bl122_271155457.jpg,Bl122,2
9148.856842,9148.885842,1,voc,274465705,274466575,870,spec2/voc/Bl122_274465705.jpg,Bl122,2
9108.597935,9108.656935,1,voc,273257938,273259708,1770,spec2/voc/Bl122_273257938.jpg,Bl122,2
14784.001465,14784.186465,1,voc,443520043,443525593,5550,spec2/voc/Bl122_443520043.jpg,Bl122,2
3841.470415,3841.473415,1,voc,115244112,115244202,90,spec2/voc/Bl122_115244112.jpg,Bl122,2
3885.251062,3885.257062,1,voc,116557531,116557711,180,spec2/voc/Bl122_116557531.jpg,Bl122,2
9086.245241,9086.266241,1,voc,272587357,272587987,630,spec2/voc/Bl122_272587357.jpg,Bl122,2
10961.008807,10961.011807,1,voc,328830264,328830354,90,spec2/voc/Bl122_328830264.jpg,Bl122,2
3894.227652,3894.233652,1,voc,116826829,116827009,180,spec2/voc/Bl122_116826829.jpg,Bl122,2
7881.180748,7881.218748,1,voc,236435422,236436562,1140,spec2/voc/Bl122_236435422.jpg,Bl122,2
6029.877533,6029.882533,1,voc,180896325,180896475,150,spec2/voc/Bl122_180896325.jpg,Bl122,2
6033.441533,6033.497533,1,voc,181003245,181004925,1680,spec2/voc/Bl122_181003245.jpg,Bl122,2
9150.525842,9150.549842,1,voc,274515775,274516495,720,spec2/voc/Bl122_274515775.jpg,Bl122,2
5936.664256,5936.688256,1,voc,178099927,178100647,720,spec2/voc/Bl122_178099927.jpg,Bl122,2
7869.200748,7869.268748,1,voc,236076022,236078062,2040,spec2/voc/Bl122_236076022.jpg,Bl122,2
6110.345706,6110.417706,1,voc,183310371,183312531,2160,spec2/voc/Bl122_183310371.jpg,Bl122,2
7911.838748,7911.850748,1,voc,237355162,237355522,360,spec2/voc/Bl122_237355162.jpg,Bl122,2
5990.853256,5990.857256,1,voc,179725597,179725717,120,spec2/voc/Bl122_179725597.jpg,Bl122,2
3823.408649,3823.671649,1,voc,114702259,114710149,7890,spec2/voc/Bl122_114702259.jpg,Bl122,2
14183.093102,14183.319102,1,voc,425492793,425499573,6780,spec2/voc/Bl122_425492793.jpg,Bl122,2
6074.896705,6075.012705,1,voc,182246901,182250381,3480,spec2/voc/Bl122_182246901.jpg,Bl122,2
5933.203256,5933.290256,1,voc,177996097,177998707,2610,spec2/voc/Bl122_177996097.jpg,Bl122,2
5954.840256,5954.847256,1,voc,178645207,178645417,210,spec2/voc/Bl122_178645207.jpg,Bl122,2
3850.499415,3850.511415,1,voc,115514982,115515342,360,spec2/voc/Bl122_115514982.jpg,Bl122,2
9057.784241,9057.843241,1,voc,271733527,271735297,1770,spec2/voc/Bl122_271733527.jpg,Bl122,2
8986.804025,8986.810025,1,voc,269604120,269604300,180,spec2/voc/Bl122_269604120.jpg,Bl122,2
8032.628748,8032.716748,1,voc,240978862,240981502,2640,spec2/voc/Bl122_240978862.jpg,Bl122,2
9074.063241,9074.282241,1,voc,272221897,272228467,6570,spec2/voc/Bl122_272221897.jpg,Bl122,2
8992.238241,8992.387241,1,voc,269767147,269771617,4470,spec2/voc/Bl122_269767147.jpg,Bl122,2
8039.445748,8039.451748,1,voc,241183372,241183552,180,spec2/voc/Bl122_241183372.jpg,Bl122,2
13171.086701,13171.101701,1,voc,395132601,395133051,450,spec2/voc/Bl122_395132601.jpg,Bl122,2
10915.226807,10915.236807,1,voc,327456804,327457104,300,spec2/voc/Bl122_327456804.jpg,Bl122,2
13201.410389,13201.437389,1,voc,396042311,396043121,810,spec2/voc/Bl122_396042311.jpg,Bl122,2
13826.40522,13826.42222,1,voc,414792156,414792666,510,spec2/voc/Bl122_414792156.jpg,Bl122,2
6025.292533,6025.302533,1,voc,180758775,180759075,300,spec2/voc/Bl122_180758775.jpg,Bl122,2
8928.011773,8928.055773,1,voc,267840353,267841673,1320,spec2/voc/Bl122_267840353.jpg,Bl122,2
3797.610649,3797.632649,1,voc,113928319,113928979,660,spec2/voc/Bl122_113928319.jpg,Bl122,2
10854.924233,10855.004233,1,voc,325647726,325650126,2400,spec2/voc/Bl122_325647726.jpg,Bl122,2
5958.537256,5958.561256,1,voc,178756117,178756837,720,spec2/voc/Bl122_178756117.jpg,Bl122,2
5966.193256,5966.366256,1,voc,178985797,178990987,5190,spec2/voc/Bl122_178985797.jpg,Bl122,2
3831.223649,3831.256649,1,voc,114936709,114937699,990,spec2/voc/Bl122_114936709.jpg,Bl122,2
8980.841025,8980.853025,1,voc,269425230,269425590,360,spec2/voc/Bl122_269425230.jpg,Bl122,2
9135.826255,9135.829255,1,voc,274074787,274074877,90,spec2/voc/Bl122_274074787.jpg,Bl122,2
7985.865748,7985.872748,1,voc,239575972,239576182,210,spec2/voc/Bl122_239575972.jpg,Bl122,2
14710.786469,14710.877469,1,voc,441323594,441326324,2730,spec2/voc/Bl122_441323594.jpg,Bl122,2
6055.946705,6055.949705,1,voc,181678401,181678491,90,spec2/voc/Bl122_181678401.jpg,Bl122,2
13213.821389,13213.938389,1,voc,396414641,396418151,3510,spec2/voc/Bl122_396414641.jpg,Bl122,2
13811.994352,13812.133352,1,voc,414359830,414364000,4170,spec2/voc/Bl122_414359830.jpg,Bl122,2
7983.157748,7983.165748,1,voc,239494732,239494972,240,spec2/voc/Bl122_239494732.jpg,Bl122,2
14027.461104,14027.644104,1,voc,420823833,420829323,5490,spec2/voc/Bl122_420823833.jpg,Bl122,2
5969.927256,5969.939256,1,voc,179097817,179098177,360,spec2/voc/Bl122_179097817.jpg,Bl122,2
6051.3242,6051.3492,1,voc,181539726,181540476,750,spec2/voc/Bl122_181539726.jpg,Bl122,2
6178.988327,6179.041327,1,voc,185369649,185371239,1590,spec2/voc/Bl122_185369649.jpg,Bl122,2
9033.103241,9033.303241,1,voc,270993097,270999097,6000,spec2/voc/Bl122_270993097.jpg,Bl122,2
9012.546241,9012.559241,1,voc,270376387,270376777,390,spec2/voc/Bl122_270376387.jpg,Bl122,2
9088.786241,9088.852241,1,voc,272663587,272665567,1980,spec2/voc/Bl122_272663587.jpg,Bl122,2
6038.216533,6038.316533,1,voc,181146495,181149495,3000,spec2/voc/Bl122_181146495.jpg,Bl122,2
8922.367773,8922.404773,1,voc,267671033,267672143,1110,spec2/voc/Bl122_267671033.jpg,Bl122,2
6012.854533,6012.859533,1,voc,180385635,180385785,150,spec2/voc/Bl122_180385635.jpg,Bl122,2
7999.732748,7999.753748,1,voc,239991982,239992612,630,spec2/voc/Bl122_239991982.jpg,Bl122,2
9114.659184,9114.667184,1,voc,273439775,273440015,240,spec2/voc/Bl122_273439775.jpg,Bl122,2
12619.28099,12619.38399,1,voc,378578429,378581519,3090,spec2/voc/Bl122_378578429.jpg,Bl122,2
7974.549748,7974.554748,1,voc,239236492,239236642,150,spec2/voc/Bl122_239236492.jpg,Bl122,2
6065.182705,6065.195705,1,voc,181955481,181955871,390,spec2/voc/Bl122_181955481.jpg,Bl122,2
8980.893025,8980.900025,1,voc,269426790,269427000,210,spec2/voc/Bl122_269426790.jpg,Bl122,2
3796.821649,3796.916649,1,voc,113904649,113907499,2850,spec2/voc/Bl122_113904649.jpg,Bl122,2
5996.418256,5996.423256,1,voc,179892547,179892697,150,spec2/voc/Bl122_179892547.jpg,Bl122,2
11184.23918,11184.24218,1,voc,335527175,335527265,90,spec2/voc/Bl122_335527175.jpg,Bl122,2
6122.777706,6122.892706,1,voc,183683331,183686781,3450,spec2/voc/Bl122_183683331.jpg,Bl122,2
14814.858551,14814.924551,1,voc,444445756,444447736,1980,spec2/voc/Bl122_444445756.jpg,Bl122,2
9042.604241,9042.688241,1,voc,271278127,271280647,2520,spec2/voc/Bl122_271278127.jpg,Bl122,2
6223.940295,6223.977295,1,voc,186718208,186719318,1110,spec2/voc/Bl122_186718208.jpg,Bl122,2
3828.237649,3828.252649,1,voc,114847129,114847579,450,spec2/voc/Bl122_114847129.jpg,Bl122,2
9079.112241,9079.117241,1,voc,272373367,272373517,150,spec2/voc/Bl122_272373367.jpg,Bl122,2
5982.968256,5982.975256,1,voc,179489047,179489257,210,spec2/voc/Bl122_179489047.jpg,Bl122,2
10941.344807,10941.541807,1,voc,328240344,328246254,5910,spec2/voc/Bl122_328240344.jpg,Bl122,2
6143.600349,6143.734349,1,voc,184308010,184312030,4020,spec2/voc/Bl122_184308010.jpg,Bl122,2
9057.690241,9057.694241,1,voc,271730707,271730827,120,spec2/voc/Bl122_271730707.jpg,Bl122,2
8966.674712,8966.683712,1,voc,269000241,269000511,270,spec2/voc/Bl122_269000241.jpg,Bl122,2
9149.535842,9149.607842,1,voc,274486075,274488235,2160,spec2/voc/Bl122_274486075.jpg,Bl122,2
13195.330662,13195.406662,1,voc,395859919,395862199,2280,spec2/voc/Bl122_395859919.jpg,Bl122,2
14126.923903,14127.099903,1,voc,423807717,423812997,5280,spec2/voc/Bl122_423807717.jpg,Bl122,2
6016.907533,6016.910533,1,voc,180507225,180507315,90,spec2/voc/Bl122_180507225.jpg,Bl122,2
9062.081241,9062.086241,1,voc,271862437,271862587,150,spec2/voc/Bl122_271862437.jpg,Bl122,2
5977.642256,5977.649256,1,voc,179329267,179329477,210,spec2/voc/Bl122_179329267.jpg,Bl122,2
6015.770533,6015.773533,1,voc,180473115,180473205,90,spec2/voc/Bl122_180473115.jpg,Bl122,2
3841.181415,3841.206415,1,voc,115235442,115236192,750,spec2/voc/Bl122_115235442.jpg,Bl122,2
9014.729241,9014.733241,1,voc,270441877,270441997,120,spec2/voc/Bl122_270441877.jpg,Bl122,2
9006.821241,9006.980241,1,voc,270204637,270209407,4770,spec2/voc/Bl122_270204637.jpg,Bl122,2
10896.495557,10896.527557,1,voc,326894866,326895826,960,spec2/voc/Bl122_326894866.jpg,Bl122,2
7911.429748,7911.435748,1,voc,237342892,237343072,180,spec2/voc/Bl122_237342892.jpg,Bl122,2
3806.795649,3806.823649,1,voc,114203869,114204709,840,spec2/voc/Bl122_114203869.jpg,Bl122,2
5966.707256,5966.715256,1,voc,179001217,179001457,240,spec2/voc/Bl122_179001217.jpg,Bl122,2
13949.305911,13949.308911,1,voc,418479177,418479267,90,spec2/voc/Bl122_418479177.jpg,Bl122,2
7975.574748,7975.584748,1,voc,239267242,239267542,300,spec2/voc/Bl122_239267242.jpg,Bl122,2
9079.522241,9079.729241,1,voc,272385667,272391877,6210,spec2/voc/Bl122_272385667.jpg,Bl122,2
6114.769706,6114.782706,1,voc,183443091,183443481,390,spec2/voc/Bl122_183443091.jpg,Bl122,2
13950.733911,13951.185911,1,voc,418522017,418535577,13560,spec2/voc/Bl122_418522017.jpg,Bl122,2
6099.09515,6099.16615,1,voc,182972854,182974984,2130,spec2/voc/Bl122_182972854.jpg,Bl122,2
7945.575748,7945.584748,1,voc,238367272,238367542,270,spec2/voc/Bl122_238367272.jpg,Bl122,2
6184.531327,6184.758327,1,voc,185535939,185542749,6810,spec2/voc/Bl122_185535939.jpg,Bl122,2
6024.018533,6024.024533,1,voc,180720555,180720735,180,spec2/voc/Bl122_180720555.jpg,Bl122,2
5958.572256,5958.575256,1,voc,178757167,178757257,90,spec2/voc/Bl122_178757167.jpg,Bl122,2
9070.089241,9070.100241,1,voc,272102677,272103007,330,spec2/voc/Bl122_272102677.jpg,Bl122,2
7911.260748,7911.275748,1,voc,237337822,237338272,450,spec2/voc/Bl122_237337822.jpg,Bl122,2
9082.302241,9082.313241,1,voc,272469067,272469397,330,spec2/voc/Bl122_272469067.jpg,Bl122,2
5996.794256,5996.848256,1,voc,179903827,179905447,1620,spec2/voc/Bl122_179903827.jpg,Bl122,2
11196.70118,11196.74818,1,voc,335901035,335902445,1410,spec2/voc/Bl122_335901035.jpg,Bl122,2
6104.134706,6104.158706,1,voc,183124041,183124761,720,spec2/voc/Bl122_183124041.jpg,Bl122,2
14834.926682,14834.929682,1,voc,445047800,445047890,90,spec2/voc/Bl122_445047800.jpg,Bl122,2
11157.02918,11157.03518,1,voc,334710875,334711055,180,spec2/voc/Bl122_334710875.jpg,Bl122,2
8016.517748,8016.523748,1,voc,240495532,240495712,180,spec2/voc/Bl122_240495532.jpg,Bl122,2
5988.038256,5988.064256,1,voc,179641147,179641927,780,spec2/voc/Bl122_179641147.jpg,Bl122,2
5939.932256,5939.937256,1,voc,178197967,178198117,150,spec2/voc/Bl122_178197967.jpg,Bl122,2
11100.423855,11100.443855,1,voc,333012715,333013315,600,spec2/voc/Bl122_333012715.jpg,Bl122,2
3809.021649,3809.058649,1,voc,114270649,114271759,1110,spec2/voc/Bl122_114270649.jpg,Bl122,2
13956.804384,13956.916384,1,voc,418704131,418707491,3360,spec2/voc/Bl122_418704131.jpg,Bl122,2
13554.801188,13554.809188,1,voc,406644035,406644275,240,spec2/voc/Bl122_406644035.jpg,Bl122,2
3881.164062,3881.203062,1,voc,116434921,116436091,1170,spec2/voc/Bl122_116434921.jpg,Bl122,2
6016.695533,6016.698533,1,voc,180500865,180500955,90,spec2/voc/Bl122_180500865.jpg,Bl122,2
11170.05918,11170.25818,1,voc,335101775,335107745,5970,spec2/voc/Bl122_335101775.jpg,Bl122,2
5949.435256,5949.453256,1,voc,178483057,178483597,540,spec2/voc/Bl122_178483057.jpg,Bl122,2
9014.079241,9014.110241,1,voc,270422377,270423307,930,spec2/voc/Bl122_270422377.jpg,Bl122,2
3822.757649,3822.765649,1,voc,114682729,114682969,240,spec2/voc/Bl122_114682729.jpg,Bl122,2
7987.032748,7987.102748,1,voc,239610982,239613082,2100,spec2/voc/Bl122_239610982.jpg,Bl122,2
13826.68522,13826.83022,1,voc,414800556,414804906,4350,spec2/voc/Bl122_414800556.jpg,Bl122,2
5989.501256,5989.507256,1,voc,179685037,179685217,180,spec2/voc/Bl122_179685037.jpg,Bl122,2
14836.177682,14836.182682,1,voc,445085330,445085480,150,spec2/voc/Bl122_445085330.jpg,Bl122,2
6091.04915,6091.10215,1,voc,182731474,182733064,1590,spec2/voc/Bl122_182731474.jpg,Bl122,2
5969.775256,5969.777256,1,voc,179093257,179093317,60,spec2/voc/Bl122_179093257.jpg,Bl122,2
7829.426748,7829.428748,1,voc,234882802,234882862,60,spec2/voc/Bl122_234882802.jpg,Bl122,2
13827.26522,13827.28622,1,voc,414817956,414818586,630,spec2/voc/Bl122_414817956.jpg,Bl122,2
13956.223384,13956.228384,1,voc,418686701,418686851,150,spec2/voc/Bl122_418686701.jpg,Bl122,2
7911.201748,7911.212748,1,voc,237336052,237336382,330,spec2/voc/Bl122_237336052.jpg,Bl122,2
6056.597705,6056.603705,1,voc,181697931,181698111,180,spec2/voc/Bl122_181697931.jpg,Bl122,2
3791.598649,3791.607649,1,voc,113747959,113748229,270,spec2/voc/Bl122_113747959.jpg,Bl122,2
6040.900065,6040.912065,1,voc,181227001,181227361,360,spec2/voc/Bl122_181227001.jpg,Bl122,2
3816.170649,3816.280649,1,voc,114485119,114488419,3300,spec2/voc/Bl122_114485119.jpg,Bl122,2
14838.595682,14838.645682,1,voc,445157870,445159370,1500,spec2/voc/Bl122_445157870.jpg,Bl122,2
8367.322166,8367.372166,1,voc,251019664,251021164,1500,spec2/voc/Bl122_251019664.jpg,Bl122,2
9128.627981,9128.633981,1,voc,273858839,273859019,180,spec2/voc/Bl122_273858839.jpg,Bl122,2
10919.531807,10919.570807,1,voc,327585954,327587124,1170,spec2/voc/Bl122_327585954.jpg,Bl122,2
9071.372241,9071.395241,1,voc,272141167,272141857,690,spec2/voc/Bl122_272141167.jpg,Bl122,2
6135.690293,6135.872293,1,voc,184070708,184076168,5460,spec2/voc/Bl122_184070708.jpg,Bl122,2
11851.94673,11851.95473,1,voc,355558401,355558641,240,spec2/voc/Bl122_355558401.jpg,Bl122,2
8919.701773,8919.827773,1,voc,267591053,267594833,3780,spec2/voc/Bl122_267591053.jpg,Bl122,2
7891.301748,7891.311748,1,voc,236739052,236739352,300,spec2/voc/Bl122_236739052.jpg,Bl122,2
14201.863387,14201.929387,1,voc,426055901,426057881,1980,spec2/voc/Bl122_426055901.jpg,Bl122,2
7886.878748,7886.886748,1,voc,236606362,236606602,240,spec2/voc/Bl122_236606362.jpg,Bl122,2
6068.612705,6068.649705,1,voc,182058381,182059491,1110,spec2/voc/Bl122_182058381.jpg,Bl122,2
12638.989849,12639.045849,1,voc,379169695,379171375,1680,spec2/voc/Bl122_379169695.jpg,Bl122,2
3819.590649,3819.593649,1,voc,114587719,114587809,90,spec2/voc/Bl122_114587719.jpg,Bl122,2
6193.070327,6193.075327,1,voc,185792109,185792259,150,spec2/voc/Bl122_185792109.jpg,Bl122,2
14806.050551,14806.065551,1,voc,444181516,444181966,450,spec2/voc/Bl122_444181516.jpg,Bl122,2
13988.281864,13988.283864,1,voc,419648455,419648515,60,spec2/voc/Bl122_419648455.jpg,Bl122,2
11152.26318,11152.29418,1,voc,334567895,334568825,930,spec2/voc/Bl122_334567895.jpg,Bl122,2
11200.964894,11200.970894,1,voc,336028946,336029126,180,spec2/voc/Bl122_336028946.jpg,Bl122,2
9079.506241,9079.511241,1,voc,272385187,272385337,150,spec2/voc/Bl122_272385187.jpg,Bl122,2
13200.328389,13200.392389,1,voc,396009851,396011771,1920,spec2/voc/Bl122_396009851.jpg,Bl122,2
13167.784658,13167.803658,1,voc,395033539,395034109,570,spec2/voc/Bl122_395033539.jpg,Bl122,2
9142.190757,9142.195757,1,voc,274265722,274265872,150,spec2/voc/Bl122_274265722.jpg,Bl122,2
9058.699241,9058.703241,1,voc,271760977,271761097,120,spec2/voc/Bl122_271760977.jpg,Bl122,2
13179.147701,13179.257701,1,voc,395374431,395377731,3300,spec2/voc/Bl122_395374431.jpg,Bl122,2
6222.036295,6222.070295,1,voc,186661088,186662108,1020,spec2/voc/Bl122_186661088.jpg,Bl122,2
13213.798389,13213.815389,1,voc,396413951,396414461,510,spec2/voc/Bl122_396413951.jpg,Bl122,2
14202.105387,14202.110387,1,voc,426063161,426063311,150,spec2/voc/Bl122_426063161.jpg,Bl122,2
9071.753241,9071.803241,1,voc,272152597,272154097,1500,spec2/voc/Bl122_272152597.jpg,Bl122,2
7961.756748,7961.759748,1,voc,238852702,238852792,90,spec2/voc/Bl122_238852702.jpg,Bl122,2
9086.118241,9086.162241,1,voc,272583547,272584867,1320,spec2/voc/Bl122_272583547.jpg,Bl122,2
9060.503241,9060.512241,1,voc,271815097,271815367,270,spec2/voc/Bl122_271815097.jpg,Bl122,2
6034.043533,6034.052533,1,voc,181021305,181021575,270,spec2/voc/Bl122_181021305.jpg,Bl122,2
13606.511736,13606.579736,1,voc,408195352,408197392,2040,spec2/voc/Bl122_408195352.jpg,Bl122,2
6028.239533,6028.270533,1,voc,180847185,180848115,930,spec2/voc/Bl122_180847185.jpg,Bl122,2
11202.222894,11202.236894,1,voc,336066686,336067106,420,spec2/voc/Bl122_336066686.jpg,Bl122,2
8918.083773,8918.135773,1,voc,267542513,267544073,1560,spec2/voc/Bl122_267542513.jpg,Bl122,2
6090.90315,6090.90915,1,voc,182727094,182727274,180,spec2/voc/Bl122_182727094.jpg,Bl122,2
6122.384706,6122.442706,1,voc,183671541,183673281,1740,spec2/voc/Bl122_183671541.jpg,Bl122,2
8360.782263,8360.993263,1,voc,250823467,250829797,6330,spec2/voc/Bl122_250823467.jpg,Bl122,2
13957.576384,13957.581384,1,voc,418727291,418727441,150,spec2/voc/Bl122_418727291.jpg,Bl122,2
14789.523551,14789.535551,1,voc,443685706,443686066,360,spec2/voc/Bl122_443685706.jpg,Bl122,2
5976.423256,5976.428256,1,voc,179292697,179292847,150,spec2/voc/Bl122_179292697.jpg,Bl122,2
10749.666932,10749.669932,1,voc,322490007,322490097,90,spec2/voc/Bl122_322490007.jpg,Bl122,2
12664.023938,12664.028938,1,voc,379920718,379920868,150,spec2/voc/Bl122_379920718.jpg,Bl122,2
11032.992132,11032.999132,1,voc,330989763,330989973,210,spec2/voc/Bl122_330989763.jpg,Bl122,2
3847.445415,3847.458415,1,voc,115423362,115423752,390,spec2/voc/Bl122_115423362.jpg,Bl122,2
6043.3712,6043.3882,1,voc,181301136,181301646,510,spec2/voc/Bl122_181301136.jpg,Bl122,2
10875.555466,10875.613466,1,voc,326266663,326268403,1740,spec2/voc/Bl122_326266663.jpg,Bl122,2
7871.895748,7871.926748,1,voc,236156872,236157802,930,spec2/voc/Bl122_236156872.jpg,Bl122,2
6032.828533,6032.889533,1,voc,180984855,180986685,1830,spec2/voc/Bl122_180984855.jpg,Bl122,2
5997.650256,5997.654256,1,voc,179929507,179929627,120,spec2/voc/Bl122_179929507.jpg,Bl122,2
6053.2222,6053.5432,1,voc,181596666,181606296,9630,spec2/voc/Bl122_181596666.jpg,Bl122,2
3882.557062,3882.784062,1,voc,116476711,116483521,6810,spec2/voc/Bl122_116476711.jpg,Bl122,2
3893.143652,3893.166652,1,voc,116794309,116794999,690,spec2/voc/Bl122_116794309.jpg,Bl122,2
6137.732293,6137.908293,1,voc,184131968,184137248,5280,spec2/voc/Bl122_184131968.jpg,Bl122,2
3039.293317,3039.300317,1,voc,91178799,91179009,210,spec2/voc/Bl122_91178799.jpg,Bl122,2
9091.056241,9091.104241,1,voc,272731687,272733127,1440,spec2/voc/Bl122_272731687.jpg,Bl122,2
7932.425748,7932.462748,1,voc,237972772,237973882,1110,spec2/voc/Bl122_237972772.jpg,Bl122,2
13969.080352,13969.082352,1,voc,419072410,419072470,60,spec2/voc/Bl122_419072410.jpg,Bl122,2
9148.271842,9148.280842,1,voc,274448155,274448425,270,spec2/voc/Bl122_274448155.jpg,Bl122,2
6069.225705,6069.434705,1,voc,182076771,182083041,6270,spec2/voc/Bl122_182076771.jpg,Bl122,2
6068.194705,6068.215705,1,voc,182045841,182046471,630,spec2/voc/Bl122_182045841.jpg,Bl122,2
13195.414662,13195.416662,1,voc,395862439,395862499,60,spec2/voc/Bl122_395862439.jpg,Bl122,2
6077.454705,6077.515705,1,voc,182323641,182325471,1830,spec2/voc/Bl122_182323641.jpg,Bl122,2
6190.091327,6190.151327,1,voc,185702739,185704539,1800,spec2/voc/Bl122_185702739.jpg,Bl122,2
9026.710241,9026.970241,1,voc,270801307,270809107,7800,spec2/voc/Bl122_270801307.jpg,Bl122,2
9071.879241,9071.888241,1,voc,272156377,272156647,270,spec2/voc/Bl122_272156377.jpg,Bl122,2
6003.544256,6003.739256,1,voc,180106327,180112177,5850,spec2/voc/Bl122_180106327.jpg,Bl122,2
9042.891241,9042.900241,1,voc,271286737,271287007,270,spec2/voc/Bl122_271286737.jpg,Bl122,2
10949.189807,10949.283807,1,voc,328475694,328478514,2820,spec2/voc/Bl122_328475694.jpg,Bl122,2
13218.608389,13218.613389,1,voc,396558251,396558401,150,spec2/voc/Bl122_396558251.jpg,Bl122,2
8206.523882,8206.598882,1,voc,246195716,246197966,2250,spec2/voc/Bl122_246195716.jpg,Bl122,2
10874.730466,10874.781466,1,voc,326241913,326243443,1530,spec2/voc/Bl122_326241913.jpg,Bl122,2
13207.711389,13207.713389,1,voc,396231341,396231401,60,spec2/voc/Bl122_396231341.jpg,Bl122,2
3896.953652,3897.102652,1,voc,116908609,116913079,4470,spec2/voc/Bl122_116908609.jpg,Bl122,2
7912.105748,7912.109748,1,voc,237363172,237363292,120,spec2/voc/Bl122_237363172.jpg,Bl122,2
13823.72322,13823.74822,1,voc,414711696,414712446,750,spec2/voc/Bl122_414711696.jpg,Bl122,2
6081.213511,6081.220511,1,voc,182436405,182436615,210,spec2/voc/Bl122_182436405.jpg,Bl122,2
14677.853425,14678.017425,1,voc,440335602,440340522,4920,spec2/voc/Bl122_440335602.jpg,Bl122,2
6067.491705,6067.544705,1,voc,182024751,182026341,1590,spec2/voc/Bl122_182024751.jpg,Bl122,2
5978.537256,5978.547256,1,voc,179356117,179356417,300,spec2/voc/Bl122_179356117.jpg,Bl122,2
10952.778807,10952.782807,1,voc,328583364,328583484,120,spec2/voc/Bl122_328583364.jpg,Bl122,2
10907.071825,10907.079825,1,voc,327212154,327212394,240,spec2/voc/Bl122_327212154.jpg,Bl122,2
11185.87218,11185.87618,1,voc,335576165,335576285,120,spec2/voc/Bl122_335576165.jpg,Bl122,2
7884.281748,7884.285748,1,voc,236528452,236528572,120,spec2/voc/Bl122_236528452.jpg,Bl122,2
13989.403864,13989.405864,1,voc,419682115,419682175,60,spec2/voc/Bl122_419682115.jpg,Bl122,2
6027.170533,6027.176533,1,voc,180815115,180815295,180,spec2/voc/Bl122_180815115.jpg,Bl122,2
9004.488241,9004.492241,1,voc,270134647,270134767,120,spec2/voc/Bl122_270134647.jpg,Bl122,2
5991.082256,5991.279256,1,voc,179732467,179738377,5910,spec2/voc/Bl122_179732467.jpg,Bl122,2
9148.291842,9148.305842,1,voc,274448755,274449175,420,spec2/voc/Bl122_274448755.jpg,Bl122,2
6125.877706,6125.883706,1,voc,183776331,183776511,180,spec2/voc/Bl122_183776331.jpg,Bl122,2
5972.929256,5972.968256,1,voc,179187877,179189047,1170,spec2/voc/Bl122_179187877.jpg,Bl122,2
6050.0192,6050.0222,1,voc,181500576,181500666,90,spec2/voc/Bl122_181500576.jpg,Bl122,2
7961.933748,7961.969748,1,voc,238858012,238859092,1080,spec2/voc/Bl122_238858012.jpg,Bl122,2
3802.125649,3802.211649,1,voc,114063769,114066349,2580,spec2/voc/Bl122_114063769.jpg,Bl122,2
14783.651465,14783.911465,1,voc,443509543,443517343,7800,spec2/voc/Bl122_443509543.jpg,Bl122,2
9008.634241,9008.644241,1,voc,270259027,270259327,300,spec2/voc/Bl122_270259027.jpg,Bl122,2
9009.289241,9009.424241,1,voc,270278677,270282727,4050,spec2/voc/Bl122_270278677.jpg,Bl122,2
5960.165256,5960.173256,1,voc,178804957,178805197,240,spec2/voc/Bl122_178804957.jpg,Bl122,2
12638.478849,12638.571849,1,voc,379154365,379157155,2790,spec2/voc/Bl122_379154365.jpg,Bl122,2
9016.930241,9016.955241,1,voc,270507907,270508657,750,spec2/voc/Bl122_270507907.jpg,Bl122,2
6040.386065,6040.415065,1,voc,181211581,181212451,870,spec2/voc/Bl122_181211581.jpg,Bl122,2
8004.602748,8004.606748,1,voc,240138082,240138202,120,spec2/voc/Bl122_240138082.jpg,Bl122,2
3048.921397,3049.124397,1,voc,91467641,91473731,6090,spec2/voc/Bl122_91467641.jpg,Bl122,2
3817.263649,3817.267649,1,voc,114517909,114518029,120,spec2/voc/Bl122_114517909.jpg,Bl122,2
6067.932705,6067.954705,1,voc,182037981,182038641,660,spec2/voc/Bl122_182037981.jpg,Bl122,2
5940.557256,5940.561256,1,voc,178216717,178216837,120,spec2/voc/Bl122_178216717.jpg,Bl122,2
13946.723911,13946.750911,1,voc,418401717,418402527,810,spec2/voc/Bl122_418401717.jpg,Bl122,2
3830.196649,3830.208649,1,voc,114905899,114906259,360,spec2/voc/Bl122_114905899.jpg,Bl122,2
13929.927797,13929.936797,1,voc,417897833,417898103,270,spec2/voc/Bl122_417897833.jpg,Bl122,2
11195.69318,11195.80618,1,voc,335870795,335874185,3390,spec2/voc/Bl122_335870795.jpg,Bl122,2
3819.303649,3819.308649,1,voc,114579109,114579259,150,spec2/voc/Bl122_114579109.jpg,Bl122,2
3876.608848,3876.653848,1,voc,116298265,116299615,1350,spec2/voc/Bl122_116298265.jpg,Bl122,2
6175.196327,6175.225327,1,voc,185255889,185256759,870,spec2/voc/Bl122_185255889.jpg,Bl122,2
5937.635256,5937.810256,1,voc,178129057,178134307,5250,spec2/voc/Bl122_178129057.jpg,Bl122,2
13168.050658,13168.076658,1,voc,395041519,395042299,780,spec2/voc/Bl122_395041519.jpg,Bl122,2
3894.362652,3894.433652,1,voc,116830879,116833009,2130,spec2/voc/Bl122_116830879.jpg,Bl122,2
9100.855241,9100.933241,1,voc,273025657,273027997,2340,spec2/voc/Bl122_273025657.jpg,Bl122,2
6019.545533,6019.549533,1,voc,180586365,180586485,120,spec2/voc/Bl122_180586365.jpg,Bl122,2
8985.363025,8985.367025,1,voc,269560890,269561010,120,spec2/voc/Bl122_269560890.jpg,Bl122,2
14793.711551,14793.805551,1,voc,443811346,443814166,2820,spec2/voc/Bl122_443811346.jpg,Bl122,2
6012.623533,6012.666533,1,voc,180378705,180379995,1290,spec2/voc/Bl122_180378705.jpg,Bl122,2
9074.015241,9074.018241,1,voc,272220457,272220547,90,spec2/voc/Bl122_272220457.jpg,Bl122,2
6203.870327,6203.897327,1,voc,186116109,186116919,810,spec2/voc/Bl122_186116109.jpg,Bl122,2
9096.081241,9096.101241,1,voc,272882437,272883037,600,spec2/voc/Bl122_272882437.jpg,Bl122,2
7908.219748,7908.249748,1,voc,237246592,237247492,900,spec2/voc/Bl122_237246592.jpg,Bl122,2
9059.067241,9059.165241,1,voc,271772017,271774957,2940,spec2/voc/Bl122_271772017.jpg,Bl122,2
6105.982706,6106.049706,1,voc,183179481,183181491,2010,spec2/voc/Bl122_183179481.jpg,Bl122,2
7885.903748,7885.912748,1,voc,236577112,236577382,270,spec2/voc/Bl122_236577112.jpg,Bl122,2
9067.869241,9067.882241,1,voc,272036077,272036467,390,spec2/voc/Bl122_272036077.jpg,Bl122,2
9055.133241,9055.141241,1,voc,271653997,271654237,240,spec2/voc/Bl122_271653997.jpg,Bl122,2
6201.208327,6201.220327,1,voc,186036249,186036609,360,spec2/voc/Bl122_186036249.jpg,Bl122,2
6141.115349,6141.214349,1,voc,184233460,184236430,2970,spec2/voc/Bl122_184233460.jpg,Bl122,2
13826.08022,13826.25822,1,voc,414782406,414787746,5340,spec2/voc/Bl122_414782406.jpg,Bl122,2
9029.467241,9029.504241,1,voc,270884017,270885127,1110,spec2/voc/Bl122_270884017.jpg,Bl122,2
9006.517241,9006.664241,1,voc,270195517,270199927,4410,spec2/voc/Bl122_270195517.jpg,Bl122,2
7896.882748,7896.895748,1,voc,236906482,236906872,390,spec2/voc/Bl122_236906482.jpg,Bl122,2
3862.236367,3862.241367,1,voc,115867091,115867241,150,spec2/voc/Bl122_115867091.jpg,Bl122,2
5958.918256,5958.920256,1,voc,178767547,178767607,60,spec2/voc/Bl122_178767547.jpg,Bl122,2
8304.236054,8304.239054,1,voc,249127081,249127171,90,spec2/voc/Bl122_249127081.jpg,Bl122,2
7891.288748,7891.290748,1,voc,236738662,236738722,60,spec2/voc/Bl122_236738662.jpg,Bl122,2
10826.177452,10826.181452,1,voc,324785323,324785443,120,spec2/voc/Bl122_324785323.jpg,Bl122,2
10960.247807,10960.279807,1,voc,328807434,328808394,960,spec2/voc/Bl122_328807434.jpg,Bl122,2
6098.33115,6098.33715,1,voc,182949934,182950114,180,spec2/voc/Bl122_182949934.jpg,Bl122,2
13468.073417,13468.113417,1,voc,404042202,404043402,1200,spec2/voc/Bl122_404042202.jpg,Bl122,2
9018.416241,9018.546241,1,voc,270552487,270556387,3900,spec2/voc/Bl122_270552487.jpg,Bl122,2
8951.864967,8951.866967,1,voc,268555949,268556009,60,spec2/voc/Bl122_268555949.jpg,Bl122,2
10938.757807,10938.769807,1,voc,328162734,328163094,360,spec2/voc/Bl122_328162734.jpg,Bl122,2
9080.093241,9080.095241,1,voc,272402797,272402857,60,spec2/voc/Bl122_272402797.jpg,Bl122,2
14805.052551,14805.063551,1,voc,444151576,444151906,330,spec2/voc/Bl122_444151576.jpg,Bl122,2
8017.113748,8017.118748,1,voc,240513412,240513562,150,spec2/voc/Bl122_240513412.jpg,Bl122,2
13209.040389,13209.043389,1,voc,396271211,396271301,90,spec2/voc/Bl122_396271211.jpg,Bl122,2
9067.294241,9067.340241,1,voc,272018827,272020207,1380,spec2/voc/Bl122_272018827.jpg,Bl122,2
7965.791748,7965.806748,1,voc,238973752,238974202,450,spec2/voc/Bl122_238973752.jpg,Bl122,2
10930.868807,10930.995807,1,voc,327926064,327929874,3810,spec2/voc/Bl122_327926064.jpg,Bl122,2
5994.420256,5994.475256,1,voc,179832607,179834257,1650,spec2/voc/Bl122_179832607.jpg,Bl122,2
7923.148748,7923.153748,1,voc,237694462,237694612,150,spec2/voc/Bl122_237694462.jpg,Bl122,2
6178.504327,6178.527327,1,voc,185355129,185355819,690,spec2/voc/Bl122_185355129.jpg,Bl122,2
5965.006256,5965.025256,1,voc,178950187,178950757,570,spec2/voc/Bl122_178950187.jpg,Bl122,2
9002.974241,9003.125241,1,voc,270089227,270093757,4530,spec2/voc/Bl122_270089227.jpg,Bl122,2
6229.327295,6229.335295,1,voc,186879818,186880058,240,spec2/voc/Bl122_186879818.jpg,Bl122,2
6025.994533,6025.998533,1,voc,180779835,180779955,120,spec2/voc/Bl122_180779835.jpg,Bl122,2
9047.839241,9047.903241,1,voc,271435177,271437097,1920,spec2/voc/Bl122_271435177.jpg,Bl122,2
5988.069256,5988.082256,1,voc,179642077,179642467,390,spec2/voc/Bl122_179642077.jpg,Bl122,2
14795.584551,14795.594551,1,voc,443867536,443867836,300,spec2/voc/Bl122_443867536.jpg,Bl122,2
5966.680256,5966.685256,1,voc,179000407,179000557,150,spec2/voc/Bl122_179000407.jpg,Bl122,2
10915.187807,10915.198807,1,voc,327455634,327455964,330,spec2/voc/Bl122_327455634.jpg,Bl122,2
6207.988327,6208.023327,1,voc,186239649,186240699,1050,spec2/voc/Bl122_186239649.jpg,Bl122,2
3884.060062,3884.528062,1,voc,116521801,116535841,14040,spec2/voc/Bl122_116521801.jpg,Bl122,2
6138.262293,6138.270293,1,voc,184147868,184148108,240,spec2/voc/Bl122_184147868.jpg,Bl122,2
6064.168705,6064.261705,1,voc,181925061,181927851,2790,spec2/voc/Bl122_181925061.jpg,Bl122,2
12670.972513,12670.983513,1,voc,380129175,380129505,330,spec2/voc/Bl122_380129175.jpg,Bl122,2
14823.267551,14823.271551,1,voc,444698026,444698146,120,spec2/voc/Bl122_444698026.jpg,Bl122,2
5956.902256,5956.910256,1,voc,178707067,178707307,240,spec2/voc/Bl122_178707067.jpg,Bl122,2
14789.121551,14789.481551,1,voc,443673646,443684446,10800,spec2/voc/Bl122_443673646.jpg,Bl122,2
12666.885394,12666.939394,1,voc,380006561,380008181,1620,spec2/voc/Bl122_380006561.jpg,Bl122,2
13600.627736,13600.754736,1,voc,408018832,408022642,3810,spec2/voc/Bl122_408018832.jpg,Bl122,2
10941.338807,10941.341807,1,voc,328240164,328240254,90,spec2/voc/Bl122_328240164.jpg,Bl122,2
14802.919551,14803.007551,1,voc,444087586,444090226,2640,spec2/voc/Bl122_444087586.jpg,Bl122,2
5960.545256,5960.572256,1,voc,178816357,178817167,810,spec2/voc/Bl122_178816357.jpg,Bl122,2
6188.082327,6188.235327,1,voc,185642469,185647059,4590,spec2/voc/Bl122_185642469.jpg,Bl122,2
3813.111649,3813.147649,1,voc,114393349,114394429,1080,spec2/voc/Bl122_114393349.jpg,Bl122,2
5935.822256,5935.829256,1,voc,178074667,178074877,210,spec2/voc/Bl122_178074667.jpg,Bl122,2
11183.70318,11184.05118,1,voc,335511095,335521535,10440,spec2/voc/Bl122_335511095.jpg,Bl122,2
13960.447384,13960.463384,1,voc,418813421,418813901,480,spec2/voc/Bl122_418813421.jpg,Bl122,2
9041.384241,9041.509241,1,voc,271241527,271245277,3750,spec2/voc/Bl122_271241527.jpg,Bl122,2
9058.282241,9058.284241,1,voc,271748467,271748527,60,spec2/voc/Bl122_271748467.jpg,Bl122,2
6160.142349,6160.187349,1,voc,184804270,184805620,1350,spec2/voc/Bl122_184804270.jpg,Bl122,2
14795.569551,14795.572551,1,voc,443867086,443867176,90,spec2/voc/Bl122_443867086.jpg,Bl122,2
6222.076295,6222.088295,1,voc,186662288,186662648,360,spec2/voc/Bl122_186662288.jpg,Bl122,2
6114.717706,6114.723706,1,voc,183441531,183441711,180,spec2/voc/Bl122_183441531.jpg,Bl122,2
12933.02129,12933.02729,1,voc,387990638,387990818,180,spec2/voc/Bl122_387990638.jpg,Bl122,2
11189.92218,11190.08718,1,voc,335697665,335702615,4950,spec2/voc/Bl122_335697665.jpg,Bl122,2
9060.658241,9060.662241,1,voc,271819747,271819867,120,spec2/voc/Bl122_271819747.jpg,Bl122,2
6099.80315,6099.81415,1,voc,182994094,182994424,330,spec2/voc/Bl122_182994094.jpg,Bl122,2
7872.991748,7872.996748,1,voc,236189752,236189902,150,spec2/voc/Bl122_236189752.jpg,Bl122,2
9161.572057,9161.671057,1,voc,274847161,274850131,2970,spec2/voc/Bl122_274847161.jpg,Bl122,2
9089.576241,9089.590241,1,voc,272687287,272687707,420,spec2/voc/Bl122_272687287.jpg,Bl122,2
9008.370241,9008.397241,1,voc,270251107,270251917,810,spec2/voc/Bl122_270251107.jpg,Bl122,2
9037.555241,9037.558241,1,voc,271126657,271126747,90,spec2/voc/Bl122_271126657.jpg,Bl122,2
8928.124773,8928.132773,1,voc,267843743,267843983,240,spec2/voc/Bl122_267843743.jpg,Bl122,2
13817.943617,13818.035617,1,voc,414538308,414541068,2760,spec2/voc/Bl122_414538308.jpg,Bl122,2
13162.013891,13162.024891,1,voc,394860416,394860746,330,spec2/voc/Bl122_394860416.jpg,Bl122,2
11146.123955,11146.310955,1,voc,334383718,334389328,5610,spec2/voc/Bl122_334383718.jpg,Bl122,2
3893.204652,3893.209652,1,voc,116796139,116796289,150,spec2/voc/Bl122_116796139.jpg,Bl122,2
9044.872241,9044.892241,1,voc,271346167,271346767,600,spec2/voc/Bl122_271346167.jpg,Bl122,2
14842.839682,14842.885682,1,voc,445285190,445286570,1380,spec2/voc/Bl122_445285190.jpg,Bl122,2
3855.959415,3855.965415,1,voc,115678782,115678962,180,spec2/voc/Bl122_115678782.jpg,Bl122,2
9094.102241,9094.153241,1,voc,272823067,272824597,1530,spec2/voc/Bl122_272823067.jpg,Bl122,2
9056.650241,9056.690241,1,voc,271699507,271700707,1200,spec2/voc/Bl122_271699507.jpg,Bl122,2
3859.646367,3860.025367,1,voc,115789391,115800761,11370,spec2/voc/Bl122_115789391.jpg,Bl122,2
3862.124367,3862.142367,1,voc,115863731,115864271,540,spec2/voc/Bl122_115863731.jpg,Bl122,2
7823.029748,7823.034748,1,voc,234690892,234691042,150,spec2/voc/Bl122_234690892.jpg,Bl122,2
5933.313256,5933.418256,1,voc,177999397,178002547,3150,spec2/voc/Bl122_177999397.jpg,Bl122,2
5989.159256,5989.194256,1,voc,179674777,179675827,1050,spec2/voc/Bl122_179674777.jpg,Bl122,2
11196.49818,11196.53318,1,voc,335894945,335895995,1050,spec2/voc/Bl122_335894945.jpg,Bl122,2
3842.424415,3842.428415,1,voc,115272732,115272852,120,spec2/voc/Bl122_115272732.jpg,Bl122,2
13763.236895,13763.437895,1,voc,412897106,412903136,6030,spec2/voc/Bl122_412897106.jpg,Bl122,2
7984.065748,7984.071748,1,voc,239521972,239522152,180,spec2/voc/Bl122_239521972.jpg,Bl122,2
6114.060706,6114.069706,1,voc,183421821,183422091,270,spec2/voc/Bl122_183421821.jpg,Bl122,2
14837.641682,14837.718682,1,voc,445129250,445131560,2310,spec2/voc/Bl122_445129250.jpg,Bl122,2
7984.448748,7984.454748,1,voc,239533462,239533642,180,spec2/voc/Bl122_239533462.jpg,Bl122,2
3824.122649,3824.138649,1,voc,114723679,114724159,480,spec2/voc/Bl122_114723679.jpg,Bl122,2
6012.329533,6012.332533,1,voc,180369885,180369975,90,spec2/voc/Bl122_180369885.jpg,Bl122,2
3808.708649,3808.723649,1,voc,114261259,114261709,450,spec2/voc/Bl122_114261259.jpg,Bl122,2
7984.269748,7984.292748,1,voc,239528092,239528782,690,spec2/voc/Bl122_239528092.jpg,Bl122,2
13966.469352,13966.480352,1,voc,418994080,418994410,330,spec2/voc/Bl122_418994080.jpg,Bl122,2
5941.964256,5941.972256,1,voc,178258927,178259167,240,spec2/voc/Bl122_178258927.jpg,Bl122,2
10862.452845,10862.602845,1,voc,325873585,325878085,4500,spec2/voc/Bl122_325873585.jpg,Bl122,2
8945.918967,8946.074967,1,voc,268377569,268382249,4680,spec2/voc/Bl122_268377569.jpg,Bl122,2
6040.698065,6040.704065,1,voc,181220941,181221121,180,spec2/voc/Bl122_181220941.jpg,Bl122,2
5991.770256,5991.827256,1,voc,179753107,179754817,1710,spec2/voc/Bl122_179753107.jpg,Bl122,2
7908.516748,7908.559748,1,voc,237255502,237256792,1290,spec2/voc/Bl122_237255502.jpg,Bl122,2
14154.349825,14154.355825,1,voc,424630494,424630674,180,spec2/voc/Bl122_424630494.jpg,Bl122,2
13999.964512,13999.971512,1,voc,419998935,419999145,210,spec2/voc/Bl122_419998935.jpg,Bl122,2
6119.039706,6119.067706,1,voc,183571191,183572031,840,spec2/voc/Bl122_183571191.jpg,Bl122,2
6171.021327,6171.031327,1,voc,185130639,185130939,300,spec2/voc/Bl122_185130639.jpg,Bl122,2
3843.988415,3843.997415,1,voc,115319652,115319922,270,spec2/voc/Bl122_115319652.jpg,Bl122,2
8997.450241,8997.456241,1,voc,269923507,269923687,180,spec2/voc/Bl122_269923507.jpg,Bl122,2
7807.573748,7807.578748,1,voc,234227212,234227362,150,spec2/voc/Bl122_234227212.jpg,Bl122,2
5996.888256,5996.890256,1,voc,179906647,179906707,60,spec2/voc/Bl122_179906647.jpg,Bl122,2
10932.768807,10932.811807,1,voc,327983064,327984354,1290,spec2/voc/Bl122_327983064.jpg,Bl122,2
6104.292706,6104.325706,1,voc,183128781,183129771,990,spec2/voc/Bl122_183128781.jpg,Bl122,2
7884.916748,7884.919748,1,voc,236547502,236547592,90,spec2/voc/Bl122_236547502.jpg,Bl122,2
3817.952649,3818.147649,1,voc,114538579,114544429,5850,spec2/voc/Bl122_114538579.jpg,Bl122,2
8013.014748,8013.017748,1,voc,240390442,240390532,90,spec2/voc/Bl122_240390442.jpg,Bl122,2
5960.052256,5960.070256,1,voc,178801567,178802107,540,spec2/voc/Bl122_178801567.jpg,Bl122,2
9114.411184,9114.413184,1,voc,273432335,273432395,60,spec2/voc/Bl122_273432335.jpg,Bl122,2
9150.614842,9150.700842,1,voc,274518445,274521025,2580,spec2/voc/Bl122_274518445.jpg,Bl122,2
7844.074748,7844.119748,1,voc,235322242,235323592,1350,spec2/voc/Bl122_235322242.jpg,Bl122,2
13601.029736,13601.081736,1,voc,408030892,408032452,1560,spec2/voc/Bl122_408030892.jpg,Bl122,2
9080.314241,9080.317241,1,voc,272409427,272409517,90,spec2/voc/Bl122_272409427.jpg,Bl122,2
7964.485748,7964.489748,1,voc,238934572,238934692,120,spec2/voc/Bl122_238934572.jpg,Bl122,2
12670.500513,12670.572513,1,voc,380115015,380117175,2160,spec2/voc/Bl122_380115015.jpg,Bl122,2
13660.277334,13660.281334,1,voc,409808320,409808440,120,spec2/voc/Bl122_409808320.jpg,Bl122,2
3805.633649,3805.641649,1,voc,114169009,114169249,240,spec2/voc/Bl122_114169009.jpg,Bl122,2
13815.509617,13815.556617,1,voc,414465288,414466698,1410,spec2/voc/Bl122_414465288.jpg,Bl122,2
8923.981773,8923.986773,1,voc,267719453,267719603,150,spec2/voc/Bl122_267719453.jpg,Bl122,2
8017.101748,8017.104748,1,voc,240513052,240513142,90,spec2/voc/Bl122_240513052.jpg,Bl122,2
7976.356748,7976.363748,1,voc,239290702,239290912,210,spec2/voc/Bl122_239290702.jpg,Bl122,2
10908.110825,10908.155825,1,voc,327243324,327244674,1350,spec2/voc/Bl122_327243324.jpg,Bl122,2
6191.631327,6191.883327,1,voc,185748939,185756499,7560,spec2/voc/Bl122_185748939.jpg,Bl122,2
6107.964706,6107.985706,1,voc,183238941,183239571,630,spec2/voc/Bl122_183238941.jpg,Bl122,2
9087.271241,9087.361241,1,voc,272618137,272620837,2700,spec2/voc/Bl122_272618137.jpg,Bl122,2
3861.826367,3861.870367,1,voc,115854791,115856111,1320,spec2/voc/Bl122_115854791.jpg,Bl122,2
11150.41418,11150.62418,1,voc,334512425,334518725,6300,spec2/voc/Bl122_334512425.jpg,Bl122,2
6059.624705,6059.627705,1,voc,181788741,181788831,90,spec2/voc/Bl122_181788741.jpg,Bl122,2
7860.603748,7860.606748,1,voc,235818112,235818202,90,spec2/voc/Bl122_235818112.jpg,Bl122,2
13999.031512,13999.099512,1,voc,419970945,419972985,2040,spec2/voc/Bl122_419970945.jpg,Bl122,2
7909.018748,7909.023748,1,voc,237270562,237270712,150,spec2/voc/Bl122_237270562.jpg,Bl122,2
11153.84218,11153.87718,1,voc,334615265,334616315,1050,spec2/voc/Bl122_334615265.jpg,Bl122,2
6065.295705,6065.359705,1,voc,181958871,181960791,1920,spec2/voc/Bl122_181958871.jpg,Bl122,2
7860.924748,7860.942748,1,voc,235827742,235828282,540,spec2/voc/Bl122_235827742.jpg,Bl122,2
13176.089701,13176.154701,1,voc,395282691,395284641,1950,spec2/voc/Bl122_395282691.jpg,Bl122,2
7810.256748,7810.266748,1,voc,234307702,234308002,300,spec2/voc/Bl122_234307702.jpg,Bl122,2
13974.550117,13974.626117,1,voc,419236503,419238783,2280,spec2/voc/Bl122_419236503.jpg,Bl122,2
12828.177025,12828.285025,1,voc,384845310,384848550,3240,spec2/voc/Bl122_384845310.jpg,Bl122,2
9162.429057,9162.514057,1,voc,274872871,274875421,2550,spec2/voc/Bl122_274872871.jpg,Bl122,2
14797.334551,14797.373551,1,voc,443920036,443921206,1170,spec2/voc/Bl122_443920036.jpg,Bl122,2
13966.454352,13966.461352,1,voc,418993630,418993840,210,spec2/voc/Bl122_418993630.jpg,Bl122,2
6022.882533,6023.029533,1,voc,180686475,180690885,4410,spec2/voc/Bl122_180686475.jpg,Bl122,2
3830.554649,3830.575649,1,voc,114916639,114917269,630,spec2/voc/Bl122_114916639.jpg,Bl122,2
6200.379327,6200.506327,1,voc,186011379,186015189,3810,spec2/voc/Bl122_186011379.jpg,Bl122,2
9077.457241,9077.485241,1,voc,272323717,272324557,840,spec2/voc/Bl122_272323717.jpg,Bl122,2
6091.58915,6091.59115,1,voc,182747674,182747734,60,spec2/voc/Bl122_182747674.jpg,Bl122,2
7983.351748,7983.366748,1,voc,239500552,239501002,450,spec2/voc/Bl122_239500552.jpg,Bl122,2
7781.112748,7781.128748,1,voc,233433382,233433862,480,spec2/voc/Bl122_233433382.jpg,Bl122,2
7962.692748,7962.719748,1,voc,238880782,238881592,810,spec2/voc/Bl122_238880782.jpg,Bl122,2
10910.293807,10910.296807,1,voc,327308814,327308904,90,spec2/voc/Bl122_327308814.jpg,Bl122,2
10954.955807,10954.994807,1,voc,328648674,328649844,1170,spec2/voc/Bl122_328648674.jpg,Bl122,2
6036.845533,6036.875533,1,voc,181105365,181106265,900,spec2/voc/Bl122_181105365.jpg,Bl122,2
6052.7172,6052.7962,1,voc,181581516,181583886,2370,spec2/voc/Bl122_181581516.jpg,Bl122,2
11867.530011,11867.582011,1,voc,356025900,356027460,1560,spec2/voc/Bl122_356025900.jpg,Bl122,2
6181.839327,6182.013327,1,voc,185455179,185460399,5220,spec2/voc/Bl122_185455179.jpg,Bl122,2
6155.418349,6155.420349,1,voc,184662550,184662610,60,spec2/voc/Bl122_184662550.jpg,Bl122,2
6062.926705,6062.984705,1,voc,181887801,181889541,1740,spec2/voc/Bl122_181887801.jpg,Bl122,2
6098.37315,6098.38215,1,voc,182951194,182951464,270,spec2/voc/Bl122_182951194.jpg,Bl122,2
7810.151748,7810.153748,1,voc,234304552,234304612,60,spec2/voc/Bl122_234304552.jpg,Bl122,2
11892.33234,11892.33934,1,voc,356769970,356770180,210,spec2/voc/Bl122_356769970.jpg,Bl122,2
5998.207256,5998.345256,1,voc,179946217,179950357,4140,spec2/voc/Bl122_179946217.jpg,Bl122,2
11185.01418,11185.07218,1,voc,335550425,335552165,1740,spec2/voc/Bl122_335550425.jpg,Bl122,2
14709.177469,14709.190469,1,voc,441275324,441275714,390,spec2/voc/Bl122_441275324.jpg,Bl122,2
7832.138748,7832.144748,1,voc,234964162,234964342,180,spec2/voc/Bl122_234964162.jpg,Bl122,2
7817.817748,7817.834748,1,voc,234534532,234535042,510,spec2/voc/Bl122_234534532.jpg,Bl122,2
10916.265807,10916.270807,1,voc,327487974,327488124,150,spec2/voc/Bl122_327487974.jpg,Bl122,2
6073.024705,6073.026705,1,voc,182190741,182190801,60,spec2/voc/Bl122_182190741.jpg,Bl122,2
8208.711882,8208.763882,1,voc,246261356,246262916,1560,spec2/voc/Bl122_246261356.jpg,Bl122,2
9080.373241,9080.529241,1,voc,272411197,272415877,4680,spec2/voc/Bl122_272411197.jpg,Bl122,2
5941.852256,5941.871256,1,voc,178255567,178256137,570,spec2/voc/Bl122_178255567.jpg,Bl122,2
11160.05818,11160.13218,1,voc,334801745,334803965,2220,spec2/voc/Bl122_334801745.jpg,Bl122,2
3843.842415,3843.844415,1,voc,115315272,115315332,60,spec2/voc/Bl122_115315272.jpg,Bl122,2
8911.727773,8911.845773,1,voc,267351833,267355373,3540,spec2/voc/Bl122_267351833.jpg,Bl122,2
8026.671748,8026.675748,1,voc,240800152,240800272,120,spec2/voc/Bl122_240800152.jpg,Bl122,2
14836.330682,14836.394682,1,voc,445089920,445091840,1920,spec2/voc/Bl122_445089920.jpg,Bl122,2
9010.699241,9010.712241,1,voc,270320977,270321367,390,spec2/voc/Bl122_270320977.jpg,Bl122,2
6029.184533,6029.207533,1,voc,180875535,180876225,690,spec2/voc/Bl122_180875535.jpg,Bl122,2
13999.024512,13999.029512,1,voc,419970735,419970885,150,spec2/voc/Bl122_419970735.jpg,Bl122,2
13589.509236,13589.517236,1,voc,407685277,407685517,240,spec2/voc/Bl122_407685277.jpg,Bl122,2
8019.894748,8019.897748,1,voc,240596842,240596932,90,spec2/voc/Bl122_240596842.jpg,Bl122,2
11192.54418,11192.68418,1,voc,335776325,335780525,4200,spec2/voc/Bl122_335776325.jpg,Bl122,2
6134.211293,6134.221293,1,voc,184026338,184026638,300,spec2/voc/Bl122_184026338.jpg,Bl122,2
6190.593327,6190.599327,1,voc,185717799,185717979,180,spec2/voc/Bl122_185717799.jpg,Bl122,2
3841.605415,3841.639415,1,voc,115248162,115249182,1020,spec2/voc/Bl122_115248162.jpg,Bl122,2
9065.617241,9065.621241,1,voc,271968517,271968637,120,spec2/voc/Bl122_271968517.jpg,Bl122,2
13175.051701,13175.073701,1,voc,395251551,395252211,660,spec2/voc/Bl122_395251551.jpg,Bl122,2
5980.883256,5980.912256,1,voc,179426497,179427367,870,spec2/voc/Bl122_179426497.jpg,Bl122,2
14816.013551,14816.371551,1,voc,444480406,444491146,10740,spec2/voc/Bl122_444480406.jpg,Bl122,2
14335.167707,14335.236707,1,voc,430055031,430057101,2070,spec2/voc/Bl122_430055031.jpg,Bl122,2
7975.263748,7975.287748,1,voc,239257912,239258632,720,spec2/voc/Bl122_239257912.jpg,Bl122,2
6078.486705,6078.492705,1,voc,182354601,182354781,180,spec2/voc/Bl122_182354601.jpg,Bl122,2
6228.531295,6228.561295,1,voc,186855938,186856838,900,spec2/voc/Bl122_186855938.jpg,Bl122,2
8997.712241,8997.720241,1,voc,269931367,269931607,240,spec2/voc/Bl122_269931367.jpg,Bl122,2
7998.589748,7998.599748,1,voc,239957692,239957992,300,spec2/voc/Bl122_239957692.jpg,Bl122,2
9013.534241,9013.555241,1,voc,270406027,270406657,630,spec2/voc/Bl122_270406027.jpg,Bl122,2
6043.7952,6043.9782,1,voc,181313856,181319346,5490,spec2/voc/Bl122_181313856.jpg,Bl122,2
9128.606981,9128.621981,1,voc,273858209,273858659,450,spec2/voc/Bl122_273858209.jpg,Bl122,2
6200.866327,6200.907327,1,voc,186025989,186027219,1230,spec2/voc/Bl122_186025989.jpg,Bl122,2
8917.908773,8917.915773,1,voc,267537263,267537473,210,spec2/voc/Bl122_267537263.jpg,Bl122,2
3815.699649,3815.708649,1,voc,114470989,114471259,270,spec2/voc/Bl122_114470989.jpg,Bl122,2
11965.244491,11965.250491,1,voc,358957334,358957514,180,spec2/voc/Bl122_358957334.jpg,Bl122,2
8980.400025,8980.413025,1,voc,269412000,269412390,390,spec2/voc/Bl122_269412000.jpg,Bl122,2
5974.947256,5974.950256,1,voc,179248417,179248507,90,spec2/voc/Bl122_179248417.jpg,Bl122,2
13570.168052,13570.173052,1,voc,407105041,407105191,150,spec2/voc/Bl122_407105041.jpg,Bl122,2
6028.592533,6028.611533,1,voc,180857775,180858345,570,spec2/voc/Bl122_180857775.jpg,Bl122,2
14765.171366,14765.393366,1,voc,442955140,442961800,6660,spec2/voc/Bl122_442955140.jpg,Bl122,2
10907.477825,10907.627825,1,voc,327224334,327228834,4500,spec2/voc/Bl122_327224334.jpg,Bl122,2
11170.97718,11170.98018,1,voc,335129315,335129405,90,spec2/voc/Bl122_335129315.jpg,Bl122,2
8019.563748,8019.567748,1,voc,240586912,240587032,120,spec2/voc/Bl122_240586912.jpg,Bl122,2
13582.370236,13582.388236,1,voc,407471107,407471647,540,spec2/voc/Bl122_407471107.jpg,Bl122,2
3867.737367,3867.802367,1,voc,116032121,116034071,1950,spec2/voc/Bl122_116032121.jpg,Bl122,2
5998.514256,5998.520256,1,voc,179955427,179955607,180,spec2/voc/Bl122_179955427.jpg,Bl122,2
10922.845807,10922.859807,1,voc,327685374,327685794,420,spec2/voc/Bl122_327685374.jpg,Bl122,2
14784.251465,14784.255465,1,voc,443527543,443527663,120,spec2/voc/Bl122_443527543.jpg,Bl122,2
7975.536748,7975.539748,1,voc,239266102,239266192,90,spec2/voc/Bl122_239266102.jpg,Bl122,2
3829.881649,3830.187649,1,voc,114896449,114905629,9180,spec2/voc/Bl122_114896449.jpg,Bl122,2
9128.335981,9128.340981,1,voc,273850079,273850229,150,spec2/voc/Bl122_273850079.jpg,Bl122,2
10936.623807,10936.652807,1,voc,328098714,328099584,870,spec2/voc/Bl122_328098714.jpg,Bl122,2
11207.745894,11207.774894,1,voc,336232376,336233246,870,spec2/voc/Bl122_336232376.jpg,Bl122,2
13221.144389,13221.165389,1,voc,396634331,396634961,630,spec2/voc/Bl122_396634331.jpg,Bl122,2
6183.041327,6183.087327,1,voc,185491239,185492619,1380,spec2/voc/Bl122_185491239.jpg,Bl122,2
6170.169327,6170.207327,1,voc,185105079,185106219,1140,spec2/voc/Bl122_185105079.jpg,Bl122,2
5982.742256,5982.755256,1,voc,179482267,179482657,390,spec2/voc/Bl122_179482267.jpg,Bl122,2
9097.119241,9097.125241,1,voc,272913577,272913757,180,spec2/voc/Bl122_272913577.jpg,Bl122,2
5980.954256,5980.984256,1,voc,179428627,179429527,900,spec2/voc/Bl122_179428627.jpg,Bl122,2
5956.441256,5956.466256,1,voc,178693237,178693987,750,spec2/voc/Bl122_178693237.jpg,Bl122,2
3897.436652,3897.441652,1,voc,116923099,116923249,150,spec2/voc/Bl122_116923099.jpg,Bl122,2
13999.936512,13999.938512,1,voc,419998095,419998155,60,spec2/voc/Bl122_419998095.jpg,Bl122,2
8018.046748,8018.058748,1,voc,240541402,240541762,360,spec2/voc/Bl122_240541402.jpg,Bl122,2
9065.852241,9065.856241,1,voc,271975567,271975687,120,spec2/voc/Bl122_271975567.jpg,Bl122,2
6204.756327,6204.768327,1,voc,186142689,186143049,360,spec2/voc/Bl122_186142689.jpg,Bl122,2
10923.432807,10923.481807,1,voc,327702984,327704454,1470,spec2/voc/Bl122_327702984.jpg,Bl122,2
8365.263015,8365.298015,1,voc,250957890,250958940,1050,spec2/voc/Bl122_250957890.jpg,Bl122,2
6204.084327,6204.152327,1,voc,186122529,186124569,2040,spec2/voc/Bl122_186122529.jpg,Bl122,2
3891.569652,3891.789652,1,voc,116747089,116753689,6600,spec2/voc/Bl122_116747089.jpg,Bl122,2
5946.938256,5946.945256,1,voc,178408147,178408357,210,spec2/voc/Bl122_178408147.jpg,Bl122,2
7985.315748,7985.321748,1,voc,239559472,239559652,180,spec2/voc/Bl122_239559472.jpg,Bl122,2
6077.141705,6077.231705,1,voc,182314251,182316951,2700,spec2/voc/Bl122_182314251.jpg,Bl122,2
9123.527182,9123.549182,1,voc,273705815,273706475,660,spec2/voc/Bl122_273705815.jpg,Bl122,2
5931.553256,5931.582256,1,voc,177946597,177947467,870,spec2/voc/Bl122_177946597.jpg,Bl122,2
10906.807825,10906.821825,1,voc,327204234,327204654,420,spec2/voc/Bl122_327204234.jpg,Bl122,2
3860.681367,3860.819367,1,voc,115820441,115824581,4140,spec2/voc/Bl122_115820441.jpg,Bl122,2
7978.085748,7978.090748,1,voc,239342572,239342722,150,spec2/voc/Bl122_239342572.jpg,Bl122,2
3820.237649,3820.264649,1,voc,114607129,114607939,810,spec2/voc/Bl122_114607129.jpg,Bl122,2
13212.026389,13212.031389,1,voc,396360791,396360941,150,spec2/voc/Bl122_396360791.jpg,Bl122,2
7937.959748,7937.965748,1,voc,238138792,238138972,180,spec2/voc/Bl122_238138792.jpg,Bl122,2
5978.428256,5978.459256,1,voc,179352847,179353777,930,spec2/voc/Bl122_179352847.jpg,Bl122,2
9067.458241,9067.461241,1,voc,272023747,272023837,90,spec2/voc/Bl122_272023747.jpg,Bl122,2
7884.865748,7884.885748,1,voc,236545972,236546572,600,spec2/voc/Bl122_236545972.jpg,Bl122,2
6147.075349,6147.085349,1,voc,184412260,184412560,300,spec2/voc/Bl122_184412260.jpg,Bl122,2
8968.053712,8968.061712,1,voc,269041611,269041851,240,spec2/voc/Bl122_269041611.jpg,Bl122,2
3842.457415,3842.466415,1,voc,115273722,115273992,270,spec2/voc/Bl122_115273722.jpg,Bl122,2
3808.984649,3808.992649,1,voc,114269539,114269779,240,spec2/voc/Bl122_114269539.jpg,Bl122,2
5972.454256,5972.499256,1,voc,179173627,179174977,1350,spec2/voc/Bl122_179173627.jpg,Bl122,2
6081.185511,6081.199511,1,voc,182435565,182435985,420,spec2/voc/Bl122_182435565.jpg,Bl122,2
7781.023748,7781.044748,1,voc,233430712,233431342,630,spec2/voc/Bl122_233430712.jpg,Bl122,2
14824.835551,14824.840551,1,voc,444745066,444745216,150,spec2/voc/Bl122_444745066.jpg,Bl122,2
6157.268349,6157.367349,1,voc,184718050,184721020,2970,spec2/voc/Bl122_184718050.jpg,Bl122,2
14804.069551,14804.263551,1,voc,444122086,444127906,5820,spec2/voc/Bl122_444122086.jpg,Bl122,2
9031.888241,9032.062241,1,voc,270956647,270961867,5220,spec2/voc/Bl122_270956647.jpg,Bl122,2
9055.077241,9055.087241,1,voc,271652317,271652617,300,spec2/voc/Bl122_271652317.jpg,Bl122,2
9044.281241,9044.351241,1,voc,271328437,271330537,2100,spec2/voc/Bl122_271328437.jpg,Bl122,2
13998.620512,13998.634512,1,voc,419958615,419959035,420,spec2/voc/Bl122_419958615.jpg,Bl122,2
7911.597748,7911.606748,1,voc,237347932,237348202,270,spec2/voc/Bl122_237347932.jpg,Bl122,2
9060.557241,9060.590241,1,voc,271816717,271817707,990,spec2/voc/Bl122_271816717.jpg,Bl122,2
11159.73018,11159.78918,1,voc,334791905,334793675,1770,spec2/voc/Bl122_334791905.jpg,Bl122,2
3797.052649,3797.154649,1,voc,113911579,113914639,3060,spec2/voc/Bl122_113911579.jpg,Bl122,2
7931.996115,7932.025115,1,voc,237959883,237960753,870,spec2/voc/Bl122_237959883.jpg,Bl122,2
6109.127706,6109.130706,1,voc,183273831,183273921,90,spec2/voc/Bl122_183273831.jpg,Bl122,2
9016.299241,9016.463241,1,voc,270488977,270493897,4920,spec2/voc/Bl122_270488977.jpg,Bl122,2
7986.491748,7986.493748,1,voc,239594752,239594812,60,spec2/voc/Bl122_239594752.jpg,Bl122,2
6040.973065,6041.167065,1,voc,181229191,181235011,5820,spec2/voc/Bl122_181229191.jpg,Bl122,2
7908.121748,7908.145748,1,voc,237243652,237244372,720,spec2/voc/Bl122_237243652.jpg,Bl122,2
7947.681748,7947.684748,1,voc,238430452,238430542,90,spec2/voc/Bl122_238430452.jpg,Bl122,2
10958.743807,10958.774807,1,voc,328762314,328763244,930,spec2/voc/Bl122_328762314.jpg,Bl122,2
12670.985513,12671.055513,1,voc,380129565,380131665,2100,spec2/voc/Bl122_380129565.jpg,Bl122,2
7910.249748,7910.253748,1,voc,237307492,237307612,120,spec2/voc/Bl122_237307492.jpg,Bl122,2
10923.032807,10923.053807,1,voc,327690984,327691614,630,spec2/voc/Bl122_327690984.jpg,Bl122,2
3895.504652,3895.765652,1,voc,116865139,116872969,7830,spec2/voc/Bl122_116865139.jpg,Bl122,2
11851.98373,11852.15173,1,voc,355559511,355564551,5040,spec2/voc/Bl122_355559511.jpg,Bl122,2
11131.949005,11131.961005,1,voc,333958470,333958830,360,spec2/voc/Bl122_333958470.jpg,Bl122,2
13966.483352,13966.519352,1,voc,418994500,418995580,1080,spec2/voc/Bl122_418994500.jpg,Bl122,2
14732.392703,14732.397703,1,voc,441971781,441971931,150,spec2/voc/Bl122_441971781.jpg,Bl122,2
13823.03422,13823.09022,1,voc,414691026,414692706,1680,spec2/voc/Bl122_414691026.jpg,Bl122,2
6099.22415,6099.29915,1,voc,182976724,182978974,2250,spec2/voc/Bl122_182976724.jpg,Bl122,2
14817.423551,14817.447551,1,voc,444522706,444523426,720,spec2/voc/Bl122_444522706.jpg,Bl122,2
8026.789748,8026.796748,1,voc,240803692,240803902,210,spec2/voc/Bl122_240803692.jpg,Bl122,2
13160.889891,13160.908891,1,voc,394826696,394827266,570,spec2/voc/Bl122_394826696.jpg,Bl122,2
6138.529293,6138.539293,1,voc,184155878,184156178,300,spec2/voc/Bl122_184155878.jpg,Bl122,2
8912.830773,8912.837773,1,voc,267384923,267385133,210,spec2/voc/Bl122_267384923.jpg,Bl122,2
9137.628255,9137.633255,1,voc,274128847,274128997,150,spec2/voc/Bl122_274128847.jpg,Bl122,2
10941.545807,10941.571807,1,voc,328246374,328247154,780,spec2/voc/Bl122_328246374.jpg,Bl122,2
8018.588748,8018.599748,1,voc,240557662,240557992,330,spec2/voc/Bl122_240557662.jpg,Bl122,2
8983.723025,8983.945025,1,voc,269511690,269518350,6660,spec2/voc/Bl122_269511690.jpg,Bl122,2
6027.282533,6027.304533,1,voc,180818475,180819135,660,spec2/voc/Bl122_180818475.jpg,Bl122,2
11149.00918,11149.03518,1,voc,334470275,334471055,780,spec2/voc/Bl122_334470275.jpg,Bl122,2
7895.038748,7895.040748,1,voc,236851162,236851222,60,spec2/voc/Bl122_236851162.jpg,Bl122,2
9054.252241,9054.255241,1,voc,271627567,271627657,90,spec2/voc/Bl122_271627567.jpg,Bl122,2
10936.794807,10936.879807,1,voc,328103844,328106394,2550,spec2/voc/Bl122_328103844.jpg,Bl122,2
3804.368649,3804.463649,1,voc,114131059,114133909,2850,spec2/voc/Bl122_114131059.jpg,Bl122,2
8040.984748,8041.011748,1,voc,241229542,241230352,810,spec2/voc/Bl122_241229542.jpg,Bl122,2
9174.450287,9174.459287,1,voc,275233508,275233778,270,spec2/voc/Bl122_275233508.jpg,Bl122,2
8021.355748,8021.359748,1,voc,240640672,240640792,120,spec2/voc/Bl122_240640672.jpg,Bl122,2
7803.333748,7803.335748,1,voc,234100012,234100072,60,spec2/voc/Bl122_234100012.jpg,Bl122,2
5972.638256,5972.653256,1,voc,179179147,179179597,450,spec2/voc/Bl122_179179147.jpg,Bl122,2
13977.474117,13977.702117,1,voc,419324223,419331063,6840,spec2/voc/Bl122_419324223.jpg,Bl122,2
8921.612773,8921.622773,1,voc,267648383,267648683,300,spec2/voc/Bl122_267648383.jpg,Bl122,2
13565.317867,13565.499867,1,voc,406959536,406964996,5460,spec2/voc/Bl122_406959536.jpg,Bl122,2
3810.204649,3810.207649,1,voc,114306139,114306229,90,spec2/voc/Bl122_114306139.jpg,Bl122,2
5997.435256,5997.440256,1,voc,179923057,179923207,150,spec2/voc/Bl122_179923057.jpg,Bl122,2
5941.994256,5942.023256,1,voc,178259827,178260697,870,spec2/voc/Bl122_178259827.jpg,Bl122,2
6099.56415,6099.57515,1,voc,182986924,182987254,330,spec2/voc/Bl122_182986924.jpg,Bl122,2
7852.198748,7852.201748,1,voc,235565962,235566052,90,spec2/voc/Bl122_235565962.jpg,Bl122,2
14790.830551,14790.833551,1,voc,443724916,443725006,90,spec2/voc/Bl122_443724916.jpg,Bl122,2
10932.499807,10932.502807,1,voc,327974994,327975084,90,spec2/voc/Bl122_327974994.jpg,Bl122,2
11134.114005,11134.154005,1,voc,334023420,334024620,1200,spec2/voc/Bl122_334023420.jpg,Bl122,2
10939.675807,10939.746807,1,voc,328190274,328192404,2130,spec2/voc/Bl122_328190274.jpg,Bl122,2
13819.048617,13819.223617,1,voc,414571458,414576708,5250,spec2/voc/Bl122_414571458.jpg,Bl122,2
14793.889551,14793.990551,1,voc,443816686,443819716,3030,spec2/voc/Bl122_443816686.jpg,Bl122,2
9066.640241,9067.021241,1,voc,271999207,272010637,11430,spec2/voc/Bl122_271999207.jpg,Bl122,2
3863.306367,3863.721367,1,voc,115899191,115911641,12450,spec2/voc/Bl122_115899191.jpg,Bl122,2
13188.156662,13188.161662,1,voc,395644699,395644849,150,spec2/voc/Bl122_395644699.jpg,Bl122,2
13995.556091,13995.752091,1,voc,419866682,419872562,5880,spec2/voc/Bl122_419866682.jpg,Bl122,2
5953.178256,5953.186256,1,voc,178595347,178595587,240,spec2/voc/Bl122_178595347.jpg,Bl122,2
6024.927533,6024.952533,1,voc,180747825,180748575,750,spec2/voc/Bl122_180747825.jpg,Bl122,2
8938.296967,8938.353967,1,voc,268148909,268150619,1710,spec2/voc/Bl122_268148909.jpg,Bl122,2
7846.581748,7846.589748,1,voc,235397452,235397692,240,spec2/voc/Bl122_235397452.jpg,Bl122,2
13244.293606,13244.332606,1,voc,397328808,397329978,1170,spec2/voc/Bl122_397328808.jpg,Bl122,2
9014.921241,9014.957241,1,voc,270447637,270448717,1080,spec2/voc/Bl122_270447637.jpg,Bl122,2
9055.739241,9055.761241,1,voc,271672177,271672837,660,spec2/voc/Bl122_271672177.jpg,Bl122,2
14801.074551,14801.091551,1,voc,444032236,444032746,510,spec2/voc/Bl122_444032236.jpg,Bl122,2
12638.587849,12638.644849,1,voc,379157635,379159345,1710,spec2/voc/Bl122_379157635.jpg,Bl122,2
3818.477649,3818.480649,1,voc,114554329,114554419,90,spec2/voc/Bl122_114554329.jpg,Bl122,2
9026.111241,9026.394241,1,voc,270783337,270791827,8490,spec2/voc/Bl122_270783337.jpg,Bl122,2
6022.176533,6022.209533,1,voc,180665295,180666285,990,spec2/voc/Bl122_180665295.jpg,Bl122,2
6147.709349,6147.881349,1,voc,184431280,184436440,5160,spec2/voc/Bl122_184431280.jpg,Bl122,2
13930.025797,13930.029797,1,voc,417900773,417900893,120,spec2/voc/Bl122_417900773.jpg,Bl122,2
7787.891748,7787.895748,1,voc,233636752,233636872,120,spec2/voc/Bl122_233636752.jpg,Bl122,2
9097.951241,9097.994241,1,voc,272938537,272939827,1290,spec2/voc/Bl122_272938537.jpg,Bl122,2
8951.286967,8951.296967,1,voc,268538609,268538909,300,spec2/voc/Bl122_268538609.jpg,Bl122,2
11157.03818,11157.04418,1,voc,334711145,334711325,180,spec2/voc/Bl122_334711145.jpg,Bl122,2
7807.914748,7807.926748,1,voc,234237442,234237802,360,spec2/voc/Bl122_234237442.jpg,Bl122,2
5969.655256,5969.657256,1,voc,179089657,179089717,60,spec2/voc/Bl122_179089657.jpg,Bl122,2
9039.352241,9039.498241,1,voc,271180567,271184947,4380,spec2/voc/Bl122_271180567.jpg,Bl122,2
11182.83318,11182.98518,1,voc,335484995,335489555,4560,spec2/voc/Bl122_335484995.jpg,Bl122,2
6091.89515,6092.10015,1,voc,182756854,182763004,6150,spec2/voc/Bl122_182756854.jpg,Bl122,2
11168.17718,11168.19618,1,voc,335045315,335045885,570,spec2/voc/Bl122_335045315.jpg,Bl122,2
8915.128773,8915.228773,1,voc,267453863,267456863,3000,spec2/voc/Bl122_267453863.jpg,Bl122,2
10908.034825,10908.085825,1,voc,327241044,327242574,1530,spec2/voc/Bl122_327241044.jpg,Bl122,2
10942.830807,10942.841807,1,voc,328284924,328285254,330,spec2/voc/Bl122_328284924.jpg,Bl122,2
11198.11718,11198.16818,1,voc,335943515,335945045,1530,spec2/voc/Bl122_335943515.jpg,Bl122,2
13163.456891,13163.517891,1,voc,394903706,394905536,1830,spec2/voc/Bl122_394903706.jpg,Bl122,2
8996.630241,8996.729241,1,voc,269898907,269901877,2970,spec2/voc/Bl122_269898907.jpg,Bl122,2
9050.588241,9050.670241,1,voc,271517647,271520107,2460,spec2/voc/Bl122_271517647.jpg,Bl122,2
8107.208516,8107.395516,1,voc,243216255,243221865,5610,spec2/voc/Bl122_243216255.jpg,Bl122,2
7991.838748,7991.899748,1,voc,239755162,239756992,1830,spec2/voc/Bl122_239755162.jpg,Bl122,2
10935.782807,10935.806807,1,voc,328073484,328074204,720,spec2/voc/Bl122_328073484.jpg,Bl122,2
5979.276256,5979.315256,1,voc,179378287,179379457,1170,spec2/voc/Bl122_179378287.jpg,Bl122,2
7923.896748,7923.903748,1,voc,237716902,237717112,210,spec2/voc/Bl122_237716902.jpg,Bl122,2
9098.874241,9098.899241,1,voc,272966227,272966977,750,spec2/voc/Bl122_272966227.jpg,Bl122,2
9022.526241,9022.655241,1,voc,270675787,270679657,3870,spec2/voc/Bl122_270675787.jpg,Bl122,2
7999.051748,7999.062748,1,voc,239971552,239971882,330,spec2/voc/Bl122_239971552.jpg,Bl122,2
11156.71318,11156.74718,1,voc,334701395,334702415,1020,spec2/voc/Bl122_334701395.jpg,Bl122,2
5984.837256,5984.866256,1,voc,179545117,179545987,870,spec2/voc/Bl122_179545117.jpg,Bl122,2
10953.932807,10953.963807,1,voc,328617984,328618914,930,spec2/voc/Bl122_328617984.jpg,Bl122,2
5941.601256,5941.614256,1,voc,178248037,178248427,390,spec2/voc/Bl122_178248037.jpg,Bl122,2
10960.340807,10960.382807,1,voc,328810224,328811484,1260,spec2/voc/Bl122_328810224.jpg,Bl122,2
9132.202981,9132.323981,1,voc,273966089,273969719,3630,spec2/voc/Bl122_273966089.jpg,Bl122,2
9092.818241,9092.851241,1,voc,272784547,272785537,990,spec2/voc/Bl122_272784547.jpg,Bl122,2
6192.344327,6192.391327,1,voc,185770329,185771739,1410,spec2/voc/Bl122_185770329.jpg,Bl122,2
9026.698241,9026.703241,1,voc,270800947,270801097,150,spec2/voc/Bl122_270800947.jpg,Bl122,2
14172.810581,14172.976581,1,voc,425184317,425189297,4980,spec2/voc/Bl122_425184317.jpg,Bl122,2
6059.907705,6059.917705,1,voc,181797231,181797531,300,spec2/voc/Bl122_181797231.jpg,Bl122,2
11160.50218,11160.50418,1,voc,334815065,334815125,60,spec2/voc/Bl122_334815065.jpg,Bl122,2
9149.165842,9149.179842,1,voc,274474975,274475395,420,spec2/voc/Bl122_274474975.jpg,Bl122,2
6029.499533,6029.505533,1,voc,180884985,180885165,180,spec2/voc/Bl122_180884985.jpg,Bl122,2
5997.420256,5997.425256,1,voc,179922607,179922757,150,spec2/voc/Bl122_179922607.jpg,Bl122,2
6202.550327,6202.554327,1,voc,186076509,186076629,120,spec2/voc/Bl122_186076509.jpg,Bl122,2
6126.695706,6126.835706,1,voc,183800871,183805071,4200,spec2/voc/Bl122_183800871.jpg,Bl122,2
5954.304256,5954.314256,1,voc,178629127,178629427,300,spec2/voc/Bl122_178629127.jpg,Bl122,2
3851.474415,3851.664415,1,voc,115544232,115549932,5700,spec2/voc/Bl122_115544232.jpg,Bl122,2
9074.923241,9075.145241,1,voc,272247697,272254357,6660,spec2/voc/Bl122_272247697.jpg,Bl122,2
12639.278849,12639.356849,1,voc,379178365,379180705,2340,spec2/voc/Bl122_379178365.jpg,Bl122,2
14386.605576,14386.752576,1,voc,431598167,431602577,4410,spec2/voc/Bl122_431598167.jpg,Bl122,2
14609.144615,14609.303615,1,voc,438274338,438279108,4770,spec2/voc/Bl122_438274338.jpg,Bl122,2
11171.04518,11171.04718,1,voc,335131355,335131415,60,spec2/voc/Bl122_335131355.jpg,Bl122,2
14810.424551,14810.426551,1,voc,444312736,444312796,60,spec2/voc/Bl122_444312736.jpg,Bl122,2
6060.423705,6060.554705,1,voc,181812711,181816641,3930,spec2/voc/Bl122_181812711.jpg,Bl122,2
11985.538611,11985.554611,1,voc,359566158,359566638,480,spec2/voc/Bl122_359566158.jpg,Bl122,2
8966.302712,8966.459712,1,voc,268989081,268993791,4710,spec2/voc/Bl122_268989081.jpg,Bl122,2
10915.853807,10915.856807,1,voc,327475614,327475704,90,spec2/voc/Bl122_327475614.jpg,Bl122,2
8968.073712,8968.406712,1,voc,269042211,269052201,9990,spec2/voc/Bl122_269042211.jpg,Bl122,2
12638.721849,12638.777849,1,voc,379161655,379163335,1680,spec2/voc/Bl122_379161655.jpg,Bl122,2
14838.749682,14838.797682,1,voc,445162490,445163930,1440,spec2/voc/Bl122_445162490.jpg,Bl122,2
6059.616705,6059.622705,1,voc,181788501,181788681,180,spec2/voc/Bl122_181788501.jpg,Bl122,2
13582.042236,13582.046236,1,voc,407461267,407461387,120,spec2/voc/Bl122_407461267.jpg,Bl122,2
9062.339241,9062.661241,1,voc,271870177,271879837,9660,spec2/voc/Bl122_271870177.jpg,Bl122,2
7962.814748,7962.900748,1,voc,238884442,238887022,2580,spec2/voc/Bl122_238884442.jpg,Bl122,2
8982.384025,8982.390025,1,voc,269471520,269471700,180,spec2/voc/Bl122_269471520.jpg,Bl122,2
8925.716773,8925.750773,1,voc,267771503,267772523,1020,spec2/voc/Bl122_267771503.jpg,Bl122,2
7895.046748,7895.067748,1,voc,236851402,236852032,630,spec2/voc/Bl122_236851402.jpg,Bl122,2
7937.809748,7937.818748,1,voc,238134292,238134562,270,spec2/voc/Bl122_238134292.jpg,Bl122,2
7860.438748,7860.443748,1,voc,235813162,235813312,150,spec2/voc/Bl122_235813162.jpg,Bl122,2
8911.271773,8911.440773,1,voc,267338153,267343223,5070,spec2/voc/Bl122_267338153.jpg,Bl122,2
3807.882649,3807.896649,1,voc,114236479,114236899,420,spec2/voc/Bl122_114236479.jpg,Bl122,2
10952.461807,10952.495807,1,voc,328573854,328574874,1020,spec2/voc/Bl122_328573854.jpg,Bl122,2
9028.193241,9028.242241,1,voc,270845797,270847267,1470,spec2/voc/Bl122_270845797.jpg,Bl122,2
7876.353748,7876.371748,1,voc,236290612,236291152,540,spec2/voc/Bl122_236290612.jpg,Bl122,2
13213.957389,13213.965389,1,voc,396418721,396418961,240,spec2/voc/Bl122_396418721.jpg,Bl122,2
6204.577327,6204.585327,1,voc,186137319,186137559,240,spec2/voc/Bl122_186137319.jpg,Bl122,2
11953.615309,11953.618309,1,voc,358608459,358608549,90,spec2/voc/Bl122_358608459.jpg,Bl122,2
11209.044894,11209.048894,1,voc,336271346,336271466,120,spec2/voc/Bl122_336271346.jpg,Bl122,2
11130.824005,11130.834005,1,voc,333924720,333925020,300,spec2/voc/Bl122_333924720.jpg,Bl122,2
10938.383807,10938.386807,1,voc,328151514,328151604,90,spec2/voc/Bl122_328151514.jpg,Bl122,2
9041.555241,9041.698241,1,voc,271246657,271250947,4290,spec2/voc/Bl122_271246657.jpg,Bl122,2
9076.976241,9077.174241,1,voc,272309287,272315227,5940,spec2/voc/Bl122_272309287.jpg,Bl122,2
6170.598327,6170.610327,1,voc,185117949,185118309,360,spec2/voc/Bl122_185117949.jpg,Bl122,2
13199.506389,13199.541389,1,voc,395985191,395986241,1050,spec2/voc/Bl122_395985191.jpg,Bl122,2
6185.731327,6185.814327,1,voc,185571939,185574429,2490,spec2/voc/Bl122_185571939.jpg,Bl122,2
6042.7342,6042.7492,1,voc,181282026,181282476,450,spec2/voc/Bl122_181282026.jpg,Bl122,2
10948.055807,10948.078807,1,voc,328441674,328442364,690,spec2/voc/Bl122_328441674.jpg,Bl122,2
14821.849551,14822.000551,1,voc,444655486,444660016,4530,spec2/voc/Bl122_444655486.jpg,Bl122,2
5988.330256,5988.356256,1,voc,179649907,179650687,780,spec2/voc/Bl122_179649907.jpg,Bl122,2
11207.431894,11207.534894,1,voc,336222956,336226046,3090,spec2/voc/Bl122_336222956.jpg,Bl122,2
6186.970327,6187.332327,1,voc,185609109,185619969,10860,spec2/voc/Bl122_185609109.jpg,Bl122,2
13814.681617,13814.769617,1,voc,414440448,414443088,2640,spec2/voc/Bl122_414440448.jpg,Bl122,2
5948.354256,5948.368256,1,voc,178450627,178451047,420,spec2/voc/Bl122_178450627.jpg,Bl122,2
10920.049807,10920.054807,1,voc,327601494,327601644,150,spec2/voc/Bl122_327601494.jpg,Bl122,2
13203.463389,13203.494389,1,voc,396103901,396104831,930,spec2/voc/Bl122_396103901.jpg,Bl122,2
11195.34018,11195.39418,1,voc,335860205,335861825,1620,spec2/voc/Bl122_335860205.jpg,Bl122,2
14822.732551,14822.863551,1,voc,444681976,444685906,3930,spec2/voc/Bl122_444681976.jpg,Bl122,2
9075.270241,9075.436241,1,voc,272258107,272263087,4980,spec2/voc/Bl122_272258107.jpg,Bl122,2
3893.802652,3893.832652,1,voc,116814079,116814979,900,spec2/voc/Bl122_116814079.jpg,Bl122,2
13554.247188,13554.257188,1,voc,406627415,406627715,300,spec2/voc/Bl122_406627415.jpg,Bl122,2
3856.061415,3856.066415,1,voc,115681842,115681992,150,spec2/voc/Bl122_115681842.jpg,Bl122,2
8005.437748,8005.469748,1,voc,240163132,240164092,960,spec2/voc/Bl122_240163132.jpg,Bl122,2
10923.219807,10923.226807,1,voc,327696594,327696804,210,spec2/voc/Bl122_327696594.jpg,Bl122,2
3806.506649,3806.533649,1,voc,114195199,114196009,810,spec2/voc/Bl122_114195199.jpg,Bl122,2
6092.95015,6092.99515,1,voc,182788504,182789854,1350,spec2/voc/Bl122_182788504.jpg,Bl122,2
12678.08317,12678.16417,1,voc,380342495,380344925,2430,spec2/voc/Bl122_380342495.jpg,Bl122,2
11204.304894,11204.365894,1,voc,336129146,336130976,1830,spec2/voc/Bl122_336129146.jpg,Bl122,2
5944.601256,5944.610256,1,voc,178338037,178338307,270,spec2/voc/Bl122_178338037.jpg,Bl122,2
11159.71418,11159.72218,1,voc,334791425,334791665,240,spec2/voc/Bl122_334791425.jpg,Bl122,2
11141.776955,11141.787955,1,voc,334253308,334253638,330,spec2/voc/Bl122_334253308.jpg,Bl122,2
6085.11515,6085.12015,1,voc,182553454,182553604,150,spec2/voc/Bl122_182553454.jpg,Bl122,2
10943.701807,10943.735807,1,voc,328311054,328312074,1020,spec2/voc/Bl122_328311054.jpg,Bl122,2
13193.835662,13193.980662,1,voc,395815069,395819419,4350,spec2/voc/Bl122_395815069.jpg,Bl122,2
14157.019825,14157.085825,1,voc,424710594,424712574,1980,spec2/voc/Bl122_424710594.jpg,Bl122,2
8956.017967,8956.020967,1,voc,268680539,268680629,90,spec2/voc/Bl122_268680539.jpg,Bl122,2
13828.787664,13828.789664,1,voc,414863629,414863689,60,spec2/voc/Bl122_414863629.jpg,Bl122,2
13244.593606,13244.703606,1,voc,397337808,397341108,3300,spec2/voc/Bl122_397337808.jpg,Bl122,2
11209.815894,11209.861894,1,voc,336294476,336295856,1380,spec2/voc/Bl122_336294476.jpg,Bl122,2
5290.608068,5290.818068,1,voc,158718242,158724542,6300,spec2/voc/Bl122_158718242.jpg,Bl122,2
13207.789389,13207.798389,1,voc,396233681,396233951,270,spec2/voc/Bl122_396233681.jpg,Bl122,2
14018.818714,14019.057714,1,voc,420564561,420571731,7170,spec2/voc/Bl122_420564561.jpg,Bl122,2
6174.037327,6174.181327,1,voc,185221119,185225439,4320,spec2/voc/Bl122_185221119.jpg,Bl122,2
11201.513894,11201.558894,1,voc,336045416,336046766,1350,spec2/voc/Bl122_336045416.jpg,Bl122,2
6099.83115,6099.84015,1,voc,182994934,182995204,270,spec2/voc/Bl122_182994934.jpg,Bl122,2
13967.080352,13967.101352,1,voc,419012410,419013040,630,spec2/voc/Bl122_419012410.jpg,Bl122,2
5969.808256,5969.812256,1,voc,179094247,179094367,120,spec2/voc/Bl122_179094247.jpg,Bl122,2
3851.706415,3851.713415,1,voc,115551192,115551402,210,spec2/voc/Bl122_115551192.jpg,Bl122,2
6071.687705,6071.730705,1,voc,182150631,182151921,1290,spec2/voc/Bl122_182150631.jpg,Bl122,2
8027.751748,8027.758748,1,voc,240832552,240832762,210,spec2/voc/Bl122_240832552.jpg,Bl122,2
5944.415256,5944.440256,1,voc,178332457,178333207,750,spec2/voc/Bl122_178332457.jpg,Bl122,2
13244.423606,13244.427606,1,voc,397332708,397332828,120,spec2/voc/Bl122_397332708.jpg,Bl122,2
14820.012551,14820.019551,1,voc,444600376,444600586,210,spec2/voc/Bl122_444600376.jpg,Bl122,2
7906.800748,7906.805748,1,voc,237204022,237204172,150,spec2/voc/Bl122_237204022.jpg,Bl122,2
13818.767617,13818.780617,1,voc,414563028,414563418,390,spec2/voc/Bl122_414563028.jpg,Bl122,2
6178.635327,6178.668327,1,voc,185359059,185360049,990,spec2/voc/Bl122_185359059.jpg,Bl122,2
6105.916706,6105.974706,1,voc,183177501,183179241,1740,spec2/voc/Bl122_183177501.jpg,Bl122,2
14149.595855,14149.628855,1,voc,424487875,424488865,990,spec2/voc/Bl122_424487875.jpg,Bl122,2
11874.548708,11874.554708,1,voc,356236461,356236641,180,spec2/voc/Bl122_356236461.jpg,Bl122,2
8984.854025,8984.865025,1,voc,269545620,269545950,330,spec2/voc/Bl122_269545620.jpg,Bl122,2
6067.925705,6067.929705,1,voc,182037771,182037891,120,spec2/voc/Bl122_182037771.jpg,Bl122,2
9076.417241,9076.446241,1,voc,272292517,272293387,870,spec2/voc/Bl122_272292517.jpg,Bl122,2
6092.49015,6092.49215,1,voc,182774704,182774764,60,spec2/voc/Bl122_182774704.jpg,Bl122,2
8026.430748,8026.433748,1,voc,240792922,240793012,90,spec2/voc/Bl122_240792922.jpg,Bl122,2
14791.311551,14791.367551,1,voc,443739346,443741026,1680,spec2/voc/Bl122_443739346.jpg,Bl122,2
11210.732894,11210.783894,1,voc,336321986,336323516,1530,spec2/voc/Bl122_336321986.jpg,Bl122,2
13732.769497,13732.777497,1,voc,411983084,411983324,240,spec2/voc/Bl122_411983084.jpg,Bl122,2
7976.345748,7976.354748,1,voc,239290372,239290642,270,spec2/voc/Bl122_239290372.jpg,Bl122,2
6222.019295,6222.025295,1,voc,186660578,186660758,180,spec2/voc/Bl122_186660578.jpg,Bl122,2
14841.245682,14841.334682,1,voc,445237370,445240040,2670,spec2/voc/Bl122_445237370.jpg,Bl122,2
7841.738748,7841.751748,1,voc,235252162,235252552,390,spec2/voc/Bl122_235252162.jpg,Bl122,2
7950.659748,7950.664748,1,voc,238519792,238519942,150,spec2/voc/Bl122_238519792.jpg,Bl122,2
8016.822748,8016.827748,1,voc,240504682,240504832,150,spec2/voc/Bl122_240504682.jpg,Bl122,2
6049.7092,6049.7362,1,voc,181491276,181492086,810,spec2/voc/Bl122_181491276.jpg,Bl122,2
14841.607682,14841.613682,1,voc,445248230,445248410,180,spec2/voc/Bl122_445248230.jpg,Bl122,2
6097.82615,6097.84515,1,voc,182934784,182935354,570,spec2/voc/Bl122_182934784.jpg,Bl122,2
6099.71015,6099.71315,1,voc,182991304,182991394,90,spec2/voc/Bl122_182991304.jpg,Bl122,2
6016.306533,6016.334533,1,voc,180489195,180490035,840,spec2/voc/Bl122_180489195.jpg,Bl122,2
3824.629649,3824.655649,1,voc,114738889,114739669,780,spec2/voc/Bl122_114738889.jpg,Bl122,2
14813.360551,14813.611551,1,voc,444400816,444408346,7530,spec2/voc/Bl122_444400816.jpg,Bl122,2
7911.795748,7911.826748,1,voc,237353872,237354802,930,spec2/voc/Bl122_237353872.jpg,Bl122,2
6130.932293,6130.969293,1,voc,183927968,183929078,1110,spec2/voc/Bl122_183927968.jpg,Bl122,2
5937.613256,5937.626256,1,voc,178128397,178128787,390,spec2/voc/Bl122_178128397.jpg,Bl122,2
6204.477327,6204.495327,1,voc,186134319,186134859,540,spec2/voc/Bl122_186134319.jpg,Bl122,2
10945.536807,10945.575807,1,voc,328366104,328367274,1170,spec2/voc/Bl122_328366104.jpg,Bl122,2
8980.542025,8980.576025,1,voc,269416260,269417280,1020,spec2/voc/Bl122_269416260.jpg,Bl122,2
10932.334807,10932.338807,1,voc,327970044,327970164,120,spec2/voc/Bl122_327970044.jpg,Bl122,2
5983.412256,5983.417256,1,voc,179502367,179502517,150,spec2/voc/Bl122_179502367.jpg,Bl122,2
11154.48518,11154.48718,1,voc,334634555,334634615,60,spec2/voc/Bl122_334634555.jpg,Bl122,2
14794.688551,14794.766551,1,voc,443840656,443842996,2340,spec2/voc/Bl122_443840656.jpg,Bl122,2
10925.343807,10925.471807,1,voc,327760314,327764154,3840,spec2/voc/Bl122_327760314.jpg,Bl122,2
5979.393256,5979.432256,1,voc,179381797,179382967,1170,spec2/voc/Bl122_179381797.jpg,Bl122,2
11170.88018,11170.95118,1,voc,335126405,335128535,2130,spec2/voc/Bl122_335126405.jpg,Bl122,2
9022.015241,9022.277241,1,voc,270660457,270668317,7860,spec2/voc/Bl122_270660457.jpg,Bl122,2
8923.915773,8923.978773,1,voc,267717473,267719363,1890,spec2/voc/Bl122_267717473.jpg,Bl122,2
3802.285649,3802.621649,1,voc,114068569,114078649,10080,spec2/voc/Bl122_114068569.jpg,Bl122,2
13790.23146,13790.29246,1,voc,413706943,413708773,1830,spec2/voc/Bl122_413706943.jpg,Bl122,2
7948.970748,7948.983748,1,voc,238469122,238469512,390,spec2/voc/Bl122_238469122.jpg,Bl122,2
14709.881469,14709.891469,1,voc,441296444,441296744,300,spec2/voc/Bl122_441296444.jpg,Bl122,2
6095.12615,6095.26515,1,voc,182853784,182857954,4170,spec2/voc/Bl122_182853784.jpg,Bl122,2
6189.766327,6189.803327,1,voc,185692989,185694099,1110,spec2/voc/Bl122_185692989.jpg,Bl122,2
5974.651256,5974.657256,1,voc,179239537,179239717,180,spec2/voc/Bl122_179239537.jpg,Bl122,2
13213.481389,13213.516389,1,voc,396404441,396405491,1050,spec2/voc/Bl122_396404441.jpg,Bl122,2
6109.988706,6110.013706,1,voc,183299661,183300411,750,spec2/voc/Bl122_183299661.jpg,Bl122,2
5969.713256,5969.727256,1,voc,179091397,179091817,420,spec2/voc/Bl122_179091397.jpg,Bl122,2
8016.670748,8016.680748,1,voc,240500122,240500422,300,spec2/voc/Bl122_240500122.jpg,Bl122,2
8928.277773,8928.303773,1,voc,267848333,267849113,780,spec2/voc/Bl122_267848333.jpg,Bl122,2
6091.50715,6091.51015,1,voc,182745214,182745304,90,spec2/voc/Bl122_182745214.jpg,Bl122,2
11161.03818,11161.06418,1,voc,334831145,334831925,780,spec2/voc/Bl122_334831145.jpg,Bl122,2
10909.097807,10909.113807,1,voc,327272934,327273414,480,spec2/voc/Bl122_327272934.jpg,Bl122,2
6089.82215,6090.01315,1,voc,182694664,182700394,5730,spec2/voc/Bl122_182694664.jpg,Bl122,2
13219.429389,13219.442389,1,voc,396582881,396583271,390,spec2/voc/Bl122_396582881.jpg,Bl122,2
7846.908748,7846.990748,1,voc,235407262,235409722,2460,spec2/voc/Bl122_235407262.jpg,Bl122,2
10924.399807,10924.632807,1,voc,327731994,327738984,6990,spec2/voc/Bl122_327731994.jpg,Bl122,2
10937.468807,10937.483807,1,voc,328124064,328124514,450,spec2/voc/Bl122_328124064.jpg,Bl122,2
14819.881551,14819.888551,1,voc,444596446,444596656,210,spec2/voc/Bl122_444596446.jpg,Bl122,2
6132.712293,6132.740293,1,voc,183981368,183982208,840,spec2/voc/Bl122_183981368.jpg,Bl122,2
14843.955682,14843.982682,1,voc,445318670,445319480,810,spec2/voc/Bl122_445318670.jpg,Bl122,2
6045.8992,6045.9072,1,voc,181376976,181377216,240,spec2/voc/Bl122_181376976.jpg,Bl122,2
9013.903241,9014.076241,1,voc,270417097,270422287,5190,spec2/voc/Bl122_270417097.jpg,Bl122,2
13583.839236,13583.850236,1,voc,407515177,407515507,330,spec2/voc/Bl122_407515177.jpg,Bl122,2
8023.039748,8023.075748,1,voc,240691192,240692272,1080,spec2/voc/Bl122_240691192.jpg,Bl122,2
8920.411773,8920.414773,1,voc,267612353,267612443,90,spec2/voc/Bl122_267612353.jpg,Bl122,2
8981.023025,8981.080025,1,voc,269430690,269432400,1710,spec2/voc/Bl122_269430690.jpg,Bl122,2
6180.561327,6180.686327,1,voc,185416839,185420589,3750,spec2/voc/Bl122_185416839.jpg,Bl122,2
6183.897327,6184.070327,1,voc,185516919,185522109,5190,spec2/voc/Bl122_185516919.jpg,Bl122,2
10925.533807,10925.559807,1,voc,327766014,327766794,780,spec2/voc/Bl122_327766014.jpg,Bl122,2
3813.296649,3813.305649,1,voc,114398899,114399169,270,spec2/voc/Bl122_114398899.jpg,Bl122,2
5957.238256,5957.256256,1,voc,178717147,178717687,540,spec2/voc/Bl122_178717147.jpg,Bl122,2
5940.923256,5941.163256,1,voc,178227697,178234897,7200,spec2/voc/Bl122_178227697.jpg,Bl122,2
13745.058896,13745.193896,1,voc,412351766,412355816,4050,spec2/voc/Bl122_412351766.jpg,Bl122,2
5971.887256,5971.891256,1,voc,179156617,179156737,120,spec2/voc/Bl122_179156617.jpg,Bl122,2
13193.261662,13193.278662,1,voc,395797849,395798359,510,spec2/voc/Bl122_395797849.jpg,Bl122,2
13589.365236,13589.377236,1,voc,407680957,407681317,360,spec2/voc/Bl122_407680957.jpg,Bl122,2
7957.638748,7957.644748,1,voc,238729162,238729342,180,spec2/voc/Bl122_238729162.jpg,Bl122,2
8926.504773,8926.527773,1,voc,267795143,267795833,690,spec2/voc/Bl122_267795143.jpg,Bl122,2
7789.370748,7789.392748,1,voc,233681122,233681782,660,spec2/voc/Bl122_233681122.jpg,Bl122,2
5972.972256,5973.239256,1,voc,179189167,179197177,8010,spec2/voc/Bl122_179189167.jpg,Bl122,2
11126.881005,11126.920005,1,voc,333806430,333807600,1170,spec2/voc/Bl122_333806430.jpg,Bl122,2
6058.842705,6058.865705,1,voc,181765281,181765971,690,spec2/voc/Bl122_181765281.jpg,Bl122,2
5983.579256,5983.581256,1,voc,179507377,179507437,60,spec2/voc/Bl122_179507377.jpg,Bl122,2
14841.776682,14841.807682,1,voc,445253300,445254230,930,spec2/voc/Bl122_445253300.jpg,Bl122,2
7974.531748,7974.540748,1,voc,239235952,239236222,270,spec2/voc/Bl122_239235952.jpg,Bl122,2
8995.781241,8995.843241,1,voc,269873437,269875297,1860,spec2/voc/Bl122_269873437.jpg,Bl122,2
3820.295649,3820.298649,1,voc,114608869,114608959,90,spec2/voc/Bl122_114608869.jpg,Bl122,2
5963.974256,5964.171256,1,voc,178919227,178925137,5910,spec2/voc/Bl122_178919227.jpg,Bl122,2
13603.401736,13603.404736,1,voc,408102052,408102142,90,spec2/voc/Bl122_408102052.jpg,Bl122,2
8981.216025,8981.273025,1,voc,269436480,269438190,1710,spec2/voc/Bl122_269436480.jpg,Bl122,2
13206.555389,13206.560389,1,voc,396196661,396196811,150,spec2/voc/Bl122_396196661.jpg,Bl122,2
7962.727748,7962.743748,1,voc,238881832,238882312,480,spec2/voc/Bl122_238881832.jpg,Bl122,2
5929.432364,5929.559364,1,voc,177882970,177886780,3810,spec2/voc/Bl122_177882970.jpg,Bl122,2
7961.602748,7961.608748,1,voc,238848082,238848262,180,spec2/voc/Bl122_238848082.jpg,Bl122,2
11131.933005,11131.937005,1,voc,333957990,333958110,120,spec2/voc/Bl122_333957990.jpg,Bl122,2
7984.476748,7984.520748,1,voc,239534302,239535622,1320,spec2/voc/Bl122_239534302.jpg,Bl122,2
10880.631609,10880.696609,1,voc,326418948,326420898,1950,spec2/voc/Bl122_326418948.jpg,Bl122,2
10920.786807,10920.792807,1,voc,327623604,327623784,180,spec2/voc/Bl122_327623604.jpg,Bl122,2
3802.889649,3803.088649,1,voc,114086689,114092659,5970,spec2/voc/Bl122_114086689.jpg,Bl122,2
7842.820748,7842.829748,1,voc,235284622,235284892,270,spec2/voc/Bl122_235284622.jpg,Bl122,2
13601.015736,13601.025736,1,voc,408030472,408030772,300,spec2/voc/Bl122_408030472.jpg,Bl122,2
10906.792825,10906.803825,1,voc,327203784,327204114,330,spec2/voc/Bl122_327203784.jpg,Bl122,2
6041.172065,6041.200065,1,voc,181235161,181236001,840,spec2/voc/Bl122_181235161.jpg,Bl122,2
9063.149241,9063.159241,1,voc,271894477,271894777,300,spec2/voc/Bl122_271894477.jpg,Bl122,2
3852.324415,3852.338415,1,voc,115569732,115570152,420,spec2/voc/Bl122_115569732.jpg,Bl122,2
10945.152807,10945.158807,1,voc,328354584,328354764,180,spec2/voc/Bl122_328354584.jpg,Bl122,2
10957.974807,10957.981807,1,voc,328739244,328739454,210,spec2/voc/Bl122_328739244.jpg,Bl122,2
3824.189649,3824.202649,1,voc,114725689,114726079,390,spec2/voc/Bl122_114725689.jpg,Bl122,2
14155.611825,14155.822825,1,voc,424668354,424674684,6330,spec2/voc/Bl122_424668354.jpg,Bl122,2
9096.514241,9096.629241,1,voc,272895427,272898877,3450,spec2/voc/Bl122_272895427.jpg,Bl122,2
3794.681649,3794.684649,1,voc,113840449,113840539,90,spec2/voc/Bl122_113840449.jpg,Bl122,2
5988.006256,5988.024256,1,voc,179640187,179640727,540,spec2/voc/Bl122_179640187.jpg,Bl122,2
3799.670649,3799.673649,1,voc,113990119,113990209,90,spec2/voc/Bl122_113990119.jpg,Bl122,2
12639.473849,12639.478849,1,voc,379184215,379184365,150,spec2/voc/Bl122_379184215.jpg,Bl122,2
8334.728758,8334.772758,1,voc,250041862,250043182,1320,spec2/voc/Bl122_250041862.jpg,Bl122,2
11130.776005,11130.818005,1,voc,333923280,333924540,1260,spec2/voc/Bl122_333923280.jpg,Bl122,2
10905.319825,10905.321825,1,voc,327159594,327159654,60,spec2/voc/Bl122_327159594.jpg,Bl122,2
7927.809748,7927.830748,1,voc,237834292,237834922,630,spec2/voc/Bl122_237834292.jpg,Bl122,2
11100.274855,11100.408855,1,voc,333008245,333012265,4020,spec2/voc/Bl122_333008245.jpg,Bl122,2
7886.614748,7886.711748,1,voc,236598442,236601352,2910,spec2/voc/Bl122_236598442.jpg,Bl122,2
6047.7612,6047.7862,1,voc,181432836,181433586,750,spec2/voc/Bl122_181432836.jpg,Bl122,2
6171.706327,6171.723327,1,voc,185151189,185151699,510,spec2/voc/Bl122_185151189.jpg,Bl122,2
8018.999748,8019.006748,1,voc,240569992,240570202,210,spec2/voc/Bl122_240569992.jpg,Bl122,2
10935.609807,10935.613807,1,voc,328068294,328068414,120,spec2/voc/Bl122_328068294.jpg,Bl122,2
14824.030551,14824.044551,1,voc,444720916,444721336,420,spec2/voc/Bl122_444720916.jpg,Bl122,2
6097.36815,6097.45615,1,voc,182921044,182923684,2640,spec2/voc/Bl122_182921044.jpg,Bl122,2
14822.156551,14822.230551,1,voc,444664696,444666916,2220,spec2/voc/Bl122_444664696.jpg,Bl122,2
6093.32915,6093.34815,1,voc,182799874,182800444,570,spec2/voc/Bl122_182799874.jpg,Bl122,2
10854.437233,10854.515233,1,voc,325633116,325635456,2340,spec2/voc/Bl122_325633116.jpg,Bl122,2
14027.648104,14027.658104,1,voc,420829443,420829743,300,spec2/voc/Bl122_420829443.jpg,Bl122,2
9028.663241,9028.682241,1,voc,270859897,270860467,570,spec2/voc/Bl122_270859897.jpg,Bl122,2
8923.287773,8923.352773,1,voc,267698633,267700583,1950,spec2/voc/Bl122_267698633.jpg,Bl122,2
6029.018533,6029.118533,1,voc,180870555,180873555,3000,spec2/voc/Bl122_180870555.jpg,Bl122,2
9088.228241,9088.487241,1,voc,272646847,272654617,7770,spec2/voc/Bl122_272646847.jpg,Bl122,2
6028.134533,6028.143533,1,voc,180844035,180844305,270,spec2/voc/Bl122_180844035.jpg,Bl122,2
13961.004384,13961.016384,1,voc,418830131,418830491,360,spec2/voc/Bl122_418830131.jpg,Bl122,2
13599.456736,13599.705736,1,voc,407983702,407991172,7470,spec2/voc/Bl122_407983702.jpg,Bl122,2
3811.852649,3811.863649,1,voc,114355579,114355909,330,spec2/voc/Bl122_114355579.jpg,Bl122,2
13206.502389,13206.541389,1,voc,396195071,396196241,1170,spec2/voc/Bl122_396195071.jpg,Bl122,2
11033.001132,11033.039132,1,voc,330990033,330991173,1140,spec2/voc/Bl122_330990033.jpg,Bl122,2
11977.315797,11977.336797,1,voc,359319473,359320103,630,spec2/voc/Bl122_359319473.jpg,Bl122,2
13958.000384,13958.014384,1,voc,418740011,418740431,420,spec2/voc/Bl122_418740011.jpg,Bl122,2
6035.930533,6035.932533,1,voc,181077915,181077975,60,spec2/voc/Bl122_181077915.jpg,Bl122,2
11193.93418,11193.96918,1,voc,335818025,335819075,1050,spec2/voc/Bl122_335818025.jpg,Bl122,2
9020.972241,9020.981241,1,voc,270629167,270629437,270,spec2/voc/Bl122_270629167.jpg,Bl122,2
5967.513256,5967.664256,1,voc,179025397,179029927,4530,spec2/voc/Bl122_179025397.jpg,Bl122,2
11851.87973,11851.88173,1,voc,355556391,355556451,60,spec2/voc/Bl122_355556391.jpg,Bl122,2
14824.855551,14824.879551,1,voc,444745666,444746386,720,spec2/voc/Bl122_444745666.jpg,Bl122,2
10919.952807,10919.966807,1,voc,327598584,327599004,420,spec2/voc/Bl122_327598584.jpg,Bl122,2
5962.360256,5962.629256,1,voc,178870807,178878877,8070,spec2/voc/Bl122_178870807.jpg,Bl122,2
13564.315867,13564.370867,1,voc,406929476,406931126,1650,spec2/voc/Bl122_406929476.jpg,Bl122,2
3806.971649,3806.976649,1,voc,114209149,114209299,150,spec2/voc/Bl122_114209149.jpg,Bl122,2
6060.717705,6060.877705,1,voc,181821531,181826331,4800,spec2/voc/Bl122_181821531.jpg,Bl122,2
13952.457911,13952.462911,1,voc,418573737,418573887,150,spec2/voc/Bl122_418573737.jpg,Bl122,2
6043.3952,6043.3972,1,voc,181301856,181301916,60,spec2/voc/Bl122_181301856.jpg,Bl122,2
6011.048533,6011.054533,1,voc,180331455,180331635,180,spec2/voc/Bl122_180331455.jpg,Bl122,2
3827.880649,3827.899649,1,voc,114836419,114836989,570,spec2/voc/Bl122_114836419.jpg,Bl122,2
9069.696241,9069.726241,1,voc,272090887,272091787,900,spec2/voc/Bl122_272090887.jpg,Bl122,2
6033.856533,6033.863533,1,voc,181015695,181015905,210,spec2/voc/Bl122_181015695.jpg,Bl122,2
7831.310748,7831.314748,1,voc,234939322,234939442,120,spec2/voc/Bl122_234939322.jpg,Bl122,2
14802.018551,14802.041551,1,voc,444060556,444061246,690,spec2/voc/Bl122_444060556.jpg,Bl122,2
14800.922551,14801.032551,1,voc,444027676,444030976,3300,spec2/voc/Bl122_444027676.jpg,Bl122,2
7989.455748,7989.461748,1,voc,239683672,239683852,180,spec2/voc/Bl122_239683672.jpg,Bl122,2
5970.304256,5970.364256,1,voc,179109127,179110927,1800,spec2/voc/Bl122_179109127.jpg,Bl122,2
3818.317649,3818.320649,1,voc,114549529,114549619,90,spec2/voc/Bl122_114549529.jpg,Bl122,2
3806.983649,3807.044649,1,voc,114209509,114211339,1830,spec2/voc/Bl122_114209509.jpg,Bl122,2
8980.815025,8980.823025,1,voc,269424450,269424690,240,spec2/voc/Bl122_269424450.jpg,Bl122,2
3272.268278,3272.272278,1,voc,98168048,98168168,120,spec2/voc/Bl122_98168048.jpg,Bl122,2
11175.55618,11175.62018,1,voc,335266685,335268605,1920,spec2/voc/Bl122_335266685.jpg,Bl122,2
13950.046911,13950.052911,1,voc,418501407,418501587,180,spec2/voc/Bl122_418501407.jpg,Bl122,2
11134.687005,11134.708005,1,voc,334040610,334041240,630,spec2/voc/Bl122_334040610.jpg,Bl122,2
3808.484649,3808.509649,1,voc,114254539,114255289,750,spec2/voc/Bl122_114254539.jpg,Bl122,2
7907.864748,7907.877748,1,voc,237235942,237236332,390,spec2/voc/Bl122_237235942.jpg,Bl122,2
9008.469241,9008.495241,1,voc,270254077,270254857,780,spec2/voc/Bl122_270254077.jpg,Bl122,2
7801.999748,7802.002748,1,voc,234059992,234060082,90,spec2/voc/Bl122_234059992.jpg,Bl122,2
5955.261256,5955.278256,1,voc,178657837,178658347,510,spec2/voc/Bl122_178657837.jpg,Bl122,2
9147.181342,9147.212342,1,voc,274415440,274416370,930,spec2/voc/Bl122_274415440.jpg,Bl122,2
13977.005117,13977.023117,1,voc,419310153,419310693,540,spec2/voc/Bl122_419310153.jpg,Bl122,2
14838.439682,14838.494682,1,voc,445153190,445154840,1650,spec2/voc/Bl122_445153190.jpg,Bl122,2
14809.122551,14809.150551,1,voc,444273676,444274516,840,spec2/voc/Bl122_444273676.jpg,Bl122,2
6030.451533,6030.460533,1,voc,180913545,180913815,270,spec2/voc/Bl122_180913545.jpg,Bl122,2
9010.381241,9010.561241,1,voc,270311437,270316837,5400,spec2/voc/Bl122_270311437.jpg,Bl122,2
10949.671807,10949.675807,1,voc,328490154,328490274,120,spec2/voc/Bl122_328490154.jpg,Bl122,2
6229.151295,6229.213295,1,voc,186874538,186876398,1860,spec2/voc/Bl122_186874538.jpg,Bl122,2
10957.210807,10957.258807,1,voc,328716324,328717764,1440,spec2/voc/Bl122_328716324.jpg,Bl122,2
6109.695706,6109.711706,1,voc,183290871,183291351,480,spec2/voc/Bl122_183290871.jpg,Bl122,2
6225.868295,6225.960295,1,voc,186776048,186778808,2760,spec2/voc/Bl122_186776048.jpg,Bl122,2
9047.833241,9047.837241,1,voc,271434997,271435117,120,spec2/voc/Bl122_271434997.jpg,Bl122,2
8040.776748,8040.791748,1,voc,241223302,241223752,450,spec2/voc/Bl122_241223302.jpg,Bl122,2
7933.307748,7933.311748,1,voc,237999232,237999352,120,spec2/voc/Bl122_237999232.jpg,Bl122,2
11211.434894,11211.459894,1,voc,336343046,336343796,750,spec2/voc/Bl122_336343046.jpg,Bl122,2
10919.492807,10919.529807,1,voc,327584784,327585894,1110,spec2/voc/Bl122_327584784.jpg,Bl122,2
13603.035736,13603.107736,1,voc,408091072,408093232,2160,spec2/voc/Bl122_408091072.jpg,Bl122,2
9005.605241,9005.607241,1,voc,270168157,270168217,60,spec2/voc/Bl122_270168157.jpg,Bl122,2
14132.736913,14132.926913,1,voc,423982107,423987807,5700,spec2/voc/Bl122_423982107.jpg,Bl122,2
8008.701748,8008.705748,1,voc,240261052,240261172,120,spec2/voc/Bl122_240261052.jpg,Bl122,2
11130.086005,11130.188005,1,voc,333902580,333905640,3060,spec2/voc/Bl122_333902580.jpg,Bl122,2
3807.176649,3807.179649,1,voc,114215299,114215389,90,spec2/voc/Bl122_114215299.jpg,Bl122,2
6018.738533,6018.745533,1,voc,180562155,180562365,210,spec2/voc/Bl122_180562155.jpg,Bl122,2
10918.009807,10918.033807,1,voc,327540294,327541014,720,spec2/voc/Bl122_327540294.jpg,Bl122,2
8927.724773,8927.752773,1,voc,267831743,267832583,840,spec2/voc/Bl122_267831743.jpg,Bl122,2
8921.729773,8921.750773,1,voc,267651893,267652523,630,spec2/voc/Bl122_267651893.jpg,Bl122,2
10897.141557,10897.164557,1,voc,326914246,326914936,690,spec2/voc/Bl122_326914246.jpg,Bl122,2
7923.521748,7923.532748,1,voc,237705652,237705982,330,spec2/voc/Bl122_237705652.jpg,Bl122,2
6183.365327,6183.390327,1,voc,185500959,185501709,750,spec2/voc/Bl122_185500959.jpg,Bl122,2
3852.874415,3852.910415,1,voc,115586232,115587312,1080,spec2/voc/Bl122_115586232.jpg,Bl122,2
9059.192241,9059.283241,1,voc,271775767,271778497,2730,spec2/voc/Bl122_271775767.jpg,Bl122,2
9138.678255,9138.682255,1,voc,274160347,274160467,120,spec2/voc/Bl122_274160347.jpg,Bl122,2
3810.387649,3810.397649,1,voc,114311629,114311929,300,spec2/voc/Bl122_114311629.jpg,Bl122,2
9062.987241,9062.989241,1,voc,271889617,271889677,60,spec2/voc/Bl122_271889617.jpg,Bl122,2
6056.724705,6056.736705,1,voc,181701741,181702101,360,spec2/voc/Bl122_181701741.jpg,Bl122,2
9030.214241,9030.224241,1,voc,270906427,270906727,300,spec2/voc/Bl122_270906427.jpg,Bl122,2
7857.531748,7857.537748,1,voc,235725952,235726132,180,spec2/voc/Bl122_235725952.jpg,Bl122,2
7794.051748,7794.071748,1,voc,233821552,233822152,600,spec2/voc/Bl122_233821552.jpg,Bl122,2
5960.832256,5960.956256,1,voc,178824967,178828687,3720,spec2/voc/Bl122_178824967.jpg,Bl122,2
8991.747241,8991.936241,1,voc,269752417,269758087,5670,spec2/voc/Bl122_269752417.jpg,Bl122,2
8031.543748,8031.547748,1,voc,240946312,240946432,120,spec2/voc/Bl122_240946312.jpg,Bl122,2
10862.740845,10862.747845,1,voc,325882225,325882435,210,spec2/voc/Bl122_325882225.jpg,Bl122,2
11142.952955,11142.997955,1,voc,334288588,334289938,1350,spec2/voc/Bl122_334288588.jpg,Bl122,2
7876.853748,7876.889748,1,voc,236305612,236306692,1080,spec2/voc/Bl122_236305612.jpg,Bl122,2
3821.460649,3821.483649,1,voc,114643819,114644509,690,spec2/voc/Bl122_114643819.jpg,Bl122,2
9000.414241,9000.502241,1,voc,270012427,270015067,2640,spec2/voc/Bl122_270012427.jpg,Bl122,2
5979.492256,5979.506256,1,voc,179384767,179385187,420,spec2/voc/Bl122_179384767.jpg,Bl122,2
5958.578256,5958.586256,1,voc,178757347,178757587,240,spec2/voc/Bl122_178757347.jpg,Bl122,2
6168.684327,6168.710327,1,voc,185060529,185061309,780,spec2/voc/Bl122_185060529.jpg,Bl122,2
13957.059384,13957.073384,1,voc,418711781,418712201,420,spec2/voc/Bl122_418711781.jpg,Bl122,2
5941.578256,5941.589256,1,voc,178247347,178247677,330,spec2/voc/Bl122_178247347.jpg,Bl122,2
9146.286342,9146.349342,1,voc,274388590,274390480,1890,spec2/voc/Bl122_274388590.jpg,Bl122,2
7984.736748,7984.744748,1,voc,239542102,239542342,240,spec2/voc/Bl122_239542102.jpg,Bl122,2
13601.658736,13601.706736,1,voc,408049762,408051202,1440,spec2/voc/Bl122_408049762.jpg,Bl122,2
13808.730653,13808.792653,1,voc,414261919,414263779,1860,spec2/voc/Bl122_414261919.jpg,Bl122,2
6121.497706,6121.511706,1,voc,183644931,183645351,420,spec2/voc/Bl122_183644931.jpg,Bl122,2
7949.199748,7949.209748,1,voc,238475992,238476292,300,spec2/voc/Bl122_238475992.jpg,Bl122,2
14838.916682,14838.937682,1,voc,445167500,445168130,630,spec2/voc/Bl122_445167500.jpg,Bl122,2
9068.915241,9069.092241,1,voc,272067457,272072767,5310,spec2/voc/Bl122_272067457.jpg,Bl122,2
7802.657748,7802.667748,1,voc,234079732,234080032,300,spec2/voc/Bl122_234079732.jpg,Bl122,2
13201.885389,13201.901389,1,voc,396056561,396057041,480,spec2/voc/Bl122_396056561.jpg,Bl122,2
6108.084706,6108.145706,1,voc,183242541,183244371,1830,spec2/voc/Bl122_183242541.jpg,Bl122,2
11206.561894,11206.593894,1,voc,336196856,336197816,960,spec2/voc/Bl122_336196856.jpg,Bl122,2
11180.82318,11180.83118,1,voc,335424695,335424935,240,spec2/voc/Bl122_335424695.jpg,Bl122,2
3803.238649,3803.260649,1,voc,114097159,114097819,660,spec2/voc/Bl122_114097159.jpg,Bl122,2
11965.253491,11965.447491,1,voc,358957604,358963424,5820,spec2/voc/Bl122_358957604.jpg,Bl122,2
3799.816649,3799.822649,1,voc,113994499,113994679,180,spec2/voc/Bl122_113994499.jpg,Bl122,2
14783.639465,14783.649465,1,voc,443509183,443509483,300,spec2/voc/Bl122_443509183.jpg,Bl122,2
14491.523169,14491.684169,1,voc,434745695,434750525,4830,spec2/voc/Bl122_434745695.jpg,Bl122,2
6035.302533,6035.315533,1,voc,181059075,181059465,390,spec2/voc/Bl122_181059075.jpg,Bl122,2
14811.199551,14811.408551,1,voc,444335986,444342256,6270,spec2/voc/Bl122_444335986.jpg,Bl122,2
13960.974384,13960.984384,1,voc,418829231,418829531,300,spec2/voc/Bl122_418829231.jpg,Bl122,2
8367.093166,8367.132166,1,voc,251012794,251013964,1170,spec2/voc/Bl122_251012794.jpg,Bl122,2
11155.87318,11155.88218,1,voc,334676195,334676465,270,spec2/voc/Bl122_334676195.jpg,Bl122,2
6023.230533,6023.234533,1,voc,180696915,180697035,120,spec2/voc/Bl122_180696915.jpg,Bl122,2
3841.974415,3841.998415,1,voc,115259232,115259952,720,spec2/voc/Bl122_115259232.jpg,Bl122,2
3897.105652,3897.108652,1,voc,116913169,116913259,90,spec2/voc/Bl122_116913169.jpg,Bl122,2
14820.795551,14820.910551,1,voc,444623866,444627316,3450,spec2/voc/Bl122_444623866.jpg,Bl122,2
11209.474894,11209.520894,1,voc,336284246,336285626,1380,spec2/voc/Bl122_336284246.jpg,Bl122,2
3799.712649,3799.747649,1,voc,113991379,113992429,1050,spec2/voc/Bl122_113991379.jpg,Bl122,2
9071.411241,9071.420241,1,voc,272142337,272142607,270,spec2/voc/Bl122_272142337.jpg,Bl122,2
8980.582025,8980.608025,1,voc,269417460,269418240,780,spec2/voc/Bl122_269417460.jpg,Bl122,2
9022.695241,9022.704241,1,voc,270680857,270681127,270,spec2/voc/Bl122_270680857.jpg,Bl122,2
9026.549241,9026.551241,1,voc,270796477,270796537,60,spec2/voc/Bl122_270796477.jpg,Bl122,2
11164.56218,11164.62618,1,voc,334936865,334938785,1920,spec2/voc/Bl122_334936865.jpg,Bl122,2
7983.943748,7983.952748,1,voc,239518312,239518582,270,spec2/voc/Bl122_239518312.jpg,Bl122,2
10905.676825,10906.012825,1,voc,327170304,327180384,10080,spec2/voc/Bl122_327170304.jpg,Bl122,2
6184.143327,6184.151327,1,voc,185524299,185524539,240,spec2/voc/Bl122_185524299.jpg,Bl122,2
3850.437415,3850.445415,1,voc,115513122,115513362,240,spec2/voc/Bl122_115513122.jpg,Bl122,2
13605.737736,13605.751736,1,voc,408172132,408172552,420,spec2/voc/Bl122_408172132.jpg,Bl122,2
6048.6872,6048.6952,1,voc,181460616,181460856,240,spec2/voc/Bl122_181460616.jpg,Bl122,2
8013.353748,8013.366748,1,voc,240400612,240401002,390,spec2/voc/Bl122_240400612.jpg,Bl122,2
3817.276649,3817.292649,1,voc,114518299,114518779,480,spec2/voc/Bl122_114518299.jpg,Bl122,2
13744.260896,13744.264896,1,voc,412327826,412327946,120,spec2/voc/Bl122_412327826.jpg,Bl122,2
9018.383241,9018.414241,1,voc,270551497,270552427,930,spec2/voc/Bl122_270551497.jpg,Bl122,2
6048.1032,6048.1152,1,voc,181443096,181443456,360,spec2/voc/Bl122_181443096.jpg,Bl122,2
13732.828497,13732.929497,1,voc,411984854,411987884,3030,spec2/voc/Bl122_411984854.jpg,Bl122,2
10957.279807,10957.294807,1,voc,328718394,328718844,450,spec2/voc/Bl122_328718394.jpg,Bl122,2
8346.035566,8346.039566,1,voc,250381066,250381186,120,spec2/voc/Bl122_250381066.jpg,Bl122,2
14369.461363,14369.636363,1,voc,431083840,431089090,5250,spec2/voc/Bl122_431083840.jpg,Bl122,2
9011.220241,9011.470241,1,voc,270336607,270344107,7500,spec2/voc/Bl122_270336607.jpg,Bl122,2
6134.016293,6134.018293,1,voc,184020488,184020548,60,spec2/voc/Bl122_184020488.jpg,Bl122,2
13818.428617,13818.446617,1,voc,414552858,414553398,540,spec2/voc/Bl122_414552858.jpg,Bl122,2
7846.225748,7846.233748,1,voc,235386772,235387012,240,spec2/voc/Bl122_235386772.jpg,Bl122,2
6131.141293,6131.302293,1,voc,183934238,183939068,4830,spec2/voc/Bl122_183934238.jpg,Bl122,2
10926.196807,10926.381807,1,voc,327785904,327791454,5550,spec2/voc/Bl122_327785904.jpg,Bl122,2
9003.144241,9003.154241,1,voc,270094327,270094627,300,spec2/voc/Bl122_270094327.jpg,Bl122,2
9053.743241,9053.745241,1,voc,271612297,271612357,60,spec2/voc/Bl122_271612297.jpg,Bl122,2
9081.047241,9081.058241,1,voc,272431417,272431747,330,spec2/voc/Bl122_272431417.jpg,Bl122,2
8911.899773,8911.902773,1,voc,267356993,267357083,90,spec2/voc/Bl122_267356993.jpg,Bl122,2
3865.560367,3865.658367,1,voc,115966811,115969751,2940,spec2/voc/Bl122_115966811.jpg,Bl122,2
5954.865256,5954.870256,1,voc,178645957,178646107,150,spec2/voc/Bl122_178645957.jpg,Bl122,2
9049.753241,9049.776241,1,voc,271492597,271493287,690,spec2/voc/Bl122_271492597.jpg,Bl122,2
13189.203662,13189.207662,1,voc,395676109,395676229,120,spec2/voc/Bl122_395676109.jpg,Bl122,2
7887.390748,7887.397748,1,voc,236621722,236621932,210,spec2/voc/Bl122_236621722.jpg,Bl122,2
5931.649256,5931.655256,1,voc,177949477,177949657,180,spec2/voc/Bl122_177949477.jpg,Bl122,2
11180.87718,11181.04218,1,voc,335426315,335431265,4950,spec2/voc/Bl122_335426315.jpg,Bl122,2
6027.361533,6027.607533,1,voc,180820845,180828225,7380,spec2/voc/Bl122_180820845.jpg,Bl122,2
7988.598748,7988.600748,1,voc,239657962,239658022,60,spec2/voc/Bl122_239657962.jpg,Bl122,2
14814.012551,14814.132551,1,voc,444420376,444423976,3600,spec2/voc/Bl122_444420376.jpg,Bl122,2
6099.17415,6099.18115,1,voc,182975224,182975434,210,spec2/voc/Bl122_182975224.jpg,Bl122,2
13921.629981,13921.638981,1,voc,417648899,417649169,270,spec2/voc/Bl122_417648899.jpg,Bl122,2
7950.896748,7950.906748,1,voc,238526902,238527202,300,spec2/voc/Bl122_238526902.jpg,Bl122,2
6125.885706,6125.888706,1,voc,183776571,183776661,90,spec2/voc/Bl122_183776571.jpg,Bl122,2
6112.703706,6112.887706,1,voc,183381111,183386631,5520,spec2/voc/Bl122_183381111.jpg,Bl122,2
5938.053256,5938.057256,1,voc,178141597,178141717,120,spec2/voc/Bl122_178141597.jpg,Bl122,2
6085.71515,6085.93315,1,voc,182571454,182577994,6540,spec2/voc/Bl122_182571454.jpg,Bl122,2
6154.881349,6154.890349,1,voc,184646440,184646710,270,spec2/voc/Bl122_184646440.jpg,Bl122,2
7998.914748,7998.922748,1,voc,239967442,239967682,240,spec2/voc/Bl122_239967442.jpg,Bl122,2
7906.698748,7906.704748,1,voc,237200962,237201142,180,spec2/voc/Bl122_237200962.jpg,Bl122,2
9081.658241,9081.664241,1,voc,272449747,272449927,180,spec2/voc/Bl122_272449747.jpg,Bl122,2
7976.644748,7976.693748,1,voc,239299342,239300812,1470,spec2/voc/Bl122_239299342.jpg,Bl122,2
3823.854649,3823.858649,1,voc,114715639,114715759,120,spec2/voc/Bl122_114715639.jpg,Bl122,2
6204.466327,6204.474327,1,voc,186133989,186134229,240,spec2/voc/Bl122_186133989.jpg,Bl122,2
7908.605748,7908.613748,1,voc,237258172,237258412,240,spec2/voc/Bl122_237258172.jpg,Bl122,2
7896.917748,7896.949748,1,voc,236907532,236908492,960,spec2/voc/Bl122_236907532.jpg,Bl122,2
9092.714241,9092.790241,1,voc,272781427,272783707,2280,spec2/voc/Bl122_272781427.jpg,Bl122,2
6137.910293,6138.041293,1,voc,184137308,184141238,3930,spec2/voc/Bl122_184137308.jpg,Bl122,2
5971.877256,5971.882256,1,voc,179156317,179156467,150,spec2/voc/Bl122_179156317.jpg,Bl122,2
5939.425256,5939.433256,1,voc,178182757,178182997,240,spec2/voc/Bl122_178182757.jpg,Bl122,2
11180.66918,11180.68318,1,voc,335420075,335420495,420,spec2/voc/Bl122_335420075.jpg,Bl122,2
7919.180748,7919.189748,1,voc,237575422,237575692,270,spec2/voc/Bl122_237575422.jpg,Bl122,2
6029.275533,6029.456533,1,voc,180878265,180883695,5430,spec2/voc/Bl122_180878265.jpg,Bl122,2
5949.284256,5949.307256,1,voc,178478527,178479217,690,spec2/voc/Bl122_178478527.jpg,Bl122,2
11208.940894,11208.970894,1,voc,336268226,336269126,900,spec2/voc/Bl122_336268226.jpg,Bl122,2
9090.785241,9090.791241,1,voc,272723557,272723737,180,spec2/voc/Bl122_272723557.jpg,Bl122,2
8981.376025,8981.382025,1,voc,269441280,269441460,180,spec2/voc/Bl122_269441280.jpg,Bl122,2
5986.076256,5986.087256,1,voc,179582287,179582617,330,spec2/voc/Bl122_179582287.jpg,Bl122,2
13214.819389,13214.837389,1,voc,396444581,396445121,540,spec2/voc/Bl122_396444581.jpg,Bl122,2
9130.691981,9130.736981,1,voc,273920759,273922109,1350,spec2/voc/Bl122_273920759.jpg,Bl122,2
6017.818533,6017.822533,1,voc,180534555,180534675,120,spec2/voc/Bl122_180534555.jpg,Bl122,2
6174.945327,6175.191327,1,voc,185248359,185255739,7380,spec2/voc/Bl122_185248359.jpg,Bl122,2
8027.522748,8027.540748,1,voc,240825682,240826222,540,spec2/voc/Bl122_240825682.jpg,Bl122,2
13921.930981,13921.946981,1,voc,417657929,417658409,480,spec2/voc/Bl122_417657929.jpg,Bl122,2
6221.980295,6221.989295,1,voc,186659408,186659678,270,spec2/voc/Bl122_186659408.jpg,Bl122,2
7886.225748,7886.233748,1,voc,236586772,236587012,240,spec2/voc/Bl122_236586772.jpg,Bl122,2
6093.30715,6093.31415,1,voc,182799214,182799424,210,spec2/voc/Bl122_182799214.jpg,Bl122,2
9128.342981,9128.523981,1,voc,273850289,273855719,5430,spec2/voc/Bl122_273850289.jpg,Bl122,2
11033.284132,11033.341132,1,voc,330998523,331000233,1710,spec2/voc/Bl122_330998523.jpg,Bl122,2
8924.009773,8924.015773,1,voc,267720293,267720473,180,spec2/voc/Bl122_267720293.jpg,Bl122,2
3816.398649,3816.463649,1,voc,114491959,114493909,1950,spec2/voc/Bl122_114491959.jpg,Bl122,2
5278.639191,5278.856191,1,voc,158359175,158365685,6510,spec2/voc/Bl122_158359175.jpg,Bl122,2
6118.910706,6118.919706,1,voc,183567321,183567591,270,spec2/voc/Bl122_183567321.jpg,Bl122,2
3866.276367,3866.299367,1,voc,115988291,115988981,690,spec2/voc/Bl122_115988291.jpg,Bl122,2
7928.328748,7928.339748,1,voc,237849862,237850192,330,spec2/voc/Bl122_237849862.jpg,Bl122,2
13580.185236,13580.249236,1,voc,407405557,407407477,1920,spec2/voc/Bl122_407405557.jpg,Bl122,2
5953.307256,5953.477256,1,voc,178599217,178604317,5100,spec2/voc/Bl122_178599217.jpg,Bl122,2
8936.384967,8936.574967,1,voc,268091549,268097249,5700,spec2/voc/Bl122_268091549.jpg,Bl122,2
11032.183132,11032.188132,1,voc,330965493,330965643,150,spec2/voc/Bl122_330965493.jpg,Bl122,2
7860.453748,7860.471748,1,voc,235813612,235814152,540,spec2/voc/Bl122_235813612.jpg,Bl122,2
8942.492967,8942.506967,1,voc,268274789,268275209,420,spec2/voc/Bl122_268274789.jpg,Bl122,2
6060.879705,6060.920705,1,voc,181826391,181827621,1230,spec2/voc/Bl122_181826391.jpg,Bl122,2
11210.915894,11210.920894,1,voc,336327476,336327626,150,spec2/voc/Bl122_336327476.jpg,Bl122,2
6111.943706,6111.946706,1,voc,183358311,183358401,90,spec2/voc/Bl122_183358311.jpg,Bl122,2
9038.131241,9038.136241,1,voc,271143937,271144087,150,spec2/voc/Bl122_271143937.jpg,Bl122,2
6111.750706,6111.938706,1,voc,183352521,183358161,5640,spec2/voc/Bl122_183352521.jpg,Bl122,2
9164.619604,9164.624604,1,voc,274938588,274938738,150,spec2/voc/Bl122_274938588.jpg,Bl122,2
14817.070551,14817.086551,1,voc,444512116,444512596,480,spec2/voc/Bl122_444512116.jpg,Bl122,2
9016.560241,9016.595241,1,voc,270496807,270497857,1050,spec2/voc/Bl122_270496807.jpg,Bl122,2
10937.024807,10937.033807,1,voc,328110744,328111014,270,spec2/voc/Bl122_328110744.jpg,Bl122,2
7846.363748,7846.367748,1,voc,235390912,235391032,120,spec2/voc/Bl122_235390912.jpg,Bl122,2
9036.490241,9036.498241,1,voc,271094707,271094947,240,spec2/voc/Bl122_271094707.jpg,Bl122,2
9178.243321,9178.260321,1,voc,275347299,275347809,510,spec2/voc/Bl122_275347299.jpg,Bl122,2
6038.356533,6038.379533,1,voc,181150695,181151385,690,spec2/voc/Bl122_181150695.jpg,Bl122,2
8920.568773,8920.630773,1,voc,267617063,267618923,1860,spec2/voc/Bl122_267617063.jpg,Bl122,2
6185.199327,6185.236327,1,voc,185555979,185557089,1110,spec2/voc/Bl122_185555979.jpg,Bl122,2
12678.41117,12678.52217,1,voc,380352335,380355665,3330,spec2/voc/Bl122_380352335.jpg,Bl122,2
3811.540649,3811.563649,1,voc,114346219,114346909,690,spec2/voc/Bl122_114346219.jpg,Bl122,2
13818.604617,13818.645617,1,voc,414558138,414559368,1230,spec2/voc/Bl122_414558138.jpg,Bl122,2
11128.243005,11128.331005,1,voc,333847290,333849930,2640,spec2/voc/Bl122_333847290.jpg,Bl122,2
5953.579256,5953.612256,1,voc,178607377,178608367,990,spec2/voc/Bl122_178607377.jpg,Bl122,2
9029.109241,9029.270241,1,voc,270873277,270878107,4830,spec2/voc/Bl122_270873277.jpg,Bl122,2
6222.344295,6222.346295,1,voc,186670328,186670388,60,spec2/voc/Bl122_186670328.jpg,Bl122,2
6068.035705,6068.060705,1,voc,182041071,182041821,750,spec2/voc/Bl122_182041071.jpg,Bl122,2
6063.552705,6063.557705,1,voc,181906581,181906731,150,spec2/voc/Bl122_181906581.jpg,Bl122,2
9047.490241,9047.619241,1,voc,271424707,271428577,3870,spec2/voc/Bl122_271424707.jpg,Bl122,2
14812.208551,14812.270551,1,voc,444366256,444368116,1860,spec2/voc/Bl122_444366256.jpg,Bl122,2
7884.298748,7884.301748,1,voc,236528962,236529052,90,spec2/voc/Bl122_236528962.jpg,Bl122,2
6174.708327,6174.806327,1,voc,185241249,185244189,2940,spec2/voc/Bl122_185241249.jpg,Bl122,2
3843.715415,3843.833415,1,voc,115311462,115315002,3540,spec2/voc/Bl122_115311462.jpg,Bl122,2
3807.828649,3807.836649,1,voc,114234859,114235099,240,spec2/voc/Bl122_114234859.jpg,Bl122,2
3823.110649,3823.117649,1,voc,114693319,114693529,210,spec2/voc/Bl122_114693319.jpg,Bl122,2
3797.207649,3797.229649,1,voc,113916229,113916889,660,spec2/voc/Bl122_113916229.jpg,Bl122,2
13217.849389,13217.877389,1,voc,396535481,396536321,840,spec2/voc/Bl122_396535481.jpg,Bl122,2
6157.390349,6157.494349,1,voc,184721710,184724830,3120,spec2/voc/Bl122_184721710.jpg,Bl122,2
5960.960256,5960.968256,1,voc,178828807,178829047,240,spec2/voc/Bl122_178828807.jpg,Bl122,2
5960.458256,5960.487256,1,voc,178813747,178814617,870,spec2/voc/Bl122_178813747.jpg,Bl122,2
13206.079389,13206.087389,1,voc,396182381,396182621,240,spec2/voc/Bl122_396182381.jpg,Bl122,2
6071.494705,6071.501705,1,voc,182144841,182145051,210,spec2/voc/Bl122_182144841.jpg,Bl122,2
6060.973705,6060.999705,1,voc,181829211,181829991,780,spec2/voc/Bl122_181829211.jpg,Bl122,2
13939.0839,13939.1459,1,voc,418172517,418174377,1860,spec2/voc/Bl122_418172517.jpg,Bl122,2
14796.439551,14796.443551,1,voc,443893186,443893306,120,spec2/voc/Bl122_443893186.jpg,Bl122,2
12664.396938,12664.492938,1,voc,379931908,379934788,2880,spec2/voc/Bl122_379931908.jpg,Bl122,2
13599.955736,13600.035736,1,voc,407998672,408001072,2400,spec2/voc/Bl122_407998672.jpg,Bl122,2
5948.120256,5948.137256,1,voc,178443607,178444117,510,spec2/voc/Bl122_178443607.jpg,Bl122,2
13825.62122,13825.71722,1,voc,414768636,414771516,2880,spec2/voc/Bl122_414768636.jpg,Bl122,2
8992.923241,8993.130241,1,voc,269787697,269793907,6210,spec2/voc/Bl122_269787697.jpg,Bl122,2
9090.448241,9090.652241,1,voc,272713447,272719567,6120,spec2/voc/Bl122_272713447.jpg,Bl122,2
13214.138389,13214.165389,1,voc,396424151,396424961,810,spec2/voc/Bl122_396424151.jpg,Bl122,2
11173.41418,11173.51318,1,voc,335202425,335205395,2970,spec2/voc/Bl122_335202425.jpg,Bl122,2
9173.773287,9173.886287,1,voc,275213198,275216588,3390,spec2/voc/Bl122_275213198.jpg,Bl122,2
6038.155533,6038.165533,1,voc,181144665,181144965,300,spec2/voc/Bl122_181144665.jpg,Bl122,2
8949.348967,8949.766967,1,voc,268480469,268493009,12540,spec2/voc/Bl122_268480469.jpg,Bl122,2
7964.462748,7964.479748,1,voc,238933882,238934392,510,spec2/voc/Bl122_238933882.jpg,Bl122,2
3804.722649,3804.769649,1,voc,114141679,114143089,1410,spec2/voc/Bl122_114141679.jpg,Bl122,2
6134.083293,6134.152293,1,voc,184022498,184024568,2070,spec2/voc/Bl122_184022498.jpg,Bl122,2
6161.442349,6161.541349,1,voc,184843270,184846240,2970,spec2/voc/Bl122_184843270.jpg,Bl122,2
5985.839256,5985.892256,1,voc,179575177,179576767,1590,spec2/voc/Bl122_179575177.jpg,Bl122,2
10909.196807,10909.200807,1,voc,327275904,327276024,120,spec2/voc/Bl122_327275904.jpg,Bl122,2
10955.156807,10955.163807,1,voc,328654704,328654914,210,spec2/voc/Bl122_328654704.jpg,Bl122,2
7777.215748,7777.237748,1,voc,233316472,233317132,660,spec2/voc/Bl122_233316472.jpg,Bl122,2
8207.861882,8207.865882,1,voc,246235856,246235976,120,spec2/voc/Bl122_246235856.jpg,Bl122,2
3865.026367,3865.035367,1,voc,115950791,115951061,270,spec2/voc/Bl122_115950791.jpg,Bl122,2
14825.853551,14825.891551,1,voc,444775606,444776746,1140,spec2/voc/Bl122_444775606.jpg,Bl122,2
14819.283551,14819.287551,1,voc,444578506,444578626,120,spec2/voc/Bl122_444578506.jpg,Bl122,2
10936.934807,10936.948807,1,voc,328108044,328108464,420,spec2/voc/Bl122_328108044.jpg,Bl122,2
5931.657256,5931.662256,1,voc,177949717,177949867,150,spec2/voc/Bl122_177949717.jpg,Bl122,2
7961.651748,7961.696748,1,voc,238849552,238850902,1350,spec2/voc/Bl122_238849552.jpg,Bl122,2
9098.030241,9098.096241,1,voc,272940907,272942887,1980,spec2/voc/Bl122_272940907.jpg,Bl122,2
6034.089533,6034.131533,1,voc,181022685,181023945,1260,spec2/voc/Bl122_181022685.jpg,Bl122,2
13961.806384,13961.889384,1,voc,418854191,418856681,2490,spec2/voc/Bl122_418854191.jpg,Bl122,2
6075.448705,6075.453705,1,voc,182263461,182263611,150,spec2/voc/Bl122_182263461.jpg,Bl122,2
7882.862748,7882.869748,1,voc,236485882,236486092,210,spec2/voc/Bl122_236485882.jpg,Bl122,2
5937.117256,5937.130256,1,voc,178113517,178113907,390,spec2/voc/Bl122_178113517.jpg,Bl122,2
5952.768256,5952.785256,1,voc,178583047,178583557,510,spec2/voc/Bl122_178583047.jpg,Bl122,2
3801.173649,3801.187649,1,voc,114035209,114035629,420,spec2/voc/Bl122_114035209.jpg,Bl122,2
9050.239241,9050.243241,1,voc,271507177,271507297,120,spec2/voc/Bl122_271507177.jpg,Bl122,2
13545.883973,13546.042973,1,voc,406376519,406381289,4770,spec2/voc/Bl122_406376519.jpg,Bl122,2
6098.28415,6098.32915,1,voc,182948524,182949874,1350,spec2/voc/Bl122_182948524.jpg,Bl122,2
7897.122748,7897.149748,1,voc,236913682,236914492,810,spec2/voc/Bl122_236913682.jpg,Bl122,2
6064.355705,6064.359705,1,voc,181930671,181930791,120,spec2/voc/Bl122_181930671.jpg,Bl122,2
3828.230649,3828.233649,1,voc,114846919,114847009,90,spec2/voc/Bl122_114846919.jpg,Bl122,2
13812.318352,13812.320352,1,voc,414369550,414369610,60,spec2/voc/Bl122_414369550.jpg,Bl122,2
8978.861025,8978.864025,1,voc,269365830,269365920,90,spec2/voc/Bl122_269365830.jpg,Bl122,2
7834.027748,7834.032748,1,voc,235020832,235020982,150,spec2/voc/Bl122_235020832.jpg,Bl122,2
14826.143551,14826.157551,1,voc,444784306,444784726,420,spec2/voc/Bl122_444784306.jpg,Bl122,2
3801.815649,3801.826649,1,voc,114054469,114054799,330,spec2/voc/Bl122_114054469.jpg,Bl122,2
8040.850748,8040.858748,1,voc,241225522,241225762,240,spec2/voc/Bl122_241225522.jpg,Bl122,2
6139.103293,6139.140293,1,voc,184173098,184174208,1110,spec2/voc/Bl122_184173098.jpg,Bl122,2
9053.211241,9053.401241,1,voc,271596337,271602037,5700,spec2/voc/Bl122_271596337.jpg,Bl122,2
8008.646748,8008.658748,1,voc,240259402,240259762,360,spec2/voc/Bl122_240259402.jpg,Bl122,2
8994.272241,8994.290241,1,voc,269828167,269828707,540,spec2/voc/Bl122_269828167.jpg,Bl122,2
10896.466557,10896.492557,1,voc,326893996,326894776,780,spec2/voc/Bl122_326893996.jpg,Bl122,2
14795.520551,14795.542551,1,voc,443865616,443866276,660,spec2/voc/Bl122_443865616.jpg,Bl122,2
8212.968724,8213.006724,1,voc,246389061,246390201,1140,spec2/voc/Bl122_246389061.jpg,Bl122,2
12660.988535,12660.991535,1,voc,379829656,379829746,90,spec2/voc/Bl122_379829656.jpg,Bl122,2
5955.199256,5955.225256,1,voc,178655977,178656757,780,spec2/voc/Bl122_178655977.jpg,Bl122,2
6071.104705,6071.110705,1,voc,182133141,182133321,180,spec2/voc/Bl122_182133141.jpg,Bl122,2
5931.738256,5931.821256,1,voc,177952147,177954637,2490,spec2/voc/Bl122_177952147.jpg,Bl122,2
9086.647241,9086.891241,1,voc,272599417,272606737,7320,spec2/voc/Bl122_272599417.jpg,Bl122,2
10896.862557,10896.868557,1,voc,326905876,326906056,180,spec2/voc/Bl122_326905876.jpg,Bl122,2
3792.202649,3792.353649,1,voc,113766079,113770609,4530,spec2/voc/Bl122_113766079.jpg,Bl122,2
13244.738606,13244.765606,1,voc,397342158,397342968,810,spec2/voc/Bl122_397342158.jpg,Bl122,2
7968.787748,7968.802748,1,voc,239063632,239064082,450,spec2/voc/Bl122_239063632.jpg,Bl122,2
6075.565705,6075.571705,1,voc,182266971,182267151,180,spec2/voc/Bl122_182266971.jpg,Bl122,2
6111.407706,6111.409706,1,voc,183342231,183342291,60,spec2/voc/Bl122_183342231.jpg,Bl122,2
12661.400535,12661.407535,1,voc,379842016,379842226,210,spec2/voc/Bl122_379842016.jpg,Bl122,2
10927.919807,10928.269807,1,voc,327837594,327848094,10500,spec2/voc/Bl122_327837594.jpg,Bl122,2
10941.328807,10941.331807,1,voc,328239864,328239954,90,spec2/voc/Bl122_328239864.jpg,Bl122,2
3861.960367,3862.003367,1,voc,115858811,115860101,1290,spec2/voc/Bl122_115858811.jpg,Bl122,2
6106.429706,6106.432706,1,voc,183192891,183192981,90,spec2/voc/Bl122_183192891.jpg,Bl122,2
7987.704748,7987.715748,1,voc,239631142,239631472,330,spec2/voc/Bl122_239631142.jpg,Bl122,2
7913.837748,7913.847748,1,voc,237415132,237415432,300,spec2/voc/Bl122_237415132.jpg,Bl122,2
13177.373701,13177.375701,1,voc,395321211,395321271,60,spec2/voc/Bl122_395321211.jpg,Bl122,2
9010.907241,9010.910241,1,voc,270327217,270327307,90,spec2/voc/Bl122_270327217.jpg,Bl122,2
10915.108807,10915.117807,1,voc,327453264,327453534,270,spec2/voc/Bl122_327453264.jpg,Bl122,2
5947.272256,5947.277256,1,voc,178418167,178418317,150,spec2/voc/Bl122_178418167.jpg,Bl122,2
11915.134799,11915.140799,1,voc,357454043,357454223,180,spec2/voc/Bl122_357454043.jpg,Bl122,2
8016.902748,8016.916748,1,voc,240507082,240507502,420,spec2/voc/Bl122_240507082.jpg,Bl122,2
6202.565327,6202.717327,1,voc,186076959,186081519,4560,spec2/voc/Bl122_186076959.jpg,Bl122,2
9099.049241,9099.058241,1,voc,272971477,272971747,270,spec2/voc/Bl122_272971477.jpg,Bl122,2
13193.537662,13193.545662,1,voc,395806129,395806369,240,spec2/voc/Bl122_395806129.jpg,Bl122,2
8987.701025,8987.780025,1,voc,269631030,269633400,2370,spec2/voc/Bl122_269631030.jpg,Bl122,2
9064.478241,9064.499241,1,voc,271934347,271934977,630,spec2/voc/Bl122_271934347.jpg,Bl122,2
14803.433551,14803.462551,1,voc,444103006,444103876,870,spec2/voc/Bl122_444103006.jpg,Bl122,2
10947.364807,10947.367807,1,voc,328420944,328421034,90,spec2/voc/Bl122_328420944.jpg,Bl122,2
6112.365706,6112.428706,1,voc,183370971,183372861,1890,spec2/voc/Bl122_183370971.jpg,Bl122,2
5986.840256,5986.871256,1,voc,179605207,179606137,930,spec2/voc/Bl122_179605207.jpg,Bl122,2
13208.007389,13208.021389,1,voc,396240221,396240641,420,spec2/voc/Bl122_396240221.jpg,Bl122,2
6169.930327,6169.943327,1,voc,185097909,185098299,390,spec2/voc/Bl122_185097909.jpg,Bl122,2
9042.552241,9042.602241,1,voc,271276567,271278067,1500,spec2/voc/Bl122_271276567.jpg,Bl122,2
6097.50715,6097.53615,1,voc,182925214,182926084,870,spec2/voc/Bl122_182925214.jpg,Bl122,2
6125.767706,6125.793706,1,voc,183773031,183773811,780,spec2/voc/Bl122_183773031.jpg,Bl122,2
3841.482415,3841.487415,1,voc,115244472,115244622,150,spec2/voc/Bl122_115244472.jpg,Bl122,2
6111.426706,6111.512706,1,voc,183342801,183345381,2580,spec2/voc/Bl122_183342801.jpg,Bl122,2
10933.005807,10933.299807,1,voc,327990174,327998994,8820,spec2/voc/Bl122_327990174.jpg,Bl122,2
3840.134415,3840.142415,1,voc,115204032,115204272,240,spec2/voc/Bl122_115204032.jpg,Bl122,2
9079.731241,9079.762241,1,voc,272391937,272392867,930,spec2/voc/Bl122_272391937.jpg,Bl122,2
7932.281748,7932.287748,1,voc,237968452,237968632,180,spec2/voc/Bl122_237968452.jpg,Bl122,2
6204.595327,6204.615327,1,voc,186137859,186138459,600,spec2/voc/Bl122_186137859.jpg,Bl122,2
5935.166256,5935.171256,1,voc,178054987,178055137,150,spec2/voc/Bl122_178054987.jpg,Bl122,2
8967.325712,8967.445712,1,voc,269019771,269023371,3600,spec2/voc/Bl122_269019771.jpg,Bl122,2
14817.050551,14817.067551,1,voc,444511516,444512026,510,spec2/voc/Bl122_444511516.jpg,Bl122,2
7837.813748,7837.817748,1,voc,235134412,235134532,120,spec2/voc/Bl122_235134412.jpg,Bl122,2
8993.739241,8993.786241,1,voc,269812177,269813587,1410,spec2/voc/Bl122_269812177.jpg,Bl122,2
3799.780649,3799.813649,1,voc,113993419,113994409,990,spec2/voc/Bl122_113993419.jpg,Bl122,2
6072.071705,6072.078705,1,voc,182162151,182162361,210,spec2/voc/Bl122_182162151.jpg,Bl122,2
10900.781004,10900.838004,1,voc,327023430,327025140,1710,spec2/voc/Bl122_327023430.jpg,Bl122,2
3815.662649,3815.696649,1,voc,114469879,114470899,1020,spec2/voc/Bl122_114469879.jpg,Bl122,2
6083.30915,6083.31815,1,voc,182499274,182499544,270,spec2/voc/Bl122_182499274.jpg,Bl122,2
11140.275955,11140.299955,1,voc,334208278,334208998,720,spec2/voc/Bl122_334208278.jpg,Bl122,2
8984.828025,8984.833025,1,voc,269544840,269544990,150,spec2/voc/Bl122_269544840.jpg,Bl122,2
3888.644652,3888.714652,1,voc,116659339,116661439,2100,spec2/voc/Bl122_116659339.jpg,Bl122,2
6122.240706,6122.284706,1,voc,183667221,183668541,1320,spec2/voc/Bl122_183667221.jpg,Bl122,2
10909.273807,10909.292807,1,voc,327278214,327278784,570,spec2/voc/Bl122_327278214.jpg,Bl122,2
8017.258748,8017.444748,1,voc,240517762,240523342,5580,spec2/voc/Bl122_240517762.jpg,Bl122,2
13219.351389,13219.373389,1,voc,396580541,396581201,660,spec2/voc/Bl122_396580541.jpg,Bl122,2
9099.921241,9099.924241,1,voc,272997637,272997727,90,spec2/voc/Bl122_272997637.jpg,Bl122,2
7803.109748,7803.115748,1,voc,234093292,234093472,180,spec2/voc/Bl122_234093292.jpg,Bl122,2
5934.493256,5934.586256,1,voc,178034797,178037587,2790,spec2/voc/Bl122_178034797.jpg,Bl122,2
6071.517705,6071.563705,1,voc,182145531,182146911,1380,spec2/voc/Bl122_182145531.jpg,Bl122,2
3815.956649,3815.971649,1,voc,114478699,114479149,450,spec2/voc/Bl122_114478699.jpg,Bl122,2
10917.662807,10917.806807,1,voc,327529884,327534204,4320,spec2/voc/Bl122_327529884.jpg,Bl122,2
13899.04063,13899.04663,1,voc,416971218,416971398,180,spec2/voc/Bl122_416971218.jpg,Bl122,2
6229.619295,6229.682295,1,voc,186888578,186890468,1890,spec2/voc/Bl122_186888578.jpg,Bl122,2
10942.789807,10942.805807,1,voc,328283694,328284174,480,spec2/voc/Bl122_328283694.jpg,Bl122,2
9160.994057,9161.102057,1,voc,274829821,274833061,3240,spec2/voc/Bl122_274829821.jpg,Bl122,3
14824.644551,14824.782551,1,voc,444739336,444743476,4140,spec2/voc/Bl122_444739336.jpg,Bl122,3
11163.10318,11163.19918,1,voc,334893095,334895975,2880,spec2/voc/Bl122_334893095.jpg,Bl122,3
11181.40118,11181.40318,1,voc,335442035,335442095,60,spec2/voc/Bl122_335442035.jpg,Bl122,3
9097.926241,9097.937241,1,voc,272937787,272938117,330,spec2/voc/Bl122_272937787.jpg,Bl122,3
7955.794748,7955.798748,1,voc,238673842,238673962,120,spec2/voc/Bl122_238673842.jpg,Bl122,3
7851.759748,7851.776748,1,voc,235552792,235553302,510,spec2/voc/Bl122_235552792.jpg,Bl122,3
11132.118005,11132.123005,1,voc,333963540,333963690,150,spec2/voc/Bl122_333963540.jpg,Bl122,3
6023.948533,6023.961533,1,voc,180718455,180718845,390,spec2/voc/Bl122_180718455.jpg,Bl122,3
9081.112241,9081.116241,1,voc,272433367,272433487,120,spec2/voc/Bl122_272433367.jpg,Bl122,3
10926.713807,10926.723807,1,voc,327801414,327801714,300,spec2/voc/Bl122_327801414.jpg,Bl122,3
11175.63618,11175.68218,1,voc,335269085,335270465,1380,spec2/voc/Bl122_335269085.jpg,Bl122,3
13947.657911,13947.673911,1,voc,418429737,418430217,480,spec2/voc/Bl122_418429737.jpg,Bl122,3
13224.371389,13224.378389,1,voc,396731141,396731351,210,spec2/voc/Bl122_396731141.jpg,Bl122,3
11163.24318,11163.28518,1,voc,334897295,334898555,1260,spec2/voc/Bl122_334897295.jpg,Bl122,3
8015.940748,8015.942748,1,voc,240478222,240478282,60,spec2/voc/Bl122_240478222.jpg,Bl122,3
8921.767773,8921.778773,1,voc,267653033,267653363,330,spec2/voc/Bl122_267653033.jpg,Bl122,3
6070.981705,6070.987705,1,voc,182129451,182129631,180,spec2/voc/Bl122_182129451.jpg,Bl122,3
6222.670295,6222.674295,1,voc,186680108,186680228,120,spec2/voc/Bl122_186680108.jpg,Bl122,3
6197.773327,6197.778327,1,voc,185933199,185933349,150,spec2/voc/Bl122_185933199.jpg,Bl122,3
6126.303706,6126.308706,1,voc,183789111,183789261,150,spec2/voc/Bl122_183789111.jpg,Bl122,3
5970.786256,5970.793256,1,voc,179123587,179123797,210,spec2/voc/Bl122_179123587.jpg,Bl122,3
9150.709842,9150.713842,1,voc,274521295,274521415,120,spec2/voc/Bl122_274521295.jpg,Bl122,3
7846.510748,7846.518748,1,voc,235395322,235395562,240,spec2/voc/Bl122_235395322.jpg,Bl122,3
3889.693652,3889.725652,1,voc,116690809,116691769,960,spec2/voc/Bl122_116690809.jpg,Bl122,3
5950.349256,5950.589256,1,voc,178510477,178517677,7200,spec2/voc/Bl122_178510477.jpg,Bl122,3
3811.286649,3811.289649,1,voc,114338599,114338689,90,spec2/voc/Bl122_114338599.jpg,Bl122,3
6032.680533,6032.759533,1,voc,180980415,180982785,2370,spec2/voc/Bl122_180980415.jpg,Bl122,3
13207.930389,13207.955389,1,voc,396237911,396238661,750,spec2/voc/Bl122_396237911.jpg,Bl122,3
14781.868844,14781.876844,1,voc,443456065,443456305,240,spec2/voc/Bl122_443456065.jpg,Bl122,3
9042.499241,9042.502241,1,voc,271274977,271275067,90,spec2/voc/Bl122_271274977.jpg,Bl122,3
14820.924551,14820.931551,1,voc,444627736,444627946,210,spec2/voc/Bl122_444627736.jpg,Bl122,3
8019.608748,8019.613748,1,voc,240588262,240588412,150,spec2/voc/Bl122_240588262.jpg,Bl122,3
5970.744256,5970.784256,1,voc,179122327,179123527,1200,spec2/voc/Bl122_179122327.jpg,Bl122,3
5994.390256,5994.397256,1,voc,179831707,179831917,210,spec2/voc/Bl122_179831707.jpg,Bl122,3
3808.563649,3808.685649,1,voc,114256909,114260569,3660,spec2/voc/Bl122_114256909.jpg,Bl122,3
9098.439241,9098.442241,1,voc,272953177,272953267,90,spec2/voc/Bl122_272953177.jpg,Bl122,3
14804.298551,14804.306551,1,voc,444128956,444129196,240,spec2/voc/Bl122_444128956.jpg,Bl122,3
14816.474551,14816.480551,1,voc,444494236,444494416,180,spec2/voc/Bl122_444494236.jpg,Bl122,3
5981.825256,5981.832256,1,voc,179454757,179454967,210,spec2/voc/Bl122_179454757.jpg,Bl122,3
3896.483652,3896.487652,1,voc,116894509,116894629,120,spec2/voc/Bl122_116894509.jpg,Bl122,3
3853.170415,3853.319415,1,voc,115595112,115599582,4470,spec2/voc/Bl122_115595112.jpg,Bl122,3
7998.720748,7998.723748,1,voc,239961622,239961712,90,spec2/voc/Bl122_239961622.jpg,Bl122,3
10940.729807,10940.743807,1,voc,328221894,328222314,420,spec2/voc/Bl122_328221894.jpg,Bl122,3
14822.283551,14822.451551,1,voc,444668506,444673546,5040,spec2/voc/Bl122_444668506.jpg,Bl122,3
11126.923005,11126.996005,1,voc,333807690,333809880,2190,spec2/voc/Bl122_333807690.jpg,Bl122,3
6099.04015,6099.09115,1,voc,182971204,182972734,1530,spec2/voc/Bl122_182971204.jpg,Bl122,3
6099.43315,6099.46315,1,voc,182982994,182983894,900,spec2/voc/Bl122_182982994.jpg,Bl122,3
6115.801706,6115.861706,1,voc,183474051,183475851,1800,spec2/voc/Bl122_183474051.jpg,Bl122,3
6048.6702,6048.6802,1,voc,181460106,181460406,300,spec2/voc/Bl122_181460106.jpg,Bl122,3
6034.012533,6034.028533,1,voc,181020375,181020855,480,spec2/voc/Bl122_181020375.jpg,Bl122,3
6033.952533,6034.009533,1,voc,181018575,181020285,1710,spec2/voc/Bl122_181018575.jpg,Bl122,3
7886.824748,7886.842748,1,voc,236604742,236605282,540,spec2/voc/Bl122_236604742.jpg,Bl122,3
6187.565327,6187.645327,1,voc,185626959,185629359,2400,spec2/voc/Bl122_185626959.jpg,Bl122,3
9040.273241,9040.309241,1,voc,271208197,271209277,1080,spec2/voc/Bl122_271208197.jpg,Bl122,3
3846.669415,3846.744415,1,voc,115400082,115402332,2250,spec2/voc/Bl122_115400082.jpg,Bl122,3
11161.68818,11161.83618,1,voc,334850645,334855085,4440,spec2/voc/Bl122_334850645.jpg,Bl122,3
10921.030807,10921.056807,1,voc,327630924,327631704,780,spec2/voc/Bl122_327630924.jpg,Bl122,3
6024.699533,6024.748533,1,voc,180740985,180742455,1470,spec2/voc/Bl122_180740985.jpg,Bl122,3
10943.464807,10943.484807,1,voc,328303944,328304544,600,spec2/voc/Bl122_328303944.jpg,Bl122,3
14793.808551,14793.835551,1,voc,443814256,443815066,810,spec2/voc/Bl122_443814256.jpg,Bl122,3
14813.207551,14813.251551,1,voc,444396226,444397546,1320,spec2/voc/Bl122_444396226.jpg,Bl122,3
14154.508825,14154.511825,1,voc,424635264,424635354,90,spec2/voc/Bl122_424635264.jpg,Bl122,3
9097.706241,9097.721241,1,voc,272931187,272931637,450,spec2/voc/Bl122_272931187.jpg,Bl122,3
9058.107241,9058.208241,1,voc,271743217,271746247,3030,spec2/voc/Bl122_271743217.jpg,Bl122,3
11209.015894,11209.034894,1,voc,336270476,336271046,570,spec2/voc/Bl122_336270476.jpg,Bl122,3
6088.68815,6088.71315,1,voc,182660644,182661394,750,spec2/voc/Bl122_182660644.jpg,Bl122,3
6073.728705,6073.812705,1,voc,182211861,182214381,2520,spec2/voc/Bl122_182211861.jpg,Bl122,3
6060.056705,6060.155705,1,voc,181801701,181804671,2970,spec2/voc/Bl122_181801701.jpg,Bl122,3
13206.584389,13206.588389,1,voc,396197531,396197651,120,spec2/voc/Bl122_396197531.jpg,Bl122,3
8929.858773,8929.861773,1,voc,267895763,267895853,90,spec2/voc/Bl122_267895763.jpg,Bl122,3
8026.549748,8026.604748,1,voc,240796492,240798142,1650,spec2/voc/Bl122_240796492.jpg,Bl122,3
11158.76518,11158.88418,1,voc,334762955,334766525,3570,spec2/voc/Bl122_334762955.jpg,Bl122,3
8994.299241,8994.681241,1,voc,269828977,269840437,11460,spec2/voc/Bl122_269828977.jpg,Bl122,3
9071.685241,9071.692241,1,voc,272150557,272150767,210,spec2/voc/Bl122_272150557.jpg,Bl122,3
11153.63618,11153.83618,1,voc,334609085,334615085,6000,spec2/voc/Bl122_334609085.jpg,Bl122,3
6202.789327,6202.799327,1,voc,186083679,186083979,300,spec2/voc/Bl122_186083679.jpg,Bl122,3
10888.679136,10888.713136,1,voc,326660374,326661394,1020,spec2/voc/Bl122_326660374.jpg,Bl122,3
6034.526533,6034.532533,1,voc,181035795,181035975,180,spec2/voc/Bl122_181035795.jpg,Bl122,3
6019.539533,6019.543533,1,voc,180586185,180586305,120,spec2/voc/Bl122_180586185.jpg,Bl122,3
11171.42118,11171.54118,1,voc,335142635,335146235,3600,spec2/voc/Bl122_335142635.jpg,Bl122,3
5944.643256,5944.684256,1,voc,178339297,178340527,1230,spec2/voc/Bl122_178339297.jpg,Bl122,3
10897.172557,10897.181557,1,voc,326915176,326915446,270,spec2/voc/Bl122_326915176.jpg,Bl122,3
9036.739241,9036.768241,1,voc,271102177,271103047,870,spec2/voc/Bl122_271102177.jpg,Bl122,3
5983.335256,5983.349256,1,voc,179500057,179500477,420,spec2/voc/Bl122_179500057.jpg,Bl122,3
3866.303367,3866.329367,1,voc,115989101,115989881,780,spec2/voc/Bl122_115989101.jpg,Bl122,3
3877.838848,3877.970848,1,voc,116335165,116339125,3960,spec2/voc/Bl122_116335165.jpg,Bl122,3
13221.070389,13221.078389,1,voc,396632111,396632351,240,spec2/voc/Bl122_396632111.jpg,Bl122,3
11141.468955,11141.471955,1,voc,334244068,334244158,90,spec2/voc/Bl122_334244068.jpg,Bl122,3
11125.387005,11125.394005,1,voc,333761610,333761820,210,spec2/voc/Bl122_333761610.jpg,Bl122,3
11210.250894,11210.252894,1,voc,336307526,336307586,60,spec2/voc/Bl122_336307526.jpg,Bl122,3
3846.526415,3846.537415,1,voc,115395792,115396122,330,spec2/voc/Bl122_115395792.jpg,Bl122,3
3847.418415,3847.431415,1,voc,115422552,115422942,390,spec2/voc/Bl122_115422552.jpg,Bl122,3
7845.251748,7845.257748,1,voc,235357552,235357732,180,spec2/voc/Bl122_235357552.jpg,Bl122,3
9042.760241,9042.794241,1,voc,271282807,271283827,1020,spec2/voc/Bl122_271282807.jpg,Bl122,3
8963.587712,8963.591712,1,voc,268907631,268907751,120,spec2/voc/Bl122_268907631.jpg,Bl122,3
13979.287216,13979.352216,1,voc,419378616,419380566,1950,spec2/voc/Bl122_419378616.jpg,Bl122,3
10955.998807,10956.001807,1,voc,328679964,328680054,90,spec2/voc/Bl122_328679964.jpg,Bl122,3
6088.85115,6088.85515,1,voc,182665534,182665654,120,spec2/voc/Bl122_182665534.jpg,Bl122,3
8025.000748,8025.009748,1,voc,240750022,240750292,270,spec2/voc/Bl122_240750022.jpg,Bl122,3
6140.408349,6140.490349,1,voc,184212250,184214710,2460,spec2/voc/Bl122_184212250.jpg,Bl122,3
6145.001349,6145.163349,1,voc,184350040,184354900,4860,spec2/voc/Bl122_184350040.jpg,Bl122,3
9064.174241,9064.177241,1,voc,271925227,271925317,90,spec2/voc/Bl122_271925227.jpg,Bl122,3
7970.126748,7970.133748,1,voc,239103802,239104012,210,spec2/voc/Bl122_239103802.jpg,Bl122,3
7772.936748,7772.941748,1,voc,233188102,233188252,150,spec2/voc/Bl122_233188102.jpg,Bl122,3
11125.346005,11125.377005,1,voc,333760380,333761310,930,spec2/voc/Bl122_333760380.jpg,Bl122,3
9115.354184,9115.359184,1,voc,273460625,273460775,150,spec2/voc/Bl122_273460625.jpg,Bl122,3
7942.664748,7942.672748,1,voc,238279942,238280182,240,spec2/voc/Bl122_238279942.jpg,Bl122,3
9085.062241,9085.065241,1,voc,272551867,272551957,90,spec2/voc/Bl122_272551867.jpg,Bl122,3
14843.698682,14843.870682,1,voc,445310960,445316120,5160,spec2/voc/Bl122_445310960.jpg,Bl122,3
5979.555256,5979.703256,1,voc,179386657,179391097,4440,spec2/voc/Bl122_179386657.jpg,Bl122,3
7892.357748,7892.361748,1,voc,236770732,236770852,120,spec2/voc/Bl122_236770732.jpg,Bl122,3
9039.919241,9040.138241,1,voc,271197577,271204147,6570,spec2/voc/Bl122_271197577.jpg,Bl122,3
12654.394367,12654.660367,1,voc,379631831,379639811,7980,spec2/voc/Bl122_379631831.jpg,Bl122,3
6168.911327,6168.915327,1,voc,185067339,185067459,120,spec2/voc/Bl122_185067339.jpg,Bl122,3
11174.41518,11174.54818,1,voc,335232455,335236445,3990,spec2/voc/Bl122_335232455.jpg,Bl122,3
6070.963705,6070.976705,1,voc,182128911,182129301,390,spec2/voc/Bl122_182128911.jpg,Bl122,3
14625.032569,14625.035569,1,voc,438750977,438751067,90,spec2/voc/Bl122_438750977.jpg,Bl122,3
11148.09218,11148.24518,1,voc,334442765,334447355,4590,spec2/voc/Bl122_334442765.jpg,Bl122,3
10825.785452,10825.791452,1,voc,324773563,324773743,180,spec2/voc/Bl122_324773563.jpg,Bl122,3
6118.400706,6118.409706,1,voc,183552021,183552291,270,spec2/voc/Bl122_183552021.jpg,Bl122,3
6023.047533,6023.160533,1,voc,180691425,180694815,3390,spec2/voc/Bl122_180691425.jpg,Bl122,3
11175.33318,11175.34318,1,voc,335259995,335260295,300,spec2/voc/Bl122_335259995.jpg,Bl122,3
13815.755617,13815.888617,1,voc,414472668,414476658,3990,spec2/voc/Bl122_414472668.jpg,Bl122,3
10855.162233,10855.266233,1,voc,325654866,325657986,3120,spec2/voc/Bl122_325654866.jpg,Bl122,3
8998.378241,8998.421241,1,voc,269951347,269952637,1290,spec2/voc/Bl122_269951347.jpg,Bl122,3
8015.312748,8015.318748,1,voc,240459382,240459562,180,spec2/voc/Bl122_240459382.jpg,Bl122,3
13899.05163,13899.27063,1,voc,416971548,416978118,6570,spec2/voc/Bl122_416971548.jpg,Bl122,3
5956.648256,5956.654256,1,voc,178699447,178699627,180,spec2/voc/Bl122_178699447.jpg,Bl122,3
9122.418182,9122.420182,1,voc,273672545,273672605,60,spec2/voc/Bl122_273672545.jpg,Bl122,3
8947.087967,8947.437967,1,voc,268412639,268423139,10500,spec2/voc/Bl122_268412639.jpg,Bl122,3
6072.204705,6072.263705,1,voc,182166141,182167911,1770,spec2/voc/Bl122_182166141.jpg,Bl122,3
3861.877367,3861.924367,1,voc,115856321,115857731,1410,spec2/voc/Bl122_115856321.jpg,Bl122,3
3889.557652,3889.602652,1,voc,116686729,116688079,1350,spec2/voc/Bl122_116686729.jpg,Bl122,3
11134.613005,11134.618005,1,voc,334038390,334038540,150,spec2/voc/Bl122_334038390.jpg,Bl122,3
8025.946748,8025.984748,1,voc,240778402,240779542,1140,spec2/voc/Bl122_240778402.jpg,Bl122,3
6099.50715,6099.55815,1,voc,182985214,182986744,1530,spec2/voc/Bl122_182985214.jpg,Bl122,3
11194.22718,11194.23318,1,voc,335826815,335826995,180,spec2/voc/Bl122_335826815.jpg,Bl122,3
5958.226256,5958.434256,1,voc,178746787,178753027,6240,spec2/voc/Bl122_178746787.jpg,Bl122,3
6138.581293,6138.593293,1,voc,184157438,184157798,360,spec2/voc/Bl122_184157438.jpg,Bl122,3
13818.360617,13818.396617,1,voc,414550818,414551898,1080,spec2/voc/Bl122_414550818.jpg,Bl122,3
7897.417748,7897.428748,1,voc,236922532,236922862,330,spec2/voc/Bl122_236922532.jpg,Bl122,3
8201.994005,8202.306005,1,voc,246059820,246069180,9360,spec2/voc/Bl122_246059820.jpg,Bl122,3
7992.494748,7992.504748,1,voc,239774842,239775142,300,spec2/voc/Bl122_239774842.jpg,Bl122,3
10963.153807,10963.260807,1,voc,328894614,328897824,3210,spec2/voc/Bl122_328894614.jpg,Bl122,3
6051.7232,6051.7362,1,voc,181551696,181552086,390,spec2/voc/Bl122_181551696.jpg,Bl122,3
6092.17115,6092.17615,1,voc,182765134,182765284,150,spec2/voc/Bl122_182765134.jpg,Bl122,3
9038.142241,9038.208241,1,voc,271144267,271146247,1980,spec2/voc/Bl122_271144267.jpg,Bl122,3
11194.19018,11194.21818,1,voc,335825705,335826545,840,spec2/voc/Bl122_335825705.jpg,Bl122,3
9050.578241,9050.583241,1,voc,271517347,271517497,150,spec2/voc/Bl122_271517347.jpg,Bl122,3
7851.369748,7851.388748,1,voc,235541092,235541662,570,spec2/voc/Bl122_235541092.jpg,Bl122,3
7973.922748,7973.952748,1,voc,239217682,239218582,900,spec2/voc/Bl122_239217682.jpg,Bl122,3
11888.685845,11888.885845,1,voc,356660575,356666575,6000,spec2/voc/Bl122_356660575.jpg,Bl122,3
13206.056389,13206.065389,1,voc,396181691,396181961,270,spec2/voc/Bl122_396181691.jpg,Bl122,3
6030.172533,6030.361533,1,voc,180905175,180910845,5670,spec2/voc/Bl122_180905175.jpg,Bl122,3
11197.59418,11197.62918,1,voc,335927825,335928875,1050,spec2/voc/Bl122_335927825.jpg,Bl122,3
6012.572533,6012.619533,1,voc,180377175,180378585,1410,spec2/voc/Bl122_180377175.jpg,Bl122,3
7881.229748,7881.235748,1,voc,236436892,236437072,180,spec2/voc/Bl122_236436892.jpg,Bl122,3
5939.772256,5939.808256,1,voc,178193167,178194247,1080,spec2/voc/Bl122_178193167.jpg,Bl122,3
3810.592649,3810.738649,1,voc,114317779,114322159,4380,spec2/voc/Bl122_114317779.jpg,Bl122,3
5935.030256,5935.125256,1,voc,178050907,178053757,2850,spec2/voc/Bl122_178050907.jpg,Bl122,3
11164.41818,11164.50318,1,voc,334932545,334935095,2550,spec2/voc/Bl122_334932545.jpg,Bl122,3
10918.242807,10918.246807,1,voc,327547284,327547404,120,spec2/voc/Bl122_327547284.jpg,Bl122,3
13823.56622,13823.57022,1,voc,414706986,414707106,120,spec2/voc/Bl122_414706986.jpg,Bl122,3
7846.331748,7846.338748,1,voc,235389952,235390162,210,spec2/voc/Bl122_235389952.jpg,Bl122,3
14818.335551,14818.358551,1,voc,444550066,444550756,690,spec2/voc/Bl122_444550066.jpg,Bl122,3
9078.841241,9078.920241,1,voc,272365237,272367607,2370,spec2/voc/Bl122_272365237.jpg,Bl122,3
3876.572848,3876.578848,1,voc,116297185,116297365,180,spec2/voc/Bl122_116297185.jpg,Bl122,3
13170.392701,13170.400701,1,voc,395111781,395112021,240,spec2/voc/Bl122_395111781.jpg,Bl122,3
14812.273551,14812.287551,1,voc,444368206,444368626,420,spec2/voc/Bl122_444368206.jpg,Bl122,3
13554.259188,13554.435188,1,voc,406627775,406633055,5280,spec2/voc/Bl122_406627775.jpg,Bl122,3
13203.496389,13203.501389,1,voc,396104891,396105041,150,spec2/voc/Bl122_396104891.jpg,Bl122,3
8912.839773,8912.862773,1,voc,267385193,267385883,690,spec2/voc/Bl122_267385193.jpg,Bl122,3
3807.648649,3807.825649,1,voc,114229459,114234769,5310,spec2/voc/Bl122_114229459.jpg,Bl122,3
3851.341415,3851.363415,1,voc,115540242,115540902,660,spec2/voc/Bl122_115540242.jpg,Bl122,3
12677.61517,12677.65917,1,voc,380328455,380329775,1320,spec2/voc/Bl122_380328455.jpg,Bl122,3
3811.868649,3811.883649,1,voc,114356059,114356509,450,spec2/voc/Bl122_114356059.jpg,Bl122,3
14797.638551,14797.641551,1,voc,443929156,443929246,90,spec2/voc/Bl122_443929156.jpg,Bl122,3
7907.751748,7907.804748,1,voc,237232552,237234142,1590,spec2/voc/Bl122_237232552.jpg,Bl122,3
3814.155649,3814.333649,1,voc,114424669,114430009,5340,spec2/voc/Bl122_114424669.jpg,Bl122,3
14708.626469,14708.634469,1,voc,441258794,441259034,240,spec2/voc/Bl122_441258794.jpg,Bl122,3
5983.858256,5983.861256,1,voc,179515747,179515837,90,spec2/voc/Bl122_179515747.jpg,Bl122,3
7833.452748,7833.459748,1,voc,235003582,235003792,210,spec2/voc/Bl122_235003582.jpg,Bl122,3
5985.679256,5985.835256,1,voc,179570377,179575057,4680,spec2/voc/Bl122_179570377.jpg,Bl122,3
8004.115748,8004.134748,1,voc,240123472,240124042,570,spec2/voc/Bl122_240123472.jpg,Bl122,3
5961.702256,5961.744256,1,voc,178851067,178852327,1260,spec2/voc/Bl122_178851067.jpg,Bl122,3
6063.067705,6063.072705,1,voc,181892031,181892181,150,spec2/voc/Bl122_181892031.jpg,Bl122,3
6068.703705,6068.711705,1,voc,182061111,182061351,240,spec2/voc/Bl122_182061111.jpg,Bl122,3
6069.104705,6069.113705,1,voc,182073141,182073411,270,spec2/voc/Bl122_182073141.jpg,Bl122,3
13603.418736,13603.489736,1,voc,408102562,408104692,2130,spec2/voc/Bl122_408102562.jpg,Bl122,3
9070.849241,9070.868241,1,voc,272125477,272126047,570,spec2/voc/Bl122_272125477.jpg,Bl122,3
13951.253911,13951.257911,1,voc,418537617,418537737,120,spec2/voc/Bl122_418537617.jpg,Bl122,3
6183.259327,6183.263327,1,voc,185497779,185497899,120,spec2/voc/Bl122_185497779.jpg,Bl122,3
8915.240773,8915.246773,1,voc,267457223,267457403,180,spec2/voc/Bl122_267457223.jpg,Bl122,3
13818.790617,13818.800617,1,voc,414563718,414564018,300,spec2/voc/Bl122_414563718.jpg,Bl122,3
6159.541349,6159.614349,1,voc,184786240,184788430,2190,spec2/voc/Bl122_184786240.jpg,Bl122,3
9094.820241,9094.830241,1,voc,272844607,272844907,300,spec2/voc/Bl122_272844607.jpg,Bl122,3
6058.887705,6058.924705,1,voc,181766631,181767741,1110,spec2/voc/Bl122_181766631.jpg,Bl122,3
11194.32318,11194.35518,1,voc,335829695,335830655,960,spec2/voc/Bl122_335829695.jpg,Bl122,3
6048.7282,6048.7332,1,voc,181461846,181461996,150,spec2/voc/Bl122_181461846.jpg,Bl122,3
12598.466308,12598.468308,1,voc,377953989,377954049,60,spec2/voc/Bl122_377953989.jpg,Bl122,3
9073.534241,9073.591241,1,voc,272206027,272207737,1710,spec2/voc/Bl122_272206027.jpg,Bl122,3
10940.667807,10940.709807,1,voc,328220034,328221294,1260,spec2/voc/Bl122_328220034.jpg,Bl122,3
3836.622415,3836.717415,1,voc,115098672,115101522,2850,spec2/voc/Bl122_115098672.jpg,Bl122,3
11187.71218,11187.83818,1,voc,335631365,335635145,3780,spec2/voc/Bl122_335631365.jpg,Bl122,3
7810.836748,7810.846748,1,voc,234325102,234325402,300,spec2/voc/Bl122_234325102.jpg,Bl122,3
14782.039844,14782.043844,1,voc,443461195,443461315,120,spec2/voc/Bl122_443461195.jpg,Bl122,3
10897.127557,10897.130557,1,voc,326913826,326913916,90,spec2/voc/Bl122_326913826.jpg,Bl122,3
5967.887256,5967.906256,1,voc,179036617,179037187,570,spec2/voc/Bl122_179036617.jpg,Bl122,3
14795.465551,14795.487551,1,voc,443863966,443864626,660,spec2/voc/Bl122_443863966.jpg,Bl122,3
5972.084256,5972.091256,1,voc,179162527,179162737,210,spec2/voc/Bl122_179162527.jpg,Bl122,3
6099.94315,6099.96215,1,voc,182998294,182998864,570,spec2/voc/Bl122_182998294.jpg,Bl122,3
6032.792533,6032.816533,1,voc,180983775,180984495,720,spec2/voc/Bl122_180983775.jpg,Bl122,3
5937.815256,5937.911256,1,voc,178134457,178137337,2880,spec2/voc/Bl122_178134457.jpg,Bl122,3
8016.161748,8016.166748,1,voc,240484852,240485002,150,spec2/voc/Bl122_240484852.jpg,Bl122,3
9020.028241,9020.174241,1,voc,270600847,270605227,4380,spec2/voc/Bl122_270600847.jpg,Bl122,3
5934.616256,5934.644256,1,voc,178038487,178039327,840,spec2/voc/Bl122_178038487.jpg,Bl122,3
3826.980649,3827.016649,1,voc,114809419,114810499,1080,spec2/voc/Bl122_114809419.jpg,Bl122,3
8015.196748,8015.201748,1,voc,240455902,240456052,150,spec2/voc/Bl122_240455902.jpg,Bl122,3
6021.913533,6021.917533,1,voc,180657405,180657525,120,spec2/voc/Bl122_180657405.jpg,Bl122,3
12939.140352,12939.195352,1,voc,388174210,388175860,1650,spec2/voc/Bl122_388174210.jpg,Bl122,3
11152.82218,11153.04118,1,voc,334584665,334591235,6570,spec2/voc/Bl122_334584665.jpg,Bl122,3
3813.726649,3813.729649,1,voc,114411799,114411889,90,spec2/voc/Bl122_114411799.jpg,Bl122,3
6086.62215,6086.70515,1,voc,182598664,182601154,2490,spec2/voc/Bl122_182598664.jpg,Bl122,3
8924.040773,8924.064773,1,voc,267721223,267721943,720,spec2/voc/Bl122_267721223.jpg,Bl122,3
5942.620256,5942.624256,1,voc,178278607,178278727,120,spec2/voc/Bl122_178278607.jpg,Bl122,3
14174.511098,14174.542098,1,voc,425235332,425236262,930,spec2/voc/Bl122_425235332.jpg,Bl122,3
9054.857241,9054.862241,1,voc,271645717,271645867,150,spec2/voc/Bl122_271645717.jpg,Bl122,3
6027.736533,6027.794533,1,voc,180832095,180833835,1740,spec2/voc/Bl122_180832095.jpg,Bl122,3
7941.705748,7941.709748,1,voc,238251172,238251292,120,spec2/voc/Bl122_238251172.jpg,Bl122,3
6171.324327,6171.369327,1,voc,185139729,185141079,1350,spec2/voc/Bl122_185139729.jpg,Bl122,3
5958.441256,5958.447256,1,voc,178753237,178753417,180,spec2/voc/Bl122_178753237.jpg,Bl122,3
3844.090415,3844.313415,1,voc,115322712,115329402,6690,spec2/voc/Bl122_115322712.jpg,Bl122,3
11145.180955,11145.262955,1,voc,334355428,334357888,2460,spec2/voc/Bl122_334355428.jpg,Bl122,3
6015.232533,6015.362533,1,voc,180456975,180460875,3900,spec2/voc/Bl122_180456975.jpg,Bl122,3
3796.695649,3796.697649,1,voc,113900869,113900929,60,spec2/voc/Bl122_113900869.jpg,Bl122,3
9076.524241,9076.695241,1,voc,272295727,272300857,5130,spec2/voc/Bl122_272295727.jpg,Bl122,3
12932.42429,12932.42929,1,voc,387972728,387972878,150,spec2/voc/Bl122_387972728.jpg,Bl122,3
6058.179705,6058.233705,1,voc,181745391,181747011,1620,spec2/voc/Bl122_181745391.jpg,Bl122,3
13206.334389,13206.337389,1,voc,396190031,396190121,90,spec2/voc/Bl122_396190031.jpg,Bl122,3
9008.619241,9008.629241,1,voc,270258577,270258877,300,spec2/voc/Bl122_270258577.jpg,Bl122,3
6226.577295,6226.700295,1,voc,186797318,186801008,3690,spec2/voc/Bl122_186797318.jpg,Bl122,3
14825.158551,14825.166551,1,voc,444754756,444754996,240,spec2/voc/Bl122_444754756.jpg,Bl122,3
9064.660241,9064.682241,1,voc,271939807,271940467,660,spec2/voc/Bl122_271939807.jpg,Bl122,3
13587.102236,13587.107236,1,voc,407613067,407613217,150,spec2/voc/Bl122_407613067.jpg,Bl122,3
13988.567864,13988.571864,1,voc,419657035,419657155,120,spec2/voc/Bl122_419657035.jpg,Bl122,3
3850.483415,3850.492415,1,voc,115514502,115514772,270,spec2/voc/Bl122_115514502.jpg,Bl122,3
8930.229773,8930.235773,1,voc,267906893,267907073,180,spec2/voc/Bl122_267906893.jpg,Bl122,3
9049.325241,9049.329241,1,voc,271479757,271479877,120,spec2/voc/Bl122_271479757.jpg,Bl122,3
6113.491706,6113.945706,1,voc,183404751,183418371,13620,spec2/voc/Bl122_183404751.jpg,Bl122,3
6168.660327,6168.682327,1,voc,185059809,185060469,660,spec2/voc/Bl122_185059809.jpg,Bl122,3
3881.026062,3881.036062,1,voc,116430781,116431081,300,spec2/voc/Bl122_116430781.jpg,Bl122,3
6032.179533,6032.181533,1,voc,180965385,180965445,60,spec2/voc/Bl122_180965385.jpg,Bl122,3
11181.10418,11181.13018,1,voc,335433125,335433905,780,spec2/voc/Bl122_335433125.jpg,Bl122,3
6147.200349,6147.561349,1,voc,184416010,184426840,10830,spec2/voc/Bl122_184416010.jpg,Bl122,3
13208.170389,13208.202389,1,voc,396245111,396246071,960,spec2/voc/Bl122_396245111.jpg,Bl122,3
10923.059807,10923.089807,1,voc,327691794,327692694,900,spec2/voc/Bl122_327691794.jpg,Bl122,3
5965.429256,5965.437256,1,voc,178962877,178963117,240,spec2/voc/Bl122_178962877.jpg,Bl122,3
8026.678748,8026.686748,1,voc,240800362,240800602,240,spec2/voc/Bl122_240800362.jpg,Bl122,3
6091.18715,6091.40415,1,voc,182735614,182742124,6510,spec2/voc/Bl122_182735614.jpg,Bl122,3
9072.529241,9072.616241,1,voc,272175877,272178487,2610,spec2/voc/Bl122_272175877.jpg,Bl122,3
9004.682241,9004.705241,1,voc,270140467,270141157,690,spec2/voc/Bl122_270140467.jpg,Bl122,3
13912.514482,13912.602482,1,voc,417375434,417378074,2640,spec2/voc/Bl122_417375434.jpg,Bl122,3
11977.149797,11977.310797,1,voc,359314493,359319323,4830,spec2/voc/Bl122_359314493.jpg,Bl122,3
3824.552649,3824.580649,1,voc,114736579,114737419,840,spec2/voc/Bl122_114736579.jpg,Bl122,3
9151.282842,9151.488842,1,voc,274538485,274544665,6180,spec2/voc/Bl122_274538485.jpg,Bl122,3
6034.158533,6034.361533,1,voc,181024755,181030845,6090,spec2/voc/Bl122_181024755.jpg,Bl122,3
6005.026256,6005.032256,1,voc,180150787,180150967,180,spec2/voc/Bl122_180150787.jpg,Bl122,3
11050.491,11050.589,1,voc,331514730,331517670,2940,spec2/voc/Bl122_331514730.jpg,Bl122,3
8023.218748,8023.239748,1,voc,240696562,240697192,630,spec2/voc/Bl122_240696562.jpg,Bl122,3
5973.483256,5973.737256,1,voc,179204497,179212117,7620,spec2/voc/Bl122_179204497.jpg,Bl122,3
12592.254947,12592.259947,1,voc,377767648,377767798,150,spec2/voc/Bl122_377767648.jpg,Bl122,3
7875.916748,7875.927748,1,voc,236277502,236277832,330,spec2/voc/Bl122_236277502.jpg,Bl122,3
13244.507606,13244.526606,1,voc,397335228,397335798,570,spec2/voc/Bl122_397335228.jpg,Bl122,3
10896.947557,10897.038557,1,voc,326908426,326911156,2730,spec2/voc/Bl122_326908426.jpg,Bl122,3
3841.256415,3841.261415,1,voc,115237692,115237842,150,spec2/voc/Bl122_115237692.jpg,Bl122,3
6182.089327,6182.159327,1,voc,185462679,185464779,2100,spec2/voc/Bl122_185462679.jpg,Bl122,3
10915.147807,10915.155807,1,voc,327454434,327454674,240,spec2/voc/Bl122_327454434.jpg,Bl122,3
9084.707241,9084.720241,1,voc,272541217,272541607,390,spec2/voc/Bl122_272541217.jpg,Bl122,3
6056.874705,6056.879705,1,voc,181706241,181706391,150,spec2/voc/Bl122_181706241.jpg,Bl122,3
13207.105389,13207.143389,1,voc,396213161,396214301,1140,spec2/voc/Bl122_396213161.jpg,Bl122,3
5965.441256,5965.462256,1,voc,178963237,178963867,630,spec2/voc/Bl122_178963237.jpg,Bl122,3
10930.137807,10930.142807,1,voc,327904134,327904284,150,spec2/voc/Bl122_327904134.jpg,Bl122,3
13947.139911,13947.157911,1,voc,418414197,418414737,540,spec2/voc/Bl122_418414197.jpg,Bl122,3
10842.125842,10842.167842,1,voc,325263775,325265035,1260,spec2/voc/Bl122_325263775.jpg,Bl122,3
6032.926533,6032.946533,1,voc,180987795,180988395,600,spec2/voc/Bl122_180987795.jpg,Bl122,3
7901.132748,7901.177748,1,voc,237033982,237035332,1350,spec2/voc/Bl122_237033982.jpg,Bl122,3
5948.775256,5948.929256,1,voc,178463257,178467877,4620,spec2/voc/Bl122_178463257.jpg,Bl122,3
14805.276551,14805.393551,1,voc,444158296,444161806,3510,spec2/voc/Bl122_444158296.jpg,Bl122,3
10958.078807,10958.107807,1,voc,328742364,328743234,870,spec2/voc/Bl122_328742364.jpg,Bl122,3
10938.229807,10938.239807,1,voc,328146894,328147194,300,spec2/voc/Bl122_328146894.jpg,Bl122,3
9021.650241,9021.653241,1,voc,270649507,270649597,90,spec2/voc/Bl122_270649507.jpg,Bl122,3
9025.497241,9025.731241,1,voc,270764917,270771937,7020,spec2/voc/Bl122_270764917.jpg,Bl122,3
8009.405748,8009.420748,1,voc,240282172,240282622,450,spec2/voc/Bl122_240282172.jpg,Bl122,3
11202.246894,11202.250894,1,voc,336067406,336067526,120,spec2/voc/Bl122_336067406.jpg,Bl122,3
3043.303929,3043.521929,1,voc,91299117,91305657,6540,spec2/voc/Bl122_91299117.jpg,Bl122,3
3176.465448,3176.511448,1,voc,95293963,95295343,1380,spec2/voc/Bl122_95293963.jpg,Bl122,3
14334.723707,14334.767707,1,voc,430041711,430043031,1320,spec2/voc/Bl122_430041711.jpg,Bl122,3
9026.558241,9026.635241,1,voc,270796747,270799057,2310,spec2/voc/Bl122_270796747.jpg,Bl122,3
6199.757327,6199.803327,1,voc,185992719,185994099,1380,spec2/voc/Bl122_185992719.jpg,Bl122,3
6024.493533,6024.560533,1,voc,180734805,180736815,2010,spec2/voc/Bl122_180734805.jpg,Bl122,3
5983.426256,5983.444256,1,voc,179502787,179503327,540,spec2/voc/Bl122_179502787.jpg,Bl122,3
5951.451256,5951.457256,1,voc,178543537,178543717,180,spec2/voc/Bl122_178543537.jpg,Bl122,3
7862.059748,7862.089748,1,voc,235861792,235862692,900,spec2/voc/Bl122_235861792.jpg,Bl122,3
8947.881967,8947.892967,1,voc,268436459,268436789,330,spec2/voc/Bl122_268436459.jpg,Bl122,3
13812.668352,13812.673352,1,voc,414380050,414380200,150,spec2/voc/Bl122_414380050.jpg,Bl122,3
13826.34022,13826.35722,1,voc,414790206,414790716,510,spec2/voc/Bl122_414790206.jpg,Bl122,3
14825.694551,14825.713551,1,voc,444770836,444771406,570,spec2/voc/Bl122_444770836.jpg,Bl122,3
6017.772533,6017.787533,1,voc,180533175,180533625,450,spec2/voc/Bl122_180533175.jpg,Bl122,3
11200.174894,11200.325894,1,voc,336005246,336009776,4530,spec2/voc/Bl122_336005246.jpg,Bl122,3
3828.414649,3828.418649,1,voc,114852439,114852559,120,spec2/voc/Bl122_114852439.jpg,Bl122,3
14809.381551,14809.472551,1,voc,444281446,444284176,2730,spec2/voc/Bl122_444281446.jpg,Bl122,3
13605.602736,13605.619736,1,voc,408168082,408168592,510,spec2/voc/Bl122_408168082.jpg,Bl122,3
7885.477748,7885.483748,1,voc,236564332,236564512,180,spec2/voc/Bl122_236564332.jpg,Bl122,3
3829.065649,3829.074649,1,voc,114871969,114872239,270,spec2/voc/Bl122_114871969.jpg,Bl122,3
6063.576705,6063.741705,1,voc,181907301,181912251,4950,spec2/voc/Bl122_181907301.jpg,Bl122,3
11208.836894,11208.855894,1,voc,336265106,336265676,570,spec2/voc/Bl122_336265106.jpg,Bl122,3
7853.292748,7853.295748,1,voc,235598782,235598872,90,spec2/voc/Bl122_235598782.jpg,Bl122,3
8938.541967,8938.597967,1,voc,268156259,268157939,1680,spec2/voc/Bl122_268156259.jpg,Bl122,3
6026.673533,6026.733533,1,voc,180800205,180802005,1800,spec2/voc/Bl122_180800205.jpg,Bl122,3
5933.116256,5933.201256,1,voc,177993487,177996037,2550,spec2/voc/Bl122_177993487.jpg,Bl122,3
7985.886748,7985.900748,1,voc,239576602,239577022,420,spec2/voc/Bl122_239576602.jpg,Bl122,3
12670.427513,12670.494513,1,voc,380112825,380114835,2010,spec2/voc/Bl122_380112825.jpg,Bl122,3
8939.454967,8939.485967,1,voc,268183649,268184579,930,spec2/voc/Bl122_268183649.jpg,Bl122,3
3816.038649,3816.147649,1,voc,114481159,114484429,3270,spec2/voc/Bl122_114481159.jpg,Bl122,3
5951.860256,5951.872256,1,voc,178555807,178556167,360,spec2/voc/Bl122_178555807.jpg,Bl122,3
6071.462705,6071.483705,1,voc,182143881,182144511,630,spec2/voc/Bl122_182143881.jpg,Bl122,3
5267.570487,5267.745487,1,voc,158027114,158032364,5250,spec2/voc/Bl122_158027114.jpg,Bl122,3
10945.068807,10945.142807,1,voc,328352064,328354284,2220,spec2/voc/Bl122_328352064.jpg,Bl122,3
10914.059807,10914.090807,1,voc,327421794,327422724,930,spec2/voc/Bl122_327421794.jpg,Bl122,3
6066.985705,6066.989705,1,voc,182009571,182009691,120,spec2/voc/Bl122_182009571.jpg,Bl122,3
7847.911748,7847.927748,1,voc,235437352,235437832,480,spec2/voc/Bl122_235437352.jpg,Bl122,3
7902.403748,7902.412748,1,voc,237072112,237072382,270,spec2/voc/Bl122_237072112.jpg,Bl122,3
10951.839807,10951.843807,1,voc,328555194,328555314,120,spec2/voc/Bl122_328555194.jpg,Bl122,3
9131.227981,9131.284981,1,voc,273936839,273938549,1710,spec2/voc/Bl122_273936839.jpg,Bl122,3
9143.212757,9143.624757,1,voc,274296382,274308742,12360,spec2/voc/Bl122_274296382.jpg,Bl122,3
12939.545352,12939.596352,1,voc,388186360,388187890,1530,spec2/voc/Bl122_388186360.jpg,Bl122,3
5978.299256,5978.309256,1,voc,179348977,179349277,300,spec2/voc/Bl122_179348977.jpg,Bl122,3
13824.67122,13824.68022,1,voc,414740136,414740406,270,spec2/voc/Bl122_414740136.jpg,Bl122,3
7856.905748,7856.922748,1,voc,235707172,235707682,510,spec2/voc/Bl122_235707172.jpg,Bl122,3
9064.876241,9064.911241,1,voc,271946287,271947337,1050,spec2/voc/Bl122_271946287.jpg,Bl122,3
6051.2392,6051.3062,1,voc,181537176,181539186,2010,spec2/voc/Bl122_181537176.jpg,Bl122,3
9051.315241,9051.320241,1,voc,271539457,271539607,150,spec2/voc/Bl122_271539457.jpg,Bl122,3
6036.358533,6036.361533,1,voc,181090755,181090845,90,spec2/voc/Bl122_181090755.jpg,Bl122,3
6019.527533,6019.532533,1,voc,180585825,180585975,150,spec2/voc/Bl122_180585825.jpg,Bl122,3
11166.81818,11166.85018,1,voc,335004545,335005505,960,spec2/voc/Bl122_335004545.jpg,Bl122,3
10885.399162,10885.409162,1,voc,326561974,326562274,300,spec2/voc/Bl122_326561974.jpg,Bl122,3
8957.292967,8957.505967,1,voc,268718789,268725179,6390,spec2/voc/Bl122_268718789.jpg,Bl122,3
13176.585701,13176.587701,1,voc,395297571,395297631,60,spec2/voc/Bl122_395297571.jpg,Bl122,3
3869.035367,3869.078367,1,voc,116071061,116072351,1290,spec2/voc/Bl122_116071061.jpg,Bl122,3
10937.868807,10937.874807,1,voc,328136064,328136244,180,spec2/voc/Bl122_328136064.jpg,Bl122,3
6011.429533,6011.433533,1,voc,180342885,180343005,120,spec2/voc/Bl122_180342885.jpg,Bl122,3
5936.953256,5936.975256,1,voc,178108597,178109257,660,spec2/voc/Bl122_178108597.jpg,Bl122,3
14340.890137,14341.050137,1,voc,430226704,430231504,4800,spec2/voc/Bl122_430226704.jpg,Bl122,3
5980.865256,5980.870256,1,voc,179425957,179426107,150,spec2/voc/Bl122_179425957.jpg,Bl122,3
11901.836225,11901.994225,1,voc,357055086,357059826,4740,spec2/voc/Bl122_357055086.jpg,Bl122,3
5969.388256,5969.447256,1,voc,179081647,179083417,1770,spec2/voc/Bl122_179081647.jpg,Bl122,3
3843.979415,3843.982415,1,voc,115319382,115319472,90,spec2/voc/Bl122_115319382.jpg,Bl122,3
7990.206748,7990.215748,1,voc,239706202,239706472,270,spec2/voc/Bl122_239706202.jpg,Bl122,3
9114.026184,9114.088184,1,voc,273420785,273422645,1860,spec2/voc/Bl122_273420785.jpg,Bl122,3
8915.885773,8915.892773,1,voc,267476573,267476783,210,spec2/voc/Bl122_267476573.jpg,Bl122,3
8993.572241,8993.605241,1,voc,269807167,269808157,990,spec2/voc/Bl122_269807167.jpg,Bl122,3
11050.262,11050.374,1,voc,331507860,331511220,3360,spec2/voc/Bl122_331507860.jpg,Bl122,3
6030.614533,6030.627533,1,voc,180918435,180918825,390,spec2/voc/Bl122_180918435.jpg,Bl122,3
7902.446748,7902.450748,1,voc,237073402,237073522,120,spec2/voc/Bl122_237073402.jpg,Bl122,3
9048.414241,9048.421241,1,voc,271452427,271452637,210,spec2/voc/Bl122_271452427.jpg,Bl122,3
13811.558352,13811.763352,1,voc,414346750,414352900,6150,spec2/voc/Bl122_414346750.jpg,Bl122,3
5985.991256,5986.021256,1,voc,179579737,179580637,900,spec2/voc/Bl122_179579737.jpg,Bl122,3
9064.352241,9064.419241,1,voc,271930567,271932577,2010,spec2/voc/Bl122_271930567.jpg,Bl122,3
9073.950241,9073.967241,1,voc,272218507,272219017,510,spec2/voc/Bl122_272218507.jpg,Bl122,3
13938.7889,13938.7929,1,voc,418163667,418163787,120,spec2/voc/Bl122_418163667.jpg,Bl122,3
8915.961773,8915.967773,1,voc,267478853,267479033,180,spec2/voc/Bl122_267478853.jpg,Bl122,3
14201.205387,14201.440387,1,voc,426036161,426043211,7050,spec2/voc/Bl122_426036161.jpg,Bl122,3
7796.890516,7796.935516,1,voc,233906715,233908065,1350,spec2/voc/Bl122_233906715.jpg,Bl122,3
10841.732842,10841.844842,1,voc,325251985,325255345,3360,spec2/voc/Bl122_325251985.jpg,Bl122,3
9034.913241,9034.923241,1,voc,271047397,271047697,300,spec2/voc/Bl122_271047397.jpg,Bl122,3
6196.596327,6196.644327,1,voc,185897889,185899329,1440,spec2/voc/Bl122_185897889.jpg,Bl122,3
6186.236327,6186.373327,1,voc,185587089,185591199,4110,spec2/voc/Bl122_185587089.jpg,Bl122,3
6062.986705,6062.996705,1,voc,181889601,181889901,300,spec2/voc/Bl122_181889601.jpg,Bl122,3
13984.369943,13984.477943,1,voc,419531098,419534338,3240,spec2/voc/Bl122_419531098.jpg,Bl122,3
6184.176327,6184.212327,1,voc,185525289,185526369,1080,spec2/voc/Bl122_185525289.jpg,Bl122,3
13812.328352,13812.431352,1,voc,414369850,414372940,3090,spec2/voc/Bl122_414369850.jpg,Bl122,3
7860.575748,7860.580748,1,voc,235817272,235817422,150,spec2/voc/Bl122_235817272.jpg,Bl122,3
14819.253551,14819.279551,1,voc,444577606,444578386,780,spec2/voc/Bl122_444577606.jpg,Bl122,3
9049.045241,9049.077241,1,voc,271471357,271472317,960,spec2/voc/Bl122_271471357.jpg,Bl122,3
7984.439748,7984.445748,1,voc,239533192,239533372,180,spec2/voc/Bl122_239533192.jpg,Bl122,3
7912.342748,7912.344748,1,voc,237370282,237370342,60,spec2/voc/Bl122_237370282.jpg,Bl122,3
9060.989241,9061.239241,1,voc,271829677,271837177,7500,spec2/voc/Bl122_271829677.jpg,Bl122,3
6228.206295,6228.254295,1,voc,186846188,186847628,1440,spec2/voc/Bl122_186846188.jpg,Bl122,3
13952.737911,13952.742911,1,voc,418582137,418582287,150,spec2/voc/Bl122_418582137.jpg,Bl122,3
5974.667256,5974.680256,1,voc,179240017,179240407,390,spec2/voc/Bl122_179240017.jpg,Bl122,3
10906.433825,10906.439825,1,voc,327193014,327193194,180,spec2/voc/Bl122_327193014.jpg,Bl122,3
6180.299327,6180.410327,1,voc,185408979,185412309,3330,spec2/voc/Bl122_185408979.jpg,Bl122,3
14804.805551,14804.814551,1,voc,444144166,444144436,270,spec2/voc/Bl122_444144166.jpg,Bl122,3
6077.420705,6077.442705,1,voc,182322621,182323281,660,spec2/voc/Bl122_182322621.jpg,Bl122,3
6084.69615,6084.70415,1,voc,182540884,182541124,240,spec2/voc/Bl122_182540884.jpg,Bl122,3
9069.350241,9069.422241,1,voc,272080507,272082667,2160,spec2/voc/Bl122_272080507.jpg,Bl122,3
6132.878293,6132.935293,1,voc,183986348,183988058,1710,spec2/voc/Bl122_183986348.jpg,Bl122,3
11904.991332,11905.027332,1,voc,357149739,357150819,1080,spec2/voc/Bl122_357149739.jpg,Bl122,3
13580.094236,13580.098236,1,voc,407402827,407402947,120,spec2/voc/Bl122_407402827.jpg,Bl122,3
9059.748241,9059.898241,1,voc,271792447,271796947,4500,spec2/voc/Bl122_271792447.jpg,Bl122,3
7938.208748,7938.288748,1,voc,238146262,238148662,2400,spec2/voc/Bl122_238146262.jpg,Bl122,3
10955.220807,10955.233807,1,voc,328656624,328657014,390,spec2/voc/Bl122_328656624.jpg,Bl122,3
7875.108748,7875.120748,1,voc,236253262,236253622,360,spec2/voc/Bl122_236253262.jpg,Bl122,3
6057.173705,6057.330705,1,voc,181715211,181719921,4710,spec2/voc/Bl122_181715211.jpg,Bl122,3
7960.434748,7960.465748,1,voc,238813042,238813972,930,spec2/voc/Bl122_238813042.jpg,Bl122,3
11162.67118,11162.81018,1,voc,334880135,334884305,4170,spec2/voc/Bl122_334880135.jpg,Bl122,3
11194.90718,11194.91118,1,voc,335847215,335847335,120,spec2/voc/Bl122_335847215.jpg,Bl122,3
13172.445701,13172.468701,1,voc,395173371,395174061,690,spec2/voc/Bl122_395173371.jpg,Bl122,3
7881.311748,7881.327748,1,voc,236439352,236439832,480,spec2/voc/Bl122_236439352.jpg,Bl122,3
13574.740572,13574.743572,1,voc,407242217,407242307,90,spec2/voc/Bl122_407242217.jpg,Bl122,3
7843.594748,7843.599748,1,voc,235307842,235307992,150,spec2/voc/Bl122_235307842.jpg,Bl122,3
7846.703748,7846.721748,1,voc,235401112,235401652,540,spec2/voc/Bl122_235401112.jpg,Bl122,3
10940.580807,10940.613807,1,voc,328217424,328218414,990,spec2/voc/Bl122_328217424.jpg,Bl122,3
9050.829241,9050.836241,1,voc,271524877,271525087,210,spec2/voc/Bl122_271524877.jpg,Bl122,3
13599.312736,13599.441736,1,voc,407979382,407983252,3870,spec2/voc/Bl122_407979382.jpg,Bl122,3
13743.455896,13743.829896,1,voc,412303676,412314896,11220,spec2/voc/Bl122_412303676.jpg,Bl122,3
13722.9759,13723.0539,1,voc,411689277,411691617,2340,spec2/voc/Bl122_411689277.jpg,Bl122,3
10887.756136,10887.780136,1,voc,326632684,326633404,720,spec2/voc/Bl122_326632684.jpg,Bl122,3
9046.561241,9046.688241,1,voc,271396837,271400647,3810,spec2/voc/Bl122_271396837.jpg,Bl122,3
7842.303748,7842.349748,1,voc,235269112,235270492,1380,spec2/voc/Bl122_235269112.jpg,Bl122,3
9003.650241,9003.687241,1,voc,270109507,270110617,1110,spec2/voc/Bl122_270109507.jpg,Bl122,3
11196.43318,11196.45818,1,voc,335892995,335893745,750,spec2/voc/Bl122_335892995.jpg,Bl122,3
9082.511241,9082.514241,1,voc,272475337,272475427,90,spec2/voc/Bl122_272475337.jpg,Bl122,3
6062.999705,6063.021705,1,voc,181889991,181890651,660,spec2/voc/Bl122_181889991.jpg,Bl122,3
13956.164384,13956.217384,1,voc,418684931,418686521,1590,spec2/voc/Bl122_418684931.jpg,Bl122,3
6092.10315,6092.13915,1,voc,182763094,182764174,1080,spec2/voc/Bl122_182763094.jpg,Bl122,3
9087.746241,9087.788241,1,voc,272632387,272633647,1260,spec2/voc/Bl122_272632387.jpg,Bl122,3
11917.778682,11917.940682,1,voc,357533360,357538220,4860,spec2/voc/Bl122_357533360.jpg,Bl122,3
3792.107649,3792.187649,1,voc,113763229,113765629,2400,spec2/voc/Bl122_113763229.jpg,Bl122,3
14175.567361,14175.596361,1,voc,425267020,425267890,870,spec2/voc/Bl122_425267020.jpg,Bl122,3
7942.692748,7942.696748,1,voc,238280782,238280902,120,spec2/voc/Bl122_238280782.jpg,Bl122,3
9061.626241,9061.767241,1,voc,271848787,271853017,4230,spec2/voc/Bl122_271848787.jpg,Bl122,3
7928.591748,7928.602748,1,voc,237857752,237858082,330,spec2/voc/Bl122_237857752.jpg,Bl122,3
7887.044748,7887.049748,1,voc,236611342,236611492,150,spec2/voc/Bl122_236611342.jpg,Bl122,3
10915.161807,10915.167807,1,voc,327454854,327455034,180,spec2/voc/Bl122_327454854.jpg,Bl122,3
11181.32718,11181.35418,1,voc,335439815,335440625,810,spec2/voc/Bl122_335439815.jpg,Bl122,3
11186.71718,11186.78318,1,voc,335601515,335603495,1980,spec2/voc/Bl122_335601515.jpg,Bl122,3
6185.240327,6185.410327,1,voc,185557209,185562309,5100,spec2/voc/Bl122_185557209.jpg,Bl122,3
3820.513649,3820.541649,1,voc,114615409,114616249,840,spec2/voc/Bl122_114615409.jpg,Bl122,3
6196.093327,6196.201327,1,voc,185882799,185886039,3240,spec2/voc/Bl122_185882799.jpg,Bl122,3
8915.711773,8915.721773,1,voc,267471353,267471653,300,spec2/voc/Bl122_267471353.jpg,Bl122,3
8008.503748,8008.509748,1,voc,240255112,240255292,180,spec2/voc/Bl122_240255112.jpg,Bl122,3
11895.108847,11895.111847,1,voc,356853265,356853355,90,spec2/voc/Bl122_356853265.jpg,Bl122,3
13977.174117,13977.202117,1,voc,419315223,419316063,840,spec2/voc/Bl122_419315223.jpg,Bl122,3
10925.711807,10925.762807,1,voc,327771354,327772884,1530,spec2/voc/Bl122_327771354.jpg,Bl122,3
6033.038533,6033.093533,1,voc,180991155,180992805,1650,spec2/voc/Bl122_180991155.jpg,Bl122,3
13947.925911,13947.940911,1,voc,418437777,418438227,450,spec2/voc/Bl122_418437777.jpg,Bl122,3
8966.775712,8966.786712,1,voc,269003271,269003601,330,spec2/voc/Bl122_269003271.jpg,Bl122,3
3822.227649,3822.234649,1,voc,114666829,114667039,210,spec2/voc/Bl122_114666829.jpg,Bl122,3
9016.647241,9016.649241,1,voc,270499417,270499477,60,spec2/voc/Bl122_270499417.jpg,Bl122,3
11203.383894,11203.407894,1,voc,336101516,336102236,720,spec2/voc/Bl122_336101516.jpg,Bl122,3
14155.078825,14155.081825,1,voc,424652364,424652454,90,spec2/voc/Bl122_424652364.jpg,Bl122,3
3797.162649,3797.165649,1,voc,113914879,113914969,90,spec2/voc/Bl122_113914879.jpg,Bl122,3
5989.028256,5989.071256,1,voc,179670847,179672137,1290,spec2/voc/Bl122_179670847.jpg,Bl122,3
5974.770256,5974.919256,1,voc,179243107,179247577,4470,spec2/voc/Bl122_179243107.jpg,Bl122,3
14149.745855,14149.969855,1,voc,424492375,424499095,6720,spec2/voc/Bl122_424492375.jpg,Bl122,3
13958.371384,13958.436384,1,voc,418751141,418753091,1950,spec2/voc/Bl122_418751141.jpg,Bl122,3
12672.062513,12672.069513,1,voc,380161875,380162085,210,spec2/voc/Bl122_380161875.jpg,Bl122,3
5961.097256,5961.120256,1,voc,178832917,178833607,690,spec2/voc/Bl122_178832917.jpg,Bl122,3
7853.298748,7853.316748,1,voc,235598962,235599502,540,spec2/voc/Bl122_235598962.jpg,Bl122,3
6175.841327,6175.863327,1,voc,185275239,185275899,660,spec2/voc/Bl122_185275239.jpg,Bl122,3
8995.413241,8995.437241,1,voc,269862397,269863117,720,spec2/voc/Bl122_269862397.jpg,Bl122,3
7983.267748,7983.276748,1,voc,239498032,239498302,270,spec2/voc/Bl122_239498032.jpg,Bl122,3
10902.763825,10902.904825,1,voc,327082914,327087144,4230,spec2/voc/Bl122_327082914.jpg,Bl122,3
8026.630748,8026.634748,1,voc,240798922,240799042,120,spec2/voc/Bl122_240798922.jpg,Bl122,3
8361.882263,8361.937263,1,voc,250856467,250858117,1650,spec2/voc/Bl122_250856467.jpg,Bl122,3
3808.884649,3808.891649,1,voc,114266539,114266749,210,spec2/voc/Bl122_114266539.jpg,Bl122,3
13188.586662,13188.590662,1,voc,395657599,395657719,120,spec2/voc/Bl122_395657599.jpg,Bl122,3
8011.585748,8011.589748,1,voc,240347572,240347692,120,spec2/voc/Bl122_240347572.jpg,Bl122,3
10956.251807,10956.547807,1,voc,328687554,328696434,8880,spec2/voc/Bl122_328687554.jpg,Bl122,3
8954.412967,8954.611967,1,voc,268632389,268638359,5970,spec2/voc/Bl122_268632389.jpg,Bl122,3
10854.698233,10854.788233,1,voc,325640946,325643646,2700,spec2/voc/Bl122_325640946.jpg,Bl122,3
8919.886773,8919.914773,1,voc,267596603,267597443,840,spec2/voc/Bl122_267596603.jpg,Bl122,3
9059.404241,9059.412241,1,voc,271782127,271782367,240,spec2/voc/Bl122_271782127.jpg,Bl122,3
13179.104701,13179.111701,1,voc,395373141,395373351,210,spec2/voc/Bl122_395373141.jpg,Bl122,3
3839.695415,3839.699415,1,voc,115190862,115190982,120,spec2/voc/Bl122_115190862.jpg,Bl122,3
11167.26618,11167.39418,1,voc,335017985,335021825,3840,spec2/voc/Bl122_335017985.jpg,Bl122,3
6143.414349,6143.431349,1,voc,184302430,184302940,510,spec2/voc/Bl122_184302430.jpg,Bl122,3
6024.297533,6024.435533,1,voc,180728925,180733065,4140,spec2/voc/Bl122_180728925.jpg,Bl122,3
8033.215748,8033.236748,1,voc,240996472,240997102,630,spec2/voc/Bl122_240996472.jpg,Bl122,3
9052.857241,9053.174241,1,voc,271585717,271595227,9510,spec2/voc/Bl122_271585717.jpg,Bl122,3
13193.332662,13193.348662,1,voc,395799979,395800459,480,spec2/voc/Bl122_395799979.jpg,Bl122,3
3807.983649,3808.106649,1,voc,114239509,114243199,3690,spec2/voc/Bl122_114239509.jpg,Bl122,3
3824.692649,3824.701649,1,voc,114740779,114741049,270,spec2/voc/Bl122_114740779.jpg,Bl122,3
11194.72518,11194.74918,1,voc,335841755,335842475,720,spec2/voc/Bl122_335841755.jpg,Bl122,3
13824.89722,13824.97922,1,voc,414746916,414749376,2460,spec2/voc/Bl122_414746916.jpg,Bl122,3
10913.538807,10913.670807,1,voc,327406164,327410124,3960,spec2/voc/Bl122_327406164.jpg,Bl122,3
5939.942256,5939.976256,1,voc,178198267,178199287,1020,spec2/voc/Bl122_178198267.jpg,Bl122,3
14335.025707,14335.028707,1,voc,430050771,430050861,90,spec2/voc/Bl122_430050771.jpg,Bl122,3
11156.06818,11156.07318,1,voc,334682045,334682195,150,spec2/voc/Bl122_334682045.jpg,Bl122,3
5964.334256,5964.338256,1,voc,178930027,178930147,120,spec2/voc/Bl122_178930027.jpg,Bl122,3
6175.717327,6175.720327,1,voc,185271519,185271609,90,spec2/voc/Bl122_185271519.jpg,Bl122,3
6114.966706,6115.227706,1,voc,183449001,183456831,7830,spec2/voc/Bl122_183449001.jpg,Bl122,3
9085.224241,9085.233241,1,voc,272556727,272556997,270,spec2/voc/Bl122_272556727.jpg,Bl122,3
6027.681533,6027.693533,1,voc,180830445,180830805,360,spec2/voc/Bl122_180830445.jpg,Bl122,3
3043.291929,3043.295929,1,voc,91298757,91298877,120,spec2/voc/Bl122_91298757.jpg,Bl122,3
7999.289748,7999.367748,1,voc,239978692,239981032,2340,spec2/voc/Bl122_239978692.jpg,Bl122,3
6223.588295,6223.637295,1,voc,186707648,186709118,1470,spec2/voc/Bl122_186707648.jpg,Bl122,3
6040.759065,6040.813065,1,voc,181222771,181224391,1620,spec2/voc/Bl122_181222771.jpg,Bl122,3
6188.039327,6188.072327,1,voc,185641179,185642169,990,spec2/voc/Bl122_185641179.jpg,Bl122,3
6148.368349,6148.628349,1,voc,184451050,184458850,7800,spec2/voc/Bl122_184451050.jpg,Bl122,3
6094.52215,6094.58015,1,voc,182835664,182837404,1740,spec2/voc/Bl122_182835664.jpg,Bl122,3
7844.962748,7844.975748,1,voc,235348882,235349272,390,spec2/voc/Bl122_235348882.jpg,Bl122,3
13957.088384,13957.091384,1,voc,418712651,418712741,90,spec2/voc/Bl122_418712651.jpg,Bl122,3
10875.078466,10875.082466,1,voc,326252353,326252473,120,spec2/voc/Bl122_326252353.jpg,Bl122,3
9027.172241,9027.343241,1,voc,270815167,270820297,5130,spec2/voc/Bl122_270815167.jpg,Bl122,3
6120.234706,6120.242706,1,voc,183607041,183607281,240,spec2/voc/Bl122_183607041.jpg,Bl122,3
11166.85318,11166.98818,1,voc,335005595,335009645,4050,spec2/voc/Bl122_335005595.jpg,Bl122,3
5937.536256,5937.550256,1,voc,178126087,178126507,420,spec2/voc/Bl122_178126087.jpg,Bl122,3
13558.741616,13558.800616,1,voc,406762248,406764018,1770,spec2/voc/Bl122_406762248.jpg,Bl122,3
11142.847955,11142.866955,1,voc,334285438,334286008,570,spec2/voc/Bl122_334285438.jpg,Bl122,3
6122.906706,6122.909706,1,voc,183687201,183687291,90,spec2/voc/Bl122_183687201.jpg,Bl122,3
8037.623748,8037.627748,1,voc,241128712,241128832,120,spec2/voc/Bl122_241128712.jpg,Bl122,3
13809.144653,13809.147653,1,voc,414274339,414274429,90,spec2/voc/Bl122_414274339.jpg,Bl122,3
6088.81415,6088.81815,1,voc,182664424,182664544,120,spec2/voc/Bl122_182664424.jpg,Bl122,3
13199.978389,13199.997389,1,voc,395999351,395999921,570,spec2/voc/Bl122_395999351.jpg,Bl122,3
7862.102748,7862.110748,1,voc,235863082,235863322,240,spec2/voc/Bl122_235863082.jpg,Bl122,3
13208.614389,13208.625389,1,voc,396258431,396258761,330,spec2/voc/Bl122_396258431.jpg,Bl122,3
7786.213748,7786.222748,1,voc,233586412,233586682,270,spec2/voc/Bl122_233586412.jpg,Bl122,3
5971.192256,5971.390256,1,voc,179135767,179141707,5940,spec2/voc/Bl122_179135767.jpg,Bl122,3
6050.4912,6050.4942,1,voc,181514736,181514826,90,spec2/voc/Bl122_181514736.jpg,Bl122,3
9086.501241,9086.548241,1,voc,272595037,272596447,1410,spec2/voc/Bl122_272595037.jpg,Bl122,3
9057.471241,9057.499241,1,voc,271724137,271724977,840,spec2/voc/Bl122_271724137.jpg,Bl122,3
10945.521807,10945.530807,1,voc,328365654,328365924,270,spec2/voc/Bl122_328365654.jpg,Bl122,3
5986.444256,5986.468256,1,voc,179593327,179594047,720,spec2/voc/Bl122_179593327.jpg,Bl122,3
8949.844967,8949.852967,1,voc,268495349,268495589,240,spec2/voc/Bl122_268495349.jpg,Bl122,3
13961.147384,13961.175384,1,voc,418834421,418835261,840,spec2/voc/Bl122_418834421.jpg,Bl122,3
5970.845256,5970.850256,1,voc,179125357,179125507,150,spec2/voc/Bl122_179125357.jpg,Bl122,3
3828.261649,3828.264649,1,voc,114847849,114847939,90,spec2/voc/Bl122_114847849.jpg,Bl122,3
8915.572773,8915.707773,1,voc,267467183,267471233,4050,spec2/voc/Bl122_267467183.jpg,Bl122,3
6010.644533,6010.677533,1,voc,180319335,180320325,990,spec2/voc/Bl122_180319335.jpg,Bl122,3
9081.636241,9081.639241,1,voc,272449087,272449177,90,spec2/voc/Bl122_272449087.jpg,Bl122,3
5980.922256,5980.925256,1,voc,179427667,179427757,90,spec2/voc/Bl122_179427667.jpg,Bl122,3
10919.355807,10919.479807,1,voc,327580674,327584394,3720,spec2/voc/Bl122_327580674.jpg,Bl122,3
9045.522241,9045.663241,1,voc,271365667,271369897,4230,spec2/voc/Bl122_271365667.jpg,Bl122,3
14808.721551,14808.725551,1,voc,444261646,444261766,120,spec2/voc/Bl122_444261646.jpg,Bl122,3
5989.009256,5989.016256,1,voc,179670277,179670487,210,spec2/voc/Bl122_179670277.jpg,Bl122,3
8367.471166,8367.519166,1,voc,251024134,251025574,1440,spec2/voc/Bl122_251024134.jpg,Bl122,3
9051.622241,9051.630241,1,voc,271548667,271548907,240,spec2/voc/Bl122_271548667.jpg,Bl122,3
13976.093117,13976.131117,1,voc,419282793,419283933,1140,spec2/voc/Bl122_419282793.jpg,Bl122,3
5943.734256,5943.744256,1,voc,178312027,178312327,300,spec2/voc/Bl122_178312027.jpg,Bl122,3
8913.255773,8913.428773,1,voc,267397673,267402863,5190,spec2/voc/Bl122_267397673.jpg,Bl122,3
6070.431705,6070.471705,1,voc,182112951,182114151,1200,spec2/voc/Bl122_182112951.jpg,Bl122,3
6169.321327,6169.323327,1,voc,185079639,185079699,60,spec2/voc/Bl122_185079639.jpg,Bl122,3
9032.999241,9033.029241,1,voc,270989977,270990877,900,spec2/voc/Bl122_270989977.jpg,Bl122,3
11131.786005,11131.860005,1,voc,333953580,333955800,2220,spec2/voc/Bl122_333953580.jpg,Bl122,3
9021.565241,9021.571241,1,voc,270646957,270647137,180,spec2/voc/Bl122_270646957.jpg,Bl122,3
5996.990256,5997.010256,1,voc,179909707,179910307,600,spec2/voc/Bl122_179909707.jpg,Bl122,3
9123.155182,9123.313182,1,voc,273694655,273699395,4740,spec2/voc/Bl122_273694655.jpg,Bl122,3
14805.756551,14805.759551,1,voc,444172696,444172786,90,spec2/voc/Bl122_444172696.jpg,Bl122,3
8946.193967,8946.278967,1,voc,268385819,268388369,2550,spec2/voc/Bl122_268385819.jpg,Bl122,3
6180.549327,6180.555327,1,voc,185416479,185416659,180,spec2/voc/Bl122_185416479.jpg,Bl122,3
6000.182256,6000.261256,1,voc,180005467,180007837,2370,spec2/voc/Bl122_180005467.jpg,Bl122,3
10905.335825,10905.456825,1,voc,327160074,327163704,3630,spec2/voc/Bl122_327160074.jpg,Bl122,3
14709.284469,14709.290469,1,voc,441278534,441278714,180,spec2/voc/Bl122_441278534.jpg,Bl122,3
6069.641705,6069.644705,1,voc,182089251,182089341,90,spec2/voc/Bl122_182089251.jpg,Bl122,3
14824.434551,14824.437551,1,voc,444733036,444733126,90,spec2/voc/Bl122_444733036.jpg,Bl122,3
11170.38918,11170.52018,1,voc,335111675,335115605,3930,spec2/voc/Bl122_335111675.jpg,Bl122,3
9174.423287,9174.442287,1,voc,275232698,275233268,570,spec2/voc/Bl122_275232698.jpg,Bl122,3
10910.484807,10910.550807,1,voc,327314544,327316524,1980,spec2/voc/Bl122_327314544.jpg,Bl122,3
5951.479256,5951.705256,1,voc,178544377,178551157,6780,spec2/voc/Bl122_178544377.jpg,Bl122,3
6040.724065,6040.750065,1,voc,181221721,181222501,780,spec2/voc/Bl122_181221721.jpg,Bl122,3
6144.035349,6144.150349,1,voc,184321060,184324510,3450,spec2/voc/Bl122_184321060.jpg,Bl122,3
8930.407773,8930.571773,1,voc,267912233,267917153,4920,spec2/voc/Bl122_267912233.jpg,Bl122,3
10885.235162,10885.286162,1,voc,326557054,326558584,1530,spec2/voc/Bl122_326557054.jpg,Bl122,3
5952.010256,5952.109256,1,voc,178560307,178563277,2970,spec2/voc/Bl122_178560307.jpg,Bl122,3
7869.436748,7869.449748,1,voc,236083102,236083492,390,spec2/voc/Bl122_236083102.jpg,Bl122,3
3813.574649,3813.629649,1,voc,114407239,114408889,1650,spec2/voc/Bl122_114407239.jpg,Bl122,3
14157.163825,14157.166825,1,voc,424714914,424715004,90,spec2/voc/Bl122_424714914.jpg,Bl122,3
6088.27715,6088.34315,1,voc,182648314,182650294,1980,spec2/voc/Bl122_182648314.jpg,Bl122,3
6140.750349,6140.860349,1,voc,184222510,184225810,3300,spec2/voc/Bl122_184222510.jpg,Bl122,3
13200.666389,13200.733389,1,voc,396019991,396022001,2010,spec2/voc/Bl122_396019991.jpg,Bl122,3
3797.890649,3797.926649,1,voc,113936719,113937799,1080,spec2/voc/Bl122_113936719.jpg,Bl122,3
3804.127649,3804.334649,1,voc,114123829,114130039,6210,spec2/voc/Bl122_114123829.jpg,Bl122,3
7896.954748,7897.051748,1,voc,236908642,236911552,2910,spec2/voc/Bl122_236908642.jpg,Bl122,3
7882.806748,7882.809748,1,voc,236484202,236484292,90,spec2/voc/Bl122_236484202.jpg,Bl122,3
10913.683807,10913.695807,1,voc,327410514,327410874,360,spec2/voc/Bl122_327410514.jpg,Bl122,3
6048.6972,6048.7032,1,voc,181460916,181461096,180,spec2/voc/Bl122_181460916.jpg,Bl122,3
9137.810255,9137.912255,1,voc,274134307,274137367,3060,spec2/voc/Bl122_274134307.jpg,Bl122,3
6150.429349,6150.436349,1,voc,184512880,184513090,210,spec2/voc/Bl122_184512880.jpg,Bl122,3
13176.664701,13176.676701,1,voc,395299941,395300301,360,spec2/voc/Bl122_395299941.jpg,Bl122,3
6107.869706,6107.876706,1,voc,183236091,183236301,210,spec2/voc/Bl122_183236091.jpg,Bl122,3
14790.605551,14790.728551,1,voc,443718166,443721856,3690,spec2/voc/Bl122_443718166.jpg,Bl122,3
6190.055327,6190.058327,1,voc,185701659,185701749,90,spec2/voc/Bl122_185701659.jpg,Bl122,3
8364.678015,8364.895015,1,voc,250940340,250946850,6510,spec2/voc/Bl122_250940340.jpg,Bl122,3
9114.803184,9115.042184,1,voc,273444095,273451265,7170,spec2/voc/Bl122_273444095.jpg,Bl122,3
9063.788241,9064.111241,1,voc,271913647,271923337,9690,spec2/voc/Bl122_271913647.jpg,Bl122,3
11983.450618,11983.619618,1,voc,359503518,359508588,5070,spec2/voc/Bl122_359503518.jpg,Bl122,3
8019.578748,8019.580748,1,voc,240587362,240587422,60,spec2/voc/Bl122_240587362.jpg,Bl122,3
9046.704241,9046.714241,1,voc,271401127,271401427,300,spec2/voc/Bl122_271401127.jpg,Bl122,3
6168.924327,6169.019327,1,voc,185067729,185070579,2850,spec2/voc/Bl122_185067729.jpg,Bl122,3
6204.785327,6204.793327,1,voc,186143559,186143799,240,spec2/voc/Bl122_186143559.jpg,Bl122,3
10952.691807,10952.707807,1,voc,328580754,328581234,480,spec2/voc/Bl122_328580754.jpg,Bl122,3
6062.757705,6062.765705,1,voc,181882731,181882971,240,spec2/voc/Bl122_181882731.jpg,Bl122,3
10957.930807,10957.954807,1,voc,328737924,328738644,720,spec2/voc/Bl122_328737924.jpg,Bl122,3
14809.594551,14809.599551,1,voc,444287836,444287986,150,spec2/voc/Bl122_444287836.jpg,Bl122,3
6182.573327,6182.598327,1,voc,185477199,185477949,750,spec2/voc/Bl122_185477199.jpg,Bl122,3
5986.732256,5986.753256,1,voc,179601967,179602597,630,spec2/voc/Bl122_179601967.jpg,Bl122,3
6160.116349,6160.123349,1,voc,184803490,184803700,210,spec2/voc/Bl122_184803490.jpg,Bl122,3
10936.952807,10936.985807,1,voc,328108584,328109574,990,spec2/voc/Bl122_328108584.jpg,Bl122,3
8980.134025,8980.137025,1,voc,269404020,269404110,90,spec2/voc/Bl122_269404020.jpg,Bl122,3
12677.92017,12678.00117,1,voc,380337605,380340035,2430,spec2/voc/Bl122_380337605.jpg,Bl122,3
14137.114881,14137.340881,1,voc,424113446,424120226,6780,spec2/voc/Bl122_424113446.jpg,Bl122,3
12589.106377,12589.119377,1,voc,377673191,377673581,390,spec2/voc/Bl122_377673191.jpg,Bl122,3
7865.699748,7865.702748,1,voc,235970992,235971082,90,spec2/voc/Bl122_235970992.jpg,Bl122,3
14141.004328,14141.008328,1,voc,424230129,424230249,120,spec2/voc/Bl122_424230129.jpg,Bl122,3
10920.662807,10920.683807,1,voc,327619884,327620514,630,spec2/voc/Bl122_327619884.jpg,Bl122,3
6199.398327,6199.404327,1,voc,185981949,185982129,180,spec2/voc/Bl122_185981949.jpg,Bl122,3
9115.383184,9115.549184,1,voc,273461495,273466475,4980,spec2/voc/Bl122_273461495.jpg,Bl122,3
13947.406911,13947.443911,1,voc,418422207,418423317,1110,spec2/voc/Bl122_418422207.jpg,Bl122,3
8957.738967,8957.745967,1,voc,268732169,268732379,210,spec2/voc/Bl122_268732169.jpg,Bl122,3
7803.552748,7803.554748,1,voc,234106582,234106642,60,spec2/voc/Bl122_234106582.jpg,Bl122,3
8303.936054,8304.000054,1,voc,249118081,249120001,1920,spec2/voc/Bl122_249118081.jpg,Bl122,3
6113.459706,6113.488706,1,voc,183403791,183404661,870,spec2/voc/Bl122_183403791.jpg,Bl122,3
5928.218748,5928.306748,1,voc,177846562,177849202,2640,spec2/voc/Bl122_177846562.jpg,Bl122,3
13818.301617,13818.326617,1,voc,414549048,414549798,750,spec2/voc/Bl122_414549048.jpg,Bl122,3
12627.117577,12627.170577,1,voc,378813527,378815117,1590,spec2/voc/Bl122_378813527.jpg,Bl122,3
7852.042748,7852.057748,1,voc,235561282,235561732,450,spec2/voc/Bl122_235561282.jpg,Bl122,3
3837.764415,3837.809415,1,voc,115132932,115134282,1350,spec2/voc/Bl122_115132932.jpg,Bl122,3
6059.969705,6059.974705,1,voc,181799091,181799241,150,spec2/voc/Bl122_181799091.jpg,Bl122,3
8016.574748,8016.577748,1,voc,240497242,240497332,90,spec2/voc/Bl122_240497242.jpg,Bl122,3
13209.253389,13209.256389,1,voc,396277601,396277691,90,spec2/voc/Bl122_396277601.jpg,Bl122,3
11135.601005,11135.703005,1,voc,334068030,334071090,3060,spec2/voc/Bl122_334068030.jpg,Bl122,3
14819.115551,14819.147551,1,voc,444573466,444574426,960,spec2/voc/Bl122_444573466.jpg,Bl122,3
12678.21517,12678.32117,1,voc,380346455,380349635,3180,spec2/voc/Bl122_380346455.jpg,Bl122,3
9097.826241,9097.873241,1,voc,272934787,272936197,1410,spec2/voc/Bl122_272934787.jpg,Bl122,3
12634.549885,12634.607885,1,voc,379036496,379038236,1740,spec2/voc/Bl122_379036496.jpg,Bl122,3
10947.206807,10947.229807,1,voc,328416204,328416894,690,spec2/voc/Bl122_328416204.jpg,Bl122,3
13565.033867,13565.040867,1,voc,406951016,406951226,210,spec2/voc/Bl122_406951016.jpg,Bl122,3
6011.649533,6011.661533,1,voc,180349485,180349845,360,spec2/voc/Bl122_180349485.jpg,Bl122,3
6222.316295,6222.326295,1,voc,186669488,186669788,300,spec2/voc/Bl122_186669488.jpg,Bl122,3
14799.048551,14799.135551,1,voc,443971456,443974066,2610,spec2/voc/Bl122_443971456.jpg,Bl122,3
14836.204682,14836.267682,1,voc,445086140,445088030,1890,spec2/voc/Bl122_445086140.jpg,Bl122,3
7952.604748,7952.848748,1,voc,238578142,238585462,7320,spec2/voc/Bl122_238578142.jpg,Bl122,3
7842.194748,7842.205748,1,voc,235265842,235266172,330,spec2/voc/Bl122_235265842.jpg,Bl122,3
9108.967935,9108.975935,1,voc,273269038,273269278,240,spec2/voc/Bl122_273269038.jpg,Bl122,3
10862.946845,10862.950845,1,voc,325888405,325888525,120,spec2/voc/Bl122_325888405.jpg,Bl122,3
6099.49115,6099.50115,1,voc,182984734,182985034,300,spec2/voc/Bl122_182984734.jpg,Bl122,3
9075.194241,9075.202241,1,voc,272255827,272256067,240,spec2/voc/Bl122_272255827.jpg,Bl122,3
7841.393748,7841.425748,1,voc,235241812,235242772,960,spec2/voc/Bl122_235241812.jpg,Bl122,3
9014.711241,9014.718241,1,voc,270441337,270441547,210,spec2/voc/Bl122_270441337.jpg,Bl122,3
14145.331577,14145.484577,1,voc,424359947,424364537,4590,spec2/voc/Bl122_424359947.jpg,Bl122,3
9041.350241,9041.354241,1,voc,271240507,271240627,120,spec2/voc/Bl122_271240507.jpg,Bl122,3
6051.4612,6051.4752,1,voc,181543836,181544256,420,spec2/voc/Bl122_181543836.jpg,Bl122,3
6099.78415,6099.79015,1,voc,182993524,182993704,180,spec2/voc/Bl122_182993524.jpg,Bl122,3
14491.514169,14491.518169,1,voc,434745425,434745545,120,spec2/voc/Bl122_434745425.jpg,Bl122,3
6068.062705,6068.082705,1,voc,182041881,182042481,600,spec2/voc/Bl122_182041881.jpg,Bl122,3
3805.841649,3805.868649,1,voc,114175249,114176059,810,spec2/voc/Bl122_114175249.jpg,Bl122,3
11171.56218,11171.66618,1,voc,335146865,335149985,3120,spec2/voc/Bl122_335146865.jpg,Bl122,3
8993.620241,8993.623241,1,voc,269808607,269808697,90,spec2/voc/Bl122_269808607.jpg,Bl122,3
11186.89218,11186.90118,1,voc,335606765,335607035,270,spec2/voc/Bl122_335606765.jpg,Bl122,3
6040.461065,6040.464065,1,voc,181213831,181213921,90,spec2/voc/Bl122_181213831.jpg,Bl122,3
6071.834705,6071.949705,1,voc,182155041,182158491,3450,spec2/voc/Bl122_182155041.jpg,Bl122,3
11204.732894,11204.782894,1,voc,336141986,336143486,1500,spec2/voc/Bl122_336141986.jpg,Bl122,3
14834.939682,14834.988682,1,voc,445048190,445049660,1470,spec2/voc/Bl122_445048190.jpg,Bl122,3
10960.703807,10960.726807,1,voc,328821114,328821804,690,spec2/voc/Bl122_328821114.jpg,Bl122,3
6060.930705,6060.933705,1,voc,181827921,181828011,90,spec2/voc/Bl122_181827921.jpg,Bl122,3
9042.301241,9042.325241,1,voc,271269037,271269757,720,spec2/voc/Bl122_271269037.jpg,Bl122,3
14803.809551,14803.826551,1,voc,444114286,444114796,510,spec2/voc/Bl122_444114286.jpg,Bl122,3
7915.640931,7915.673931,1,voc,237469227,237470217,990,spec2/voc/Bl122_237469227.jpg,Bl122,3
5991.282256,5991.309256,1,voc,179738467,179739277,810,spec2/voc/Bl122_179738467.jpg,Bl122,3
6016.378533,6016.382533,1,voc,180491355,180491475,120,spec2/voc/Bl122_180491355.jpg,Bl122,3
7952.410821,7952.516821,1,voc,238572324,238575504,3180,spec2/voc/Bl122_238572324.jpg,Bl122,3
6133.989293,6134.013293,1,voc,184019678,184020398,720,spec2/voc/Bl122_184019678.jpg,Bl122,3
7814.625748,7814.637748,1,voc,234438772,234439132,360,spec2/voc/Bl122_234438772.jpg,Bl122,3
7884.489748,7884.515748,1,voc,236534692,236535472,780,spec2/voc/Bl122_236534692.jpg,Bl122,3
8334.849758,8334.907758,1,voc,250045492,250047232,1740,spec2/voc/Bl122_250045492.jpg,Bl122,3
6000.177256,6000.179256,1,voc,180005317,180005377,60,spec2/voc/Bl122_180005317.jpg,Bl122,3
10932.283807,10932.288807,1,voc,327968514,327968664,150,spec2/voc/Bl122_327968514.jpg,Bl122,3
9046.968241,9047.079241,1,voc,271409047,271412377,3330,spec2/voc/Bl122_271409047.jpg,Bl122,3
7983.247748,7983.263748,1,voc,239497432,239497912,480,spec2/voc/Bl122_239497432.jpg,Bl122,3
9030.316241,9030.319241,1,voc,270909487,270909577,90,spec2/voc/Bl122_270909487.jpg,Bl122,3
14797.510551,14797.635551,1,voc,443925316,443929066,3750,spec2/voc/Bl122_443925316.jpg,Bl122,3
8018.491748,8018.497748,1,voc,240554752,240554932,180,spec2/voc/Bl122_240554752.jpg,Bl122,3
6055.985705,6055.990705,1,voc,181679571,181679721,150,spec2/voc/Bl122_181679571.jpg,Bl122,3
7881.461748,7881.525748,1,voc,236443852,236445772,1920,spec2/voc/Bl122_236443852.jpg,Bl122,3
13600.150736,13600.223736,1,voc,408004522,408006712,2190,spec2/voc/Bl122_408004522.jpg,Bl122,3
10896.767557,10896.852557,1,voc,326903026,326905576,2550,spec2/voc/Bl122_326903026.jpg,Bl122,3
9131.774981,9131.809981,1,voc,273953249,273954299,1050,spec2/voc/Bl122_273953249.jpg,Bl122,3
5947.773256,5947.782256,1,voc,178433197,178433467,270,spec2/voc/Bl122_178433197.jpg,Bl122,3
14784.392465,14784.446465,1,voc,443531773,443533393,1620,spec2/voc/Bl122_443531773.jpg,Bl122,3
12938.961352,12939.012352,1,voc,388168840,388170370,1530,spec2/voc/Bl122_388168840.jpg,Bl122,3
6011.008533,6011.012533,1,voc,180330255,180330375,120,spec2/voc/Bl122_180330255.jpg,Bl122,3
9093.250241,9093.280241,1,voc,272797507,272798407,900,spec2/voc/Bl122_272797507.jpg,Bl122,3
14257.312524,14257.508524,1,voc,427719375,427725255,5880,spec2/voc/Bl122_427719375.jpg,Bl122,3
9032.383241,9032.496241,1,voc,270971497,270974887,3390,spec2/voc/Bl122_270971497.jpg,Bl122,3
14149.711855,14149.714855,1,voc,424491355,424491445,90,spec2/voc/Bl122_424491355.jpg,Bl122,3
5957.322256,5957.390256,1,voc,178719667,178721707,2040,spec2/voc/Bl122_178719667.jpg,Bl122,3
11127.072005,11127.177005,1,voc,333812160,333815310,3150,spec2/voc/Bl122_333812160.jpg,Bl122,3
8921.153773,8921.173773,1,voc,267634613,267635213,600,spec2/voc/Bl122_267634613.jpg,Bl122,3
7846.125748,7846.129748,1,voc,235383772,235383892,120,spec2/voc/Bl122_235383772.jpg,Bl122,3
10947.164807,10947.167807,1,voc,328414944,328415034,90,spec2/voc/Bl122_328414944.jpg,Bl122,3
3847.703415,3847.809415,1,voc,115431102,115434282,3180,spec2/voc/Bl122_115431102.jpg,Bl122,3
8966.789712,8966.813712,1,voc,269003691,269004411,720,spec2/voc/Bl122_269003691.jpg,Bl122,3
6024.136533,6024.141533,1,voc,180724095,180724245,150,spec2/voc/Bl122_180724095.jpg,Bl122,3
9123.006182,9123.008182,1,voc,273690185,273690245,60,spec2/voc/Bl122_273690185.jpg,Bl122,3
13921.377981,13921.441981,1,voc,417641339,417643259,1920,spec2/voc/Bl122_417641339.jpg,Bl122,3
9013.757241,9013.761241,1,voc,270412717,270412837,120,spec2/voc/Bl122_270412717.jpg,Bl122,3
9072.698241,9072.701241,1,voc,272180947,272181037,90,spec2/voc/Bl122_272180947.jpg,Bl122,3
13221.053389,13221.055389,1,voc,396631601,396631661,60,spec2/voc/Bl122_396631601.jpg,Bl122,3
14792.440551,14792.526551,1,voc,443773216,443775796,2580,spec2/voc/Bl122_443773216.jpg,Bl122,3
3841.729415,3841.757415,1,voc,115251882,115252722,840,spec2/voc/Bl122_115251882.jpg,Bl122,3
11851.90373,11851.91573,1,voc,355557111,355557471,360,spec2/voc/Bl122_355557111.jpg,Bl122,3
13815.597617,13815.619617,1,voc,414467928,414468588,660,spec2/voc/Bl122_414467928.jpg,Bl122,3
7973.648748,7973.662748,1,voc,239209462,239209882,420,spec2/voc/Bl122_239209462.jpg,Bl122,3
3806.632649,3806.637649,1,voc,114198979,114199129,150,spec2/voc/Bl122_114198979.jpg,Bl122,3
10965.499807,10965.501807,1,voc,328964994,328965054,60,spec2/voc/Bl122_328964994.jpg,Bl122,3
10936.685807,10936.691807,1,voc,328100574,328100754,180,spec2/voc/Bl122_328100574.jpg,Bl122,3
3861.233367,3861.296367,1,voc,115837001,115838891,1890,spec2/voc/Bl122_115837001.jpg,Bl122,3
10913.673807,10913.675807,1,voc,327410214,327410274,60,spec2/voc/Bl122_327410214.jpg,Bl122,3
6191.892327,6192.169327,1,voc,185756769,185765079,8310,spec2/voc/Bl122_185756769.jpg,Bl122,3
14810.822551,14810.989551,1,voc,444324676,444329686,5010,spec2/voc/Bl122_444324676.jpg,Bl122,3
7858.540748,7858.543748,1,voc,235756222,235756312,90,spec2/voc/Bl122_235756222.jpg,Bl122,3
6170.052327,6170.166327,1,voc,185101569,185104989,3420,spec2/voc/Bl122_185101569.jpg,Bl122,3
11162.96718,11163.09518,1,voc,334889015,334892855,3840,spec2/voc/Bl122_334889015.jpg,Bl122,3
10906.085825,10906.089825,1,voc,327182574,327182694,120,spec2/voc/Bl122_327182574.jpg,Bl122,3
8919.852773,8919.856773,1,voc,267595583,267595703,120,spec2/voc/Bl122_267595583.jpg,Bl122,3
9038.862241,9038.866241,1,voc,271165867,271165987,120,spec2/voc/Bl122_271165867.jpg,Bl122,3
6068.721705,6068.930705,1,voc,182061651,182067921,6270,spec2/voc/Bl122_182061651.jpg,Bl122,3
5949.382256,5949.414256,1,voc,178481467,178482427,960,spec2/voc/Bl122_178481467.jpg,Bl122,3
6075.227705,6075.230705,1,voc,182256831,182256921,90,spec2/voc/Bl122_182256831.jpg,Bl122,3
11124.516005,11124.709005,1,voc,333735480,333741270,5790,spec2/voc/Bl122_333735480.jpg,Bl122,3
3868.067367,3868.120367,1,voc,116042021,116043611,1590,spec2/voc/Bl122_116042021.jpg,Bl122,3
13827.24722,13827.26022,1,voc,414817416,414817806,390,spec2/voc/Bl122_414817416.jpg,Bl122,3
3829.799649,3829.805649,1,voc,114893989,114894169,180,spec2/voc/Bl122_114893989.jpg,Bl122,3
13826.94522,13826.95222,1,voc,414808356,414808566,210,spec2/voc/Bl122_414808356.jpg,Bl122,3
8938.163967,8938.191967,1,voc,268144919,268145759,840,spec2/voc/Bl122_268144919.jpg,Bl122,3
12664.037938,12664.259938,1,voc,379921138,379927798,6660,spec2/voc/Bl122_379921138.jpg,Bl122,3
10909.191807,10909.193807,1,voc,327275754,327275814,60,spec2/voc/Bl122_327275754.jpg,Bl122,3
7876.432748,7876.435748,1,voc,236292982,236293072,90,spec2/voc/Bl122_236292982.jpg,Bl122,3
12587.423744,12587.434744,1,voc,377622712,377623042,330,spec2/voc/Bl122_377622712.jpg,Bl122,3
6194.665327,6194.798327,1,voc,185839959,185843949,3990,spec2/voc/Bl122_185839959.jpg,Bl122,3
5953.195256,5953.258256,1,voc,178595857,178597747,1890,spec2/voc/Bl122_178595857.jpg,Bl122,3
8978.355025,8978.361025,1,voc,269350650,269350830,180,spec2/voc/Bl122_269350650.jpg,Bl122,3
14820.739551,14820.741551,1,voc,444622186,444622246,60,spec2/voc/Bl122_444622186.jpg,Bl122,3
6029.170533,6029.175533,1,voc,180875115,180875265,150,spec2/voc/Bl122_180875115.jpg,Bl122,3
8920.424773,8920.453773,1,voc,267612743,267613613,870,spec2/voc/Bl122_267612743.jpg,Bl122,3
12672.685513,12672.689513,1,voc,380180565,380180685,120,spec2/voc/Bl122_380180565.jpg,Bl122,3
6154.894349,6154.899349,1,voc,184646830,184646980,150,spec2/voc/Bl122_184646830.jpg,Bl122,3
13558.962616,13559.053616,1,voc,406768878,406771608,2730,spec2/voc/Bl122_406768878.jpg,Bl122,3
8208.851882,8208.857882,1,voc,246265556,246265736,180,spec2/voc/Bl122_246265556.jpg,Bl122,3
13206.776389,13206.927389,1,voc,396203291,396207821,4530,spec2/voc/Bl122_396203291.jpg,Bl122,3
14844.256682,14844.267682,1,voc,445327700,445328030,330,spec2/voc/Bl122_445327700.jpg,Bl122,3
11178.12018,11178.23418,1,voc,335343605,335347025,3420,spec2/voc/Bl122_335343605.jpg,Bl122,3
8969.127712,8969.379712,1,voc,269073831,269081391,7560,spec2/voc/Bl122_269073831.jpg,Bl122,3
14824.364551,14824.368551,1,voc,444730936,444731056,120,spec2/voc/Bl122_444730936.jpg,Bl122,3
13180.386701,13180.423701,1,voc,395411601,395412711,1110,spec2/voc/Bl122_395411601.jpg,Bl122,3
14791.603551,14791.623551,1,voc,443748106,443748706,600,spec2/voc/Bl122_443748106.jpg,Bl122,3
7885.030748,7885.075748,1,voc,236550922,236552272,1350,spec2/voc/Bl122_236550922.jpg,Bl122,3
7842.079748,7842.082748,1,voc,235262392,235262482,90,spec2/voc/Bl122_235262392.jpg,Bl122,3
14015.130222,14015.325222,1,voc,420453906,420459756,5850,spec2/voc/Bl122_420453906.jpg,Bl122,3
6221.825295,6221.913295,1,voc,186654758,186657398,2640,spec2/voc/Bl122_186654758.jpg,Bl122,3
8964.527712,8964.621712,1,voc,268935831,268938651,2820,spec2/voc/Bl122_268935831.jpg,Bl122,3
3796.918649,3797.049649,1,voc,113907559,113911489,3930,spec2/voc/Bl122_113907559.jpg,Bl122,3
14000.185512,14000.189512,1,voc,420005565,420005685,120,spec2/voc/Bl122_420005565.jpg,Bl122,3
13200.554389,13200.567389,1,voc,396016631,396017021,390,spec2/voc/Bl122_396016631.jpg,Bl122,3
10919.280807,10919.284807,1,voc,327578424,327578544,120,spec2/voc/Bl122_327578424.jpg,Bl122,3
14808.029551,14808.621551,1,voc,444240886,444258646,17760,spec2/voc/Bl122_444240886.jpg,Bl122,3
9098.964241,9098.970241,1,voc,272968927,272969107,180,spec2/voc/Bl122_272968927.jpg,Bl122,3
14800.272551,14800.307551,1,voc,444008176,444009226,1050,spec2/voc/Bl122_444008176.jpg,Bl122,3
14806.361551,14806.422551,1,voc,444190846,444192676,1830,spec2/voc/Bl122_444190846.jpg,Bl122,3
13565.092867,13565.095867,1,voc,406952786,406952876,90,spec2/voc/Bl122_406952786.jpg,Bl122,3
6154.577349,6154.609349,1,voc,184637320,184638280,960,spec2/voc/Bl122_184637320.jpg,Bl122,3
7850.711748,7850.720748,1,voc,235521352,235521622,270,spec2/voc/Bl122_235521352.jpg,Bl122,3
5979.783256,5979.808256,1,voc,179393497,179394247,750,spec2/voc/Bl122_179393497.jpg,Bl122,3
5989.893256,5989.913256,1,voc,179696797,179697397,600,spec2/voc/Bl122_179696797.jpg,Bl122,3
7886.297748,7886.304748,1,voc,236588932,236589142,210,spec2/voc/Bl122_236588932.jpg,Bl122,3
13554.790188,13554.798188,1,voc,406643705,406643945,240,spec2/voc/Bl122_406643705.jpg,Bl122,3
6067.159705,6067.169705,1,voc,182014791,182015091,300,spec2/voc/Bl122_182014791.jpg,Bl122,3
6142.445349,6142.451349,1,voc,184273360,184273540,180,spec2/voc/Bl122_184273360.jpg,Bl122,3
11149.09518,11149.10118,1,voc,334472855,334473035,180,spec2/voc/Bl122_334472855.jpg,Bl122,3
9127.609981,9127.656981,1,voc,273828299,273829709,1410,spec2/voc/Bl122_273828299.jpg,Bl122,3
9168.982604,9169.136604,1,voc,275069478,275074098,4620,spec2/voc/Bl122_275069478.jpg,Bl122,3
10946.486807,10946.489807,1,voc,328394604,328394694,90,spec2/voc/Bl122_328394604.jpg,Bl122,3
7984.457748,7984.470748,1,voc,239533732,239534122,390,spec2/voc/Bl122_239533732.jpg,Bl122,3
14117.300808,14117.461808,1,voc,423519024,423523854,4830,spec2/voc/Bl122_423519024.jpg,Bl122,3
8929.486773,8929.706773,1,voc,267884603,267891203,6600,spec2/voc/Bl122_267884603.jpg,Bl122,3
13814.497617,13814.500617,1,voc,414434928,414435018,90,spec2/voc/Bl122_414434928.jpg,Bl122,3
8982.186025,8982.189025,1,voc,269465580,269465670,90,spec2/voc/Bl122_269465580.jpg,Bl122,3
5956.661256,5956.867256,1,voc,178699837,178706017,6180,spec2/voc/Bl122_178699837.jpg,Bl122,3
8928.188773,8928.232773,1,voc,267845663,267846983,1320,spec2/voc/Bl122_267845663.jpg,Bl122,3
13976.164117,13976.181117,1,voc,419284923,419285433,510,spec2/voc/Bl122_419284923.jpg,Bl122,3
9009.488241,9009.493241,1,voc,270284647,270284797,150,spec2/voc/Bl122_270284647.jpg,Bl122,3
6058.782705,6058.806705,1,voc,181763481,181764201,720,spec2/voc/Bl122_181763481.jpg,Bl122,3
11189.18118,11189.24018,1,voc,335675435,335677205,1770,spec2/voc/Bl122_335675435.jpg,Bl122,3
6021.998533,6022.066533,1,voc,180659955,180661995,2040,spec2/voc/Bl122_180659955.jpg,Bl122,3
11914.592799,11914.787799,1,voc,357437783,357443633,5850,spec2/voc/Bl122_357437783.jpg,Bl122,3
8016.652748,8016.660748,1,voc,240499582,240499822,240,spec2/voc/Bl122_240499582.jpg,Bl122,3
6076.616705,6076.621705,1,voc,182298501,182298651,150,spec2/voc/Bl122_182298501.jpg,Bl122,3
13983.361943,13983.365943,1,voc,419500858,419500978,120,spec2/voc/Bl122_419500858.jpg,Bl122,3
9008.566241,9008.592241,1,voc,270256987,270257767,780,spec2/voc/Bl122_270256987.jpg,Bl122,3
13219.746389,13219.762389,1,voc,396592391,396592871,480,spec2/voc/Bl122_396592391.jpg,Bl122,3
9056.978241,9057.027241,1,voc,271709347,271710817,1470,spec2/voc/Bl122_271709347.jpg,Bl122,3
6225.534295,6225.637295,1,voc,186766028,186769118,3090,spec2/voc/Bl122_186766028.jpg,Bl122,3
7841.549748,7841.552748,1,voc,235246492,235246582,90,spec2/voc/Bl122_235246492.jpg,Bl122,3
7860.963748,7860.967748,1,voc,235828912,235829032,120,spec2/voc/Bl122_235828912.jpg,Bl122,3
11124.376005,11124.419005,1,voc,333731280,333732570,1290,spec2/voc/Bl122_333731280.jpg,Bl122,3
10962.058807,10962.131807,1,voc,328861764,328863954,2190,spec2/voc/Bl122_328861764.jpg,Bl122,3
6134.176293,6134.202293,1,voc,184025288,184026068,780,spec2/voc/Bl122_184025288.jpg,Bl122,3
5960.614256,5960.715256,1,voc,178818427,178821457,3030,spec2/voc/Bl122_178818427.jpg,Bl122,3
13221.187389,13221.190389,1,voc,396635621,396635711,90,spec2/voc/Bl122_396635621.jpg,Bl122,3
13581.051236,13581.186236,1,voc,407431537,407435587,4050,spec2/voc/Bl122_407431537.jpg,Bl122,3
14120.231121,14120.357121,1,voc,423606933,423610713,3780,spec2/voc/Bl122_423606933.jpg,Bl122,3
6095.63815,6095.65415,1,voc,182869144,182869624,480,spec2/voc/Bl122_182869144.jpg,Bl122,3
6221.799295,6221.806295,1,voc,186653978,186654188,210,spec2/voc/Bl122_186653978.jpg,Bl122,3
5959.018256,5959.022256,1,voc,178770547,178770667,120,spec2/voc/Bl122_178770547.jpg,Bl122,3
13208.795389,13208.803389,1,voc,396263861,396264101,240,spec2/voc/Bl122_396263861.jpg,Bl122,3
5966.634256,5966.662256,1,voc,178999027,178999867,840,spec2/voc/Bl122_178999027.jpg,Bl122,3
10906.232825,10906.235825,1,voc,327186984,327187074,90,spec2/voc/Bl122_327186984.jpg,Bl122,3
6047.9212,6047.9332,1,voc,181437636,181437996,360,spec2/voc/Bl122_181437636.jpg,Bl122,3
3865.140367,3865.143367,1,voc,115954211,115954301,90,spec2/voc/Bl122_115954211.jpg,Bl122,3
7842.438748,7842.455748,1,voc,235273162,235273672,510,spec2/voc/Bl122_235273162.jpg,Bl122,3
14815.515551,14815.525551,1,voc,444465466,444465766,300,spec2/voc/Bl122_444465466.jpg,Bl122,3
6015.961533,6016.085533,1,voc,180478845,180482565,3720,spec2/voc/Bl122_180478845.jpg,Bl122,3
6069.934705,6070.178705,1,voc,182098041,182105361,7320,spec2/voc/Bl122_182098041.jpg,Bl122,3
9014.316241,9014.546241,1,voc,270429487,270436387,6900,spec2/voc/Bl122_270429487.jpg,Bl122,3
13199.602389,13199.745389,1,voc,395988071,395992361,4290,spec2/voc/Bl122_395988071.jpg,Bl122,3
10910.557807,10910.803807,1,voc,327316734,327324114,7380,spec2/voc/Bl122_327316734.jpg,Bl122,3
3861.646367,3861.679367,1,voc,115849391,115850381,990,spec2/voc/Bl122_115849391.jpg,Bl122,3
11168.20218,11168.21418,1,voc,335046065,335046425,360,spec2/voc/Bl122_335046065.jpg,Bl122,3
12932.31429,12932.36329,1,voc,387969428,387970898,1470,spec2/voc/Bl122_387969428.jpg,Bl122,3
8963.595712,8963.715712,1,voc,268907871,268911471,3600,spec2/voc/Bl122_268907871.jpg,Bl122,3
13156.236066,13156.257066,1,voc,394687081,394687711,630,spec2/voc/Bl122_394687081.jpg,Bl122,3
5951.927256,5951.938256,1,voc,178557817,178558147,330,spec2/voc/Bl122_178557817.jpg,Bl122,3
5941.500256,5941.505256,1,voc,178245007,178245157,150,spec2/voc/Bl122_178245007.jpg,Bl122,3
5944.397256,5944.411256,1,voc,178331917,178332337,420,spec2/voc/Bl122_178331917.jpg,Bl122,3
6117.919706,6117.963706,1,voc,183537591,183538911,1320,spec2/voc/Bl122_183537591.jpg,Bl122,3
9042.737241,9042.741241,1,voc,271282117,271282237,120,spec2/voc/Bl122_271282117.jpg,Bl122,3
7867.371748,7867.380748,1,voc,236021152,236021422,270,spec2/voc/Bl122_236021152.jpg,Bl122,3
9095.626241,9095.664241,1,voc,272868787,272869927,1140,spec2/voc/Bl122_272868787.jpg,Bl122,3
8921.849773,8921.921773,1,voc,267655493,267657653,2160,spec2/voc/Bl122_267655493.jpg,Bl122,3
3843.424415,3843.621415,1,voc,115302732,115308642,5910,spec2/voc/Bl122_115302732.jpg,Bl122,3
13188.660662,13188.664662,1,voc,395659819,395659939,120,spec2/voc/Bl122_395659819.jpg,Bl122,3
6011.554533,6011.556533,1,voc,180346635,180346695,60,spec2/voc/Bl122_180346635.jpg,Bl122,3
9098.127241,9098.162241,1,voc,272943817,272944867,1050,spec2/voc/Bl122_272943817.jpg,Bl122,3
10942.339807,10942.561807,1,voc,328270194,328276854,6660,spec2/voc/Bl122_328270194.jpg,Bl122,3
14334.876707,14334.901707,1,voc,430046301,430047051,750,spec2/voc/Bl122_430046301.jpg,Bl122,3
7976.538748,7976.548748,1,voc,239296162,239296462,300,spec2/voc/Bl122_239296162.jpg,Bl122,3
5981.209256,5981.212256,1,voc,179436277,179436367,90,spec2/voc/Bl122_179436277.jpg,Bl122,3
11161.18618,11161.18818,1,voc,334835585,334835645,60,spec2/voc/Bl122_334835585.jpg,Bl122,3
9053.488241,9053.491241,1,voc,271604647,271604737,90,spec2/voc/Bl122_271604647.jpg,Bl122,3
9148.836842,9148.846842,1,voc,274465105,274465405,300,spec2/voc/Bl122_274465105.jpg,Bl122,3
13638.653962,13638.697962,1,voc,409159618,409160938,1320,spec2/voc/Bl122_409159618.jpg,Bl122,3
6170.587327,6170.592327,1,voc,185117619,185117769,150,spec2/voc/Bl122_185117619.jpg,Bl122,3
9064.147241,9064.170241,1,voc,271924417,271925107,690,spec2/voc/Bl122_271924417.jpg,Bl122,3
13989.167864,13989.170864,1,voc,419675035,419675125,90,spec2/voc/Bl122_419675035.jpg,Bl122,3
7999.016748,7999.033748,1,voc,239970502,239971012,510,spec2/voc/Bl122_239970502.jpg,Bl122,3
10919.315807,10919.328807,1,voc,327579474,327579864,390,spec2/voc/Bl122_327579474.jpg,Bl122,3
6178.415327,6178.445327,1,voc,185352459,185353359,900,spec2/voc/Bl122_185352459.jpg,Bl122,3
6221.648295,6221.685295,1,voc,186649448,186650558,1110,spec2/voc/Bl122_186649448.jpg,Bl122,3
5997.015256,5997.022256,1,voc,179910457,179910667,210,spec2/voc/Bl122_179910457.jpg,Bl122,3
5989.198256,5989.211256,1,voc,179675947,179676337,390,spec2/voc/Bl122_179675947.jpg,Bl122,3
13200.004389,13200.010389,1,voc,396000131,396000311,180,spec2/voc/Bl122_396000131.jpg,Bl122,3
6026.925533,6027.042533,1,voc,180807765,180811275,3510,spec2/voc/Bl122_180807765.jpg,Bl122,3
11145.933955,11146.026955,1,voc,334378018,334380808,2790,spec2/voc/Bl122_334378018.jpg,Bl122,3
13583.957236,13583.967236,1,voc,407518717,407519017,300,spec2/voc/Bl122_407518717.jpg,Bl122,3
13180.433701,13180.458701,1,voc,395413011,395413761,750,spec2/voc/Bl122_395413011.jpg,Bl122,3
13975.892117,13975.926117,1,voc,419276763,419277783,1020,spec2/voc/Bl122_419276763.jpg,Bl122,3
5941.246256,5941.290256,1,voc,178237387,178238707,1320,spec2/voc/Bl122_178237387.jpg,Bl122,3
12660.994535,12661.006535,1,voc,379829836,379830196,360,spec2/voc/Bl122_379829836.jpg,Bl122,3
8912.906773,8912.919773,1,voc,267387203,267387593,390,spec2/voc/Bl122_267387203.jpg,Bl122,3
7952.533748,7952.572748,1,voc,238576012,238577182,1170,spec2/voc/Bl122_238576012.jpg,Bl122,3
3862.112367,3862.122367,1,voc,115863371,115863671,300,spec2/voc/Bl122_115863371.jpg,Bl122,3
9021.656241,9021.823241,1,voc,270649687,270654697,5010,spec2/voc/Bl122_270649687.jpg,Bl122,3
5964.311256,5964.314256,1,voc,178929337,178929427,90,spec2/voc/Bl122_178929337.jpg,Bl122,3
7952.993748,7953.004748,1,voc,238589812,238590142,330,spec2/voc/Bl122_238589812.jpg,Bl122,3
5929.854364,5929.859364,1,voc,177895630,177895780,150,spec2/voc/Bl122_177895630.jpg,Bl122,3
14167.781454,14168.035454,1,voc,425033443,425041063,7620,spec2/voc/Bl122_425033443.jpg,Bl122,3
11870.813861,11871.032861,1,voc,356124415,356130985,6570,spec2/voc/Bl122_356124415.jpg,Bl122,3
13169.603701,13169.611701,1,voc,395088111,395088351,240,spec2/voc/Bl122_395088111.jpg,Bl122,3
13218.493389,13218.604389,1,voc,396554801,396558131,3330,spec2/voc/Bl122_396554801.jpg,Bl122,3
3876.155848,3876.288848,1,voc,116284675,116288665,3990,spec2/voc/Bl122_116284675.jpg,Bl122,3
5957.552256,5957.633256,1,voc,178726567,178728997,2430,spec2/voc/Bl122_178726567.jpg,Bl122,3
10956.564807,10956.681807,1,voc,328696944,328700454,3510,spec2/voc/Bl122_328696944.jpg,Bl122,3
5929.793364,5929.851364,1,voc,177893800,177895540,1740,spec2/voc/Bl122_177893800.jpg,Bl122,3
7994.786748,7994.898748,1,voc,239843602,239846962,3360,spec2/voc/Bl122_239843602.jpg,Bl122,3
6098.76615,6098.86915,1,voc,182962984,182966074,3090,spec2/voc/Bl122_182962984.jpg,Bl122,3
6099.88515,6099.89015,1,voc,182996554,182996704,150,spec2/voc/Bl122_182996554.jpg,Bl122,3
9141.469757,9141.477757,1,voc,274244092,274244332,240,spec2/voc/Bl122_274244092.jpg,Bl122,3
11163.76318,11163.79518,1,voc,334912895,334913855,960,spec2/voc/Bl122_334912895.jpg,Bl122,3
6153.603349,6153.618349,1,voc,184608100,184608550,450,spec2/voc/Bl122_184608100.jpg,Bl122,3
13174.756701,13174.818701,1,voc,395242701,395244561,1860,spec2/voc/Bl122_395242701.jpg,Bl122,3
5954.803256,5954.805256,1,voc,178644097,178644157,60,spec2/voc/Bl122_178644097.jpg,Bl122,3
5934.137256,5934.156256,1,voc,178024117,178024687,570,spec2/voc/Bl122_178024117.jpg,Bl122,3
9056.817241,9056.860241,1,voc,271704517,271705807,1290,spec2/voc/Bl122_271704517.jpg,Bl122,3
13947.449911,13947.627911,1,voc,418423497,418428837,5340,spec2/voc/Bl122_418423497.jpg,Bl122,3
6205.855327,6205.901327,1,voc,186175659,186177039,1380,spec2/voc/Bl122_186175659.jpg,Bl122,3
3822.169649,3822.219649,1,voc,114665089,114666589,1500,spec2/voc/Bl122_114665089.jpg,Bl122,3
3896.492652,3896.498652,1,voc,116894779,116894959,180,spec2/voc/Bl122_116894779.jpg,Bl122,3
9012.251241,9012.298241,1,voc,270367537,270368947,1410,spec2/voc/Bl122_270367537.jpg,Bl122,3
6099.37115,6099.42515,1,voc,182981134,182982754,1620,spec2/voc/Bl122_182981134.jpg,Bl122,3
13947.651911,13947.653911,1,voc,418429557,418429617,60,spec2/voc/Bl122_418429557.jpg,Bl122,3
14838.804682,14838.846682,1,voc,445164140,445165400,1260,spec2/voc/Bl122_445164140.jpg,Bl122,3
10934.642807,10934.777807,1,voc,328039284,328043334,4050,spec2/voc/Bl122_328039284.jpg,Bl122,3
10923.175807,10923.216807,1,voc,327695274,327696504,1230,spec2/voc/Bl122_327695274.jpg,Bl122,3
6064.760705,6064.767705,1,voc,181942821,181943031,210,spec2/voc/Bl122_181942821.jpg,Bl122,3
11040.947892,11041.383892,1,voc,331228436,331241516,13080,spec2/voc/Bl122_331228436.jpg,Bl122,3
12204.322035,12204.535035,1,voc,366129661,366136051,6390,spec2/voc/Bl122_366129661.jpg,Bl122,3
9059.176241,9059.181241,1,voc,271775287,271775437,150,spec2/voc/Bl122_271775287.jpg,Bl122,3
7936.640748,7936.658748,1,voc,238099222,238099762,540,spec2/voc/Bl122_238099222.jpg,Bl122,3
10923.494807,10923.936807,1,voc,327704844,327718104,13260,spec2/voc/Bl122_327704844.jpg,Bl122,3
13983.833943,13983.848943,1,voc,419515018,419515468,450,spec2/voc/Bl122_419515018.jpg,Bl122,3
3815.005649,3815.278649,1,voc,114450169,114458359,8190,spec2/voc/Bl122_114450169.jpg,Bl122,3
6037.645533,6037.719533,1,voc,181129365,181131585,2220,spec2/voc/Bl122_181129365.jpg,Bl122,3
9070.550241,9070.775241,1,voc,272116507,272123257,6750,spec2/voc/Bl122_272116507.jpg,Bl122,3
6061.319705,6061.345705,1,voc,181839591,181840371,780,spec2/voc/Bl122_181839591.jpg,Bl122,3
13203.641389,13203.785389,1,voc,396109241,396113561,4320,spec2/voc/Bl122_396109241.jpg,Bl122,3
9100.835241,9100.845241,1,voc,273025057,273025357,300,spec2/voc/Bl122_273025057.jpg,Bl122,3
8925.483773,8925.498773,1,voc,267764513,267764963,450,spec2/voc/Bl122_267764513.jpg,Bl122,3
7841.295748,7841.311748,1,voc,235238872,235239352,480,spec2/voc/Bl122_235238872.jpg,Bl122,3
9098.239241,9098.281241,1,voc,272947177,272948437,1260,spec2/voc/Bl122_272947177.jpg,Bl122,3
3838.919415,3838.945415,1,voc,115167582,115168362,780,spec2/voc/Bl122_115167582.jpg,Bl122,3
9067.861241,9067.864241,1,voc,272035837,272035927,90,spec2/voc/Bl122_272035837.jpg,Bl122,3
9024.955241,9025.124241,1,voc,270748657,270753727,5070,spec2/voc/Bl122_270748657.jpg,Bl122,3
9051.183241,9051.190241,1,voc,271535497,271535707,210,spec2/voc/Bl122_271535497.jpg,Bl122,3
11151.85218,11151.96018,1,voc,334555565,334558805,3240,spec2/voc/Bl122_334555565.jpg,Bl122,3
9162.208057,9162.386057,1,voc,274866241,274871581,5340,spec2/voc/Bl122_274866241.jpg,Bl122,3
14821.340551,14821.386551,1,voc,444640216,444641596,1380,spec2/voc/Bl122_444640216.jpg,Bl122,3
9065.042241,9065.236241,1,voc,271951267,271957087,5820,spec2/voc/Bl122_271951267.jpg,Bl122,3
5986.428256,5986.439256,1,voc,179592847,179593177,330,spec2/voc/Bl122_179592847.jpg,Bl122,3
9020.262241,9020.272241,1,voc,270607867,270608167,300,spec2/voc/Bl122_270607867.jpg,Bl122,3
5998.942256,5998.964256,1,voc,179968267,179968927,660,spec2/voc/Bl122_179968267.jpg,Bl122,3
7859.628748,7859.634748,1,voc,235788862,235789042,180,spec2/voc/Bl122_235788862.jpg,Bl122,3
9099.113241,9099.121241,1,voc,272973397,272973637,240,spec2/voc/Bl122_272973397.jpg,Bl122,3
13914.959392,13915.133392,1,voc,417448781,417454001,5220,spec2/voc/Bl122_417448781.jpg,Bl122,3
13789.68746,13789.86146,1,voc,413690623,413695843,5220,spec2/voc/Bl122_413690623.jpg,Bl122,3
7772.910748,7772.919748,1,voc,233187322,233187592,270,spec2/voc/Bl122_233187322.jpg,Bl122,3
9064.563241,9064.577241,1,voc,271936897,271937317,420,spec2/voc/Bl122_271936897.jpg,Bl122,3
5998.489256,5998.511256,1,voc,179954677,179955337,660,spec2/voc/Bl122_179954677.jpg,Bl122,3
8912.971773,8912.982773,1,voc,267389153,267389483,330,spec2/voc/Bl122_267389153.jpg,Bl122,3
6035.286533,6035.298533,1,voc,181058595,181058955,360,spec2/voc/Bl122_181058595.jpg,Bl122,3
10928.967807,10929.042807,1,voc,327869034,327871284,2250,spec2/voc/Bl122_327869034.jpg,Bl122,3
14817.739551,14817.842551,1,voc,444532186,444535276,3090,spec2/voc/Bl122_444532186.jpg,Bl122,3
6023.933533,6023.940533,1,voc,180718005,180718215,210,spec2/voc/Bl122_180718005.jpg,Bl122,3
13170.094701,13170.107701,1,voc,395102841,395103231,390,spec2/voc/Bl122_395102841.jpg,Bl122,3
3829.483649,3829.502649,1,voc,114884509,114885079,570,spec2/voc/Bl122_114884509.jpg,Bl122,3
5948.627256,5948.674256,1,voc,178458817,178460227,1410,spec2/voc/Bl122_178458817.jpg,Bl122,3
11208.576894,11208.579894,1,voc,336257306,336257396,90,spec2/voc/Bl122_336257306.jpg,Bl122,3
14820.287551,14820.396551,1,voc,444608626,444611896,3270,spec2/voc/Bl122_444608626.jpg,Bl122,3
13998.679512,13998.693512,1,voc,419960385,419960805,420,spec2/voc/Bl122_419960385.jpg,Bl122,3
13638.869962,13638.922962,1,voc,409166098,409167688,1590,spec2/voc/Bl122_409166098.jpg,Bl122,3
14201.989387,14201.998387,1,voc,426059681,426059951,270,spec2/voc/Bl122_426059681.jpg,Bl122,3
8919.670773,8919.697773,1,voc,267590123,267590933,810,spec2/voc/Bl122_267590123.jpg,Bl122,3
6171.005327,6171.010327,1,voc,185130159,185130309,150,spec2/voc/Bl122_185130159.jpg,Bl122,3
6105.807706,6105.832706,1,voc,183174231,183174981,750,spec2/voc/Bl122_183174231.jpg,Bl122,3
6222.624295,6222.626295,1,voc,186678728,186678788,60,spec2/voc/Bl122_186678728.jpg,Bl122,3
5997.451256,5997.457256,1,voc,179923537,179923717,180,spec2/voc/Bl122_179923537.jpg,Bl122,3
8938.402967,8938.406967,1,voc,268152089,268152209,120,spec2/voc/Bl122_268152089.jpg,Bl122,3
6067.815705,6067.896705,1,voc,182034471,182036901,2430,spec2/voc/Bl122_182034471.jpg,Bl122,3
6005.210256,6005.237256,1,voc,180156307,180157117,810,spec2/voc/Bl122_180156307.jpg,Bl122,3
6048.7052,6048.7142,1,voc,181461156,181461426,270,spec2/voc/Bl122_181461156.jpg,Bl122,3
13914.951392,13914.956392,1,voc,417448541,417448691,150,spec2/voc/Bl122_417448541.jpg,Bl122,3
9109.009935,9109.015935,1,voc,273270298,273270478,180,spec2/voc/Bl122_273270298.jpg,Bl122,3
7929.172748,7929.185748,1,voc,237875182,237875572,390,spec2/voc/Bl122_237875182.jpg,Bl122,3
9091.432241,9091.500241,1,voc,272742967,272745007,2040,spec2/voc/Bl122_272742967.jpg,Bl122,3
3844.048415,3844.088415,1,voc,115321452,115322652,1200,spec2/voc/Bl122_115321452.jpg,Bl122,3
13175.024701,13175.046701,1,voc,395250741,395251401,660,spec2/voc/Bl122_395250741.jpg,Bl122,3
7874.434748,7874.445748,1,voc,236233042,236233372,330,spec2/voc/Bl122_236233042.jpg,Bl122,3
8964.690712,8964.717712,1,voc,268940721,268941531,810,spec2/voc/Bl122_268940721.jpg,Bl122,3
9042.480241,9042.486241,1,voc,271274407,271274587,180,spec2/voc/Bl122_271274407.jpg,Bl122,3
6059.631705,6059.715705,1,voc,181788951,181791471,2520,spec2/voc/Bl122_181788951.jpg,Bl122,3
5959.456256,5959.459256,1,voc,178783687,178783777,90,spec2/voc/Bl122_178783687.jpg,Bl122,3
5986.485256,5986.491256,1,voc,179594557,179594737,180,spec2/voc/Bl122_179594557.jpg,Bl122,3
11142.758955,11142.795955,1,voc,334282768,334283878,1110,spec2/voc/Bl122_334282768.jpg,Bl122,3
7908.769748,7908.772748,1,voc,237263092,237263182,90,spec2/voc/Bl122_237263092.jpg,Bl122,3
5936.316256,5936.455256,1,voc,178089487,178093657,4170,spec2/voc/Bl122_178089487.jpg,Bl122,3
7860.971748,7861.018748,1,voc,235829152,235830562,1410,spec2/voc/Bl122_235829152.jpg,Bl122,3
9054.721241,9054.726241,1,voc,271641637,271641787,150,spec2/voc/Bl122_271641637.jpg,Bl122,3
6187.791327,6187.794327,1,voc,185633739,185633829,90,spec2/voc/Bl122_185633739.jpg,Bl122,3
13826.00622,13826.00922,1,voc,414780186,414780276,90,spec2/voc/Bl122_414780186.jpg,Bl122,3
10915.367807,10915.391807,1,voc,327461034,327461754,720,spec2/voc/Bl122_327461034.jpg,Bl122,3
14822.262551,14822.264551,1,voc,444667876,444667936,60,spec2/voc/Bl122_444667876.jpg,Bl122,3
5990.659256,5990.707256,1,voc,179719777,179721217,1440,spec2/voc/Bl122_179719777.jpg,Bl122,3
13960.349384,13960.354384,1,voc,418810481,418810631,150,spec2/voc/Bl122_418810481.jpg,Bl122,3
9096.689241,9096.757241,1,voc,272900677,272902717,2040,spec2/voc/Bl122_272900677.jpg,Bl122,3
8937.003967,8937.014967,1,voc,268110119,268110449,330,spec2/voc/Bl122_268110119.jpg,Bl122,3
6113.260706,6113.268706,1,voc,183397821,183398061,240,spec2/voc/Bl122_183397821.jpg,Bl122,3
5945.718256,5945.720256,1,voc,178371547,178371607,60,spec2/voc/Bl122_178371547.jpg,Bl122,3
11129.462005,11129.668005,1,voc,333883860,333890040,6180,spec2/voc/Bl122_333883860.jpg,Bl122,3
10957.077807,10957.081807,1,voc,328712334,328712454,120,spec2/voc/Bl122_328712334.jpg,Bl122,3
14148.855855,14149.065855,1,voc,424465675,424471975,6300,spec2/voc/Bl122_424465675.jpg,Bl122,3
5990.955256,5990.986256,1,voc,179728657,179729587,930,spec2/voc/Bl122_179728657.jpg,Bl122,3
7814.640748,7814.645748,1,voc,234439222,234439372,150,spec2/voc/Bl122_234439222.jpg,Bl122,3
7874.455748,7874.461748,1,voc,236233672,236233852,180,spec2/voc/Bl122_236233672.jpg,Bl122,3
3850.348415,3850.357415,1,voc,115510452,115510722,270,spec2/voc/Bl122_115510452.jpg,Bl122,3
14817.499551,14817.502551,1,voc,444524986,444525076,90,spec2/voc/Bl122_444524986.jpg,Bl122,3
8992.845241,8992.854241,1,voc,269785357,269785627,270,spec2/voc/Bl122_269785357.jpg,Bl122,3
6096.95415,6096.99015,1,voc,182908624,182909704,1080,spec2/voc/Bl122_182908624.jpg,Bl122,3
6033.243533,6033.250533,1,voc,180997305,180997515,210,spec2/voc/Bl122_180997305.jpg,Bl122,3
12622.126161,12622.417161,1,voc,378663784,378672514,8730,spec2/voc/Bl122_378663784.jpg,Bl122,3
9083.718241,9083.897241,1,voc,272511547,272516917,5370,spec2/voc/Bl122_272511547.jpg,Bl122,3
6017.693533,6017.710533,1,voc,180530805,180531315,510,spec2/voc/Bl122_180530805.jpg,Bl122,3
3049.126397,3049.179397,1,voc,91473791,91475381,1590,spec2/voc/Bl122_91473791.jpg,Bl122,3
10931.426807,10931.462807,1,voc,327942804,327943884,1080,spec2/voc/Bl122_327942804.jpg,Bl122,3
6037.400533,6037.405533,1,voc,181122015,181122165,150,spec2/voc/Bl122_181122015.jpg,Bl122,3
14805.086551,14805.097551,1,voc,444152596,444152926,330,spec2/voc/Bl122_444152596.jpg,Bl122,3
10957.141807,10957.193807,1,voc,328714254,328715814,1560,spec2/voc/Bl122_328714254.jpg,Bl122,3
10875.154466,10875.249466,1,voc,326254633,326257483,2850,spec2/voc/Bl122_326254633.jpg,Bl122,3
13947.630911,13947.634911,1,voc,418428927,418429047,120,spec2/voc/Bl122_418428927.jpg,Bl122,3
10887.787136,10887.806136,1,voc,326633614,326634184,570,spec2/voc/Bl122_326633614.jpg,Bl122,3
3890.131652,3890.205652,1,voc,116703949,116706169,2220,spec2/voc/Bl122_116703949.jpg,Bl122,3
14819.299551,14819.443551,1,voc,444578986,444583306,4320,spec2/voc/Bl122_444578986.jpg,Bl122,3
10926.174807,10926.187807,1,voc,327785244,327785634,390,spec2/voc/Bl122_327785244.jpg,Bl122,3
6138.242293,6138.253293,1,voc,184147268,184147598,330,spec2/voc/Bl122_184147268.jpg,Bl122,3
13187.724662,13187.798662,1,voc,395631739,395633959,2220,spec2/voc/Bl122_395631739.jpg,Bl122,3
6025.178533,6025.201533,1,voc,180755355,180756045,690,spec2/voc/Bl122_180755355.jpg,Bl122,3
3804.882649,3804.913649,1,voc,114146479,114147409,930,spec2/voc/Bl122_114146479.jpg,Bl122,3
5964.357256,5964.365256,1,voc,178930717,178930957,240,spec2/voc/Bl122_178930717.jpg,Bl122,3
3894.448652,3894.475652,1,voc,116833459,116834269,810,spec2/voc/Bl122_116833459.jpg,Bl122,3
11210.927894,11210.966894,1,voc,336327836,336329006,1170,spec2/voc/Bl122_336327836.jpg,Bl122,3
8022.525748,8022.528748,1,voc,240675772,240675862,90,spec2/voc/Bl122_240675772.jpg,Bl122,3
13244.711606,13244.735606,1,voc,397341348,397342068,720,spec2/voc/Bl122_397341348.jpg,Bl122,3
10933.866807,10933.908807,1,voc,328016004,328017264,1260,spec2/voc/Bl122_328016004.jpg,Bl122,3
6049.0202,6049.0262,1,voc,181470606,181470786,180,spec2/voc/Bl122_181470606.jpg,Bl122,3
3812.683649,3812.688649,1,voc,114380509,114380659,150,spec2/voc/Bl122_114380509.jpg,Bl122,3
9058.500241,9058.554241,1,voc,271755007,271756627,1620,spec2/voc/Bl122_271755007.jpg,Bl122,3
14818.395551,14818.403551,1,voc,444551866,444552106,240,spec2/voc/Bl122_444551866.jpg,Bl122,3
14805.039551,14805.049551,1,voc,444151186,444151486,300,spec2/voc/Bl122_444151186.jpg,Bl122,3
9162.189057,9162.203057,1,voc,274865671,274866091,420,spec2/voc/Bl122_274865671.jpg,Bl122,3
6088.77815,6088.79415,1,voc,182663344,182663824,480,spec2/voc/Bl122_182663344.jpg,Bl122,3
8996.824241,8996.841241,1,voc,269904727,269905237,510,spec2/voc/Bl122_269904727.jpg,Bl122,3
8986.966025,8987.213025,1,voc,269608980,269616390,7410,spec2/voc/Bl122_269608980.jpg,Bl122,3
3055.119464,3055.138464,1,voc,91653583,91654153,570,spec2/voc/Bl122_91653583.jpg,Bl122,3
6055.853705,6055.879705,1,voc,181675611,181676391,780,spec2/voc/Bl122_181675611.jpg,Bl122,3
11953.501309,11953.509309,1,voc,358605039,358605279,240,spec2/voc/Bl122_358605039.jpg,Bl122,3
9016.663241,9016.861241,1,voc,270499897,270505837,5940,spec2/voc/Bl122_270499897.jpg,Bl122,3
7972.755748,7972.766748,1,voc,239182672,239183002,330,spec2/voc/Bl122_239182672.jpg,Bl122,3
9034.193241,9034.383241,1,voc,271025797,271031497,5700,spec2/voc/Bl122_271025797.jpg,Bl122,3
10918.219807,10918.229807,1,voc,327546594,327546894,300,spec2/voc/Bl122_327546594.jpg,Bl122,3
8008.627748,8008.640748,1,voc,240258832,240259222,390,spec2/voc/Bl122_240258832.jpg,Bl122,3
6116.309706,6116.522706,1,voc,183489291,183495681,6390,spec2/voc/Bl122_183489291.jpg,Bl122,3
3824.166649,3824.187649,1,voc,114724999,114725629,630,spec2/voc/Bl122_114724999.jpg,Bl122,3
9073.294241,9073.306241,1,voc,272198827,272199187,360,spec2/voc/Bl122_272198827.jpg,Bl122,3
5944.587256,5944.592256,1,voc,178337617,178337767,150,spec2/voc/Bl122_178337617.jpg,Bl122,3
11190.88918,11190.91618,1,voc,335726675,335727485,810,spec2/voc/Bl122_335726675.jpg,Bl122,3
3822.266649,3822.309649,1,voc,114667999,114669289,1290,spec2/voc/Bl122_114667999.jpg,Bl122,3
9132.144981,9132.190981,1,voc,273964349,273965729,1380,spec2/voc/Bl122_273964349.jpg,Bl122,3
3856.415415,3856.542415,1,voc,115692462,115696272,3810,spec2/voc/Bl122_115692462.jpg,Bl122,3
3822.076649,3822.084649,1,voc,114662299,114662539,240,spec2/voc/Bl122_114662299.jpg,Bl122,3
14842.950682,14843.062682,1,voc,445288520,445291880,3360,spec2/voc/Bl122_445288520.jpg,Bl122,3
7844.397748,7844.399748,1,voc,235331932,235331992,60,spec2/voc/Bl122_235331932.jpg,Bl122,3
9006.115241,9006.117241,1,voc,270183457,270183517,60,spec2/voc/Bl122_270183457.jpg,Bl122,3
11189.04618,11189.17818,1,voc,335671385,335675345,3960,spec2/voc/Bl122_335671385.jpg,Bl122,3
8039.604748,8039.607748,1,voc,241188142,241188232,90,spec2/voc/Bl122_241188142.jpg,Bl122,3
3057.209192,3057.212192,1,voc,91716275,91716365,90,spec2/voc/Bl122_91716275.jpg,Bl122,3
13968.653352,13968.656352,1,voc,419059600,419059690,90,spec2/voc/Bl122_419059600.jpg,Bl122,3
6097.57615,6097.62915,1,voc,182927284,182928874,1590,spec2/voc/Bl122_182927284.jpg,Bl122,3
3850.135415,3850.139415,1,voc,115504062,115504182,120,spec2/voc/Bl122_115504062.jpg,Bl122,3
11168.87018,11168.96018,1,voc,335066105,335068805,2700,spec2/voc/Bl122_335066105.jpg,Bl122,3
9088.960241,9089.164241,1,voc,272668807,272674927,6120,spec2/voc/Bl122_272668807.jpg,Bl122,3
14162.901897,14162.906897,1,voc,424887056,424887206,150,spec2/voc/Bl122_424887056.jpg,Bl122,3
7781.049748,7781.053748,1,voc,233431492,233431612,120,spec2/voc/Bl122_233431492.jpg,Bl122,3
7915.542748,7915.602748,1,voc,237466282,237468082,1800,spec2/voc/Bl122_237466282.jpg,Bl122,3
6058.485705,6058.494705,1,voc,181754571,181754841,270,spec2/voc/Bl122_181754571.jpg,Bl122,3
3886.258062,3886.338062,1,voc,116587741,116590141,2400,spec2/voc/Bl122_116587741.jpg,Bl122,3
5951.827256,5951.855256,1,voc,178554817,178555657,840,spec2/voc/Bl122_178554817.jpg,Bl122,3
6018.722533,6018.734533,1,voc,180561675,180562035,360,spec2/voc/Bl122_180561675.jpg,Bl122,3
10952.736807,10952.775807,1,voc,328582104,328583274,1170,spec2/voc/Bl122_328582104.jpg,Bl122,3
6008.567533,6008.856533,1,voc,180257025,180265695,8670,spec2/voc/Bl122_180257025.jpg,Bl122,3
9020.647241,9020.785241,1,voc,270619417,270623557,4140,spec2/voc/Bl122_270619417.jpg,Bl122,3
9063.778241,9063.784241,1,voc,271913347,271913527,180,spec2/voc/Bl122_271913347.jpg,Bl122,3
11197.30818,11197.40618,1,voc,335919245,335922185,2940,spec2/voc/Bl122_335919245.jpg,Bl122,3
10934.789807,10935.026807,1,voc,328043694,328050804,7110,spec2/voc/Bl122_328043694.jpg,Bl122,3
3812.734649,3812.778649,1,voc,114382039,114383359,1320,spec2/voc/Bl122_114382039.jpg,Bl122,3
14800.384551,14800.830551,1,voc,444011536,444024916,13380,spec2/voc/Bl122_444011536.jpg,Bl122,3
7781.056748,7781.062748,1,voc,233431702,233431882,180,spec2/voc/Bl122_233431702.jpg,Bl122,3
11211.610894,11211.631894,1,voc,336348326,336348956,630,spec2/voc/Bl122_336348326.jpg,Bl122,3
5971.703256,5971.862256,1,voc,179151097,179155867,4770,spec2/voc/Bl122_179151097.jpg,Bl122,3
3886.511062,3886.514062,1,voc,116595331,116595421,90,spec2/voc/Bl122_116595331.jpg,Bl122,3
13204.627389,13204.641389,1,voc,396138821,396139241,420,spec2/voc/Bl122_396138821.jpg,Bl122,3
7907.566748,7907.601748,1,voc,237227002,237228052,1050,spec2/voc/Bl122_237227002.jpg,Bl122,3
8993.731241,8993.736241,1,voc,269811937,269812087,150,spec2/voc/Bl122_269811937.jpg,Bl122,3
10947.523807,10947.553807,1,voc,328425714,328426614,900,spec2/voc/Bl122_328425714.jpg,Bl122,3
8013.104748,8013.112748,1,voc,240393142,240393382,240,spec2/voc/Bl122_240393142.jpg,Bl122,3
6064.773705,6064.780705,1,voc,181943211,181943421,210,spec2/voc/Bl122_181943211.jpg,Bl122,3
9059.507241,9059.739241,1,voc,271785217,271792177,6960,spec2/voc/Bl122_271785217.jpg,Bl122,3
8202.608005,8202.832005,1,voc,246078240,246084960,6720,spec2/voc/Bl122_246078240.jpg,Bl122,3
13212.073389,13212.082389,1,voc,396362201,396362471,270,spec2/voc/Bl122_396362201.jpg,Bl122,3
8925.501773,8925.621773,1,voc,267765053,267768653,3600,spec2/voc/Bl122_267765053.jpg,Bl122,3
7845.001748,7845.022748,1,voc,235350052,235350682,630,spec2/voc/Bl122_235350052.jpg,Bl122,3
9113.857184,9114.019184,1,voc,273415715,273420575,4860,spec2/voc/Bl122_273415715.jpg,Bl122,3
5929.748364,5929.751364,1,voc,177892450,177892540,90,spec2/voc/Bl122_177892450.jpg,Bl122,3
9164.948604,9165.209604,1,voc,274948458,274956288,7830,spec2/voc/Bl122_274948458.jpg,Bl122,3
9040.343241,9040.371241,1,voc,271210297,271211137,840,spec2/voc/Bl122_271210297.jpg,Bl122,3
3882.268062,3882.431062,1,voc,116468041,116472931,4890,spec2/voc/Bl122_116468041.jpg,Bl122,3
6031.895533,6032.100533,1,voc,180956865,180963015,6150,spec2/voc/Bl122_180956865.jpg,Bl122,3
10897.198557,10897.213557,1,voc,326915956,326916406,450,spec2/voc/Bl122_326915956.jpg,Bl122,3
13968.532352,13968.643352,1,voc,419055970,419059300,3330,spec2/voc/Bl122_419055970.jpg,Bl122,3
13823.17022,13823.38722,1,voc,414695106,414701616,6510,spec2/voc/Bl122_414695106.jpg,Bl122,3
9058.960241,9059.036241,1,voc,271768807,271771087,2280,spec2/voc/Bl122_271768807.jpg,Bl122,3
8919.918773,8919.929773,1,voc,267597563,267597893,330,spec2/voc/Bl122_267597563.jpg,Bl122,3
7861.739748,7861.746748,1,voc,235852192,235852402,210,spec2/voc/Bl122_235852192.jpg,Bl122,3
11125.484005,11125.487005,1,voc,333764520,333764610,90,spec2/voc/Bl122_333764520.jpg,Bl122,3
10906.238825,10906.333825,1,voc,327187164,327190014,2850,spec2/voc/Bl122_327187164.jpg,Bl122,3
5938.883256,5938.888256,1,voc,178166497,178166647,150,spec2/voc/Bl122_178166497.jpg,Bl122,3
10936.887807,10936.900807,1,voc,328106634,328107024,390,spec2/voc/Bl122_328106634.jpg,Bl122,3
9169.668604,9169.922604,1,voc,275090058,275097678,7620,spec2/voc/Bl122_275090058.jpg,Bl122,3
6158.891349,6158.970349,1,voc,184766740,184769110,2370,spec2/voc/Bl122_184766740.jpg,Bl122,3
11162.65418,11162.65818,1,voc,334879625,334879745,120,spec2/voc/Bl122_334879625.jpg,Bl122,3
13170.590701,13170.641701,1,voc,395117721,395119251,1530,spec2/voc/Bl122_395117721.jpg,Bl122,3
10953.007807,10953.140807,1,voc,328590234,328594224,3990,spec2/voc/Bl122_328590234.jpg,Bl122,3
6032.773533,6032.787533,1,voc,180983205,180983625,420,spec2/voc/Bl122_180983205.jpg,Bl122,3
9152.146842,9152.386842,1,voc,274564405,274571605,7200,spec2/voc/Bl122_274564405.jpg,Bl122,3
7890.423748,7890.440748,1,voc,236712712,236713222,510,spec2/voc/Bl122_236712712.jpg,Bl122,3
3825.342649,3825.360649,1,voc,114760279,114760819,540,spec2/voc/Bl122_114760279.jpg,Bl122,3
9060.311241,9060.314241,1,voc,271809337,271809427,90,spec2/voc/Bl122_271809337.jpg,Bl122,3
10929.858807,10929.883807,1,voc,327895764,327896514,750,spec2/voc/Bl122_327895764.jpg,Bl122,3
3803.782649,3803.930649,1,voc,114113479,114117919,4440,spec2/voc/Bl122_114113479.jpg,Bl122,3
11050.97,11051.02,1,voc,331529100,331530600,1500,spec2/voc/Bl122_331529100.jpg,Bl122,3
3851.035415,3851.049415,1,voc,115531062,115531482,420,spec2/voc/Bl122_115531062.jpg,Bl122,3
7845.622748,7845.633748,1,voc,235368682,235369012,330,spec2/voc/Bl122_235368682.jpg,Bl122,3
11207.835894,11207.861894,1,voc,336235076,336235856,780,spec2/voc/Bl122_336235076.jpg,Bl122,3
11046.296537,11046.298537,1,voc,331388896,331388956,60,spec2/voc/Bl122_331388896.jpg,Bl122,3
9124.909182,9125.118182,1,voc,273747275,273753545,6270,spec2/voc/Bl122_273747275.jpg,Bl122,3
3057.073192,3057.136192,1,voc,91712195,91714085,1890,spec2/voc/Bl122_91712195.jpg,Bl122,3
7929.096748,7929.129748,1,voc,237872902,237873892,990,spec2/voc/Bl122_237872902.jpg,Bl122,3
7843.889748,7843.912748,1,voc,235316692,235317382,690,spec2/voc/Bl122_235316692.jpg,Bl122,3
7952.411748,7952.516748,1,voc,238572352,238575502,3150,spec2/voc/Bl122_238572352.jpg,Bl122,3
3886.549062,3886.759062,1,voc,116596471,116602771,6300,spec2/voc/Bl122_116596471.jpg,Bl122,3
14824.815551,14824.828551,1,voc,444744466,444744856,390,spec2/voc/Bl122_444744466.jpg,Bl122,3
6178.342327,6178.351327,1,voc,185350269,185350539,270,spec2/voc/Bl122_185350269.jpg,Bl122,3
11150.77918,11150.78518,1,voc,334523375,334523555,180,spec2/voc/Bl122_334523375.jpg,Bl122,3
13946.692911,13946.714911,1,voc,418400787,418401447,660,spec2/voc/Bl122_418400787.jpg,Bl122,3
13163.652891,13163.765891,1,voc,394909586,394912976,3390,spec2/voc/Bl122_394909586.jpg,Bl122,3
5978.521256,5978.534256,1,voc,179355637,179356027,390,spec2/voc/Bl122_179355637.jpg,Bl122,3
8955.407967,8955.467967,1,voc,268662239,268664039,1800,spec2/voc/Bl122_268662239.jpg,Bl122,3
10943.658807,10943.693807,1,voc,328309764,328310814,1050,spec2/voc/Bl122_328309764.jpg,Bl122,3
9123.683182,9123.773182,1,voc,273710495,273713195,2700,spec2/voc/Bl122_273710495.jpg,Bl122,3
7962.587748,7962.625748,1,voc,238877632,238878772,1140,spec2/voc/Bl122_238877632.jpg,Bl122,3
6058.986705,6059.241705,1,voc,181769601,181777251,7650,spec2/voc/Bl122_181769601.jpg,Bl122,3
6056.203705,6056.233705,1,voc,181686111,181687011,900,spec2/voc/Bl122_181686111.jpg,Bl122,3
12589.295377,12589.298377,1,voc,377678861,377678951,90,spec2/voc/Bl122_377678861.jpg,Bl122,3
13162.210891,13162.231891,1,voc,394866326,394866956,630,spec2/voc/Bl122_394866326.jpg,Bl122,3
7723.440941,7723.447941,1,voc,231703228,231703438,210,spec2/voc/Bl122_231703228.jpg,Bl122,3
5955.192256,5955.196256,1,voc,178655767,178655887,120,spec2/voc/Bl122_178655767.jpg,Bl122,3
6077.305705,6077.384705,1,voc,182319171,182321541,2370,spec2/voc/Bl122_182319171.jpg,Bl122,3
13583.925236,13583.943236,1,voc,407517757,407518297,540,spec2/voc/Bl122_407517757.jpg,Bl122,3
3815.983649,3815.987649,1,voc,114479509,114479629,120,spec2/voc/Bl122_114479509.jpg,Bl122,3
5954.068256,5954.301256,1,voc,178622047,178629037,6990,spec2/voc/Bl122_178622047.jpg,Bl122,3
13169.797701,13169.800701,1,voc,395093931,395094021,90,spec2/voc/Bl122_395093931.jpg,Bl122,3
14814.457551,14814.553551,1,voc,444433726,444436606,2880,spec2/voc/Bl122_444433726.jpg,Bl122,3
5946.865256,5946.880256,1,voc,178405957,178406407,450,spec2/voc/Bl122_178405957.jpg,Bl122,3
6081.306511,6081.439511,1,voc,182439195,182443185,3990,spec2/voc/Bl122_182439195.jpg,Bl122,3
9059.429241,9059.433241,1,voc,271782877,271782997,120,spec2/voc/Bl122_271782877.jpg,Bl122,3
7908.485748,7908.499748,1,voc,237254572,237254992,420,spec2/voc/Bl122_237254572.jpg,Bl122,3
7932.228748,7932.240748,1,voc,237966862,237967222,360,spec2/voc/Bl122_237966862.jpg,Bl122,3
8944.149967,8944.210967,1,voc,268324499,268326329,1830,spec2/voc/Bl122_268324499.jpg,Bl122,3
3806.579649,3806.589649,1,voc,114197389,114197689,300,spec2/voc/Bl122_114197389.jpg,Bl122,3
8923.480773,8923.726773,1,voc,267704423,267711803,7380,spec2/voc/Bl122_267704423.jpg,Bl122,3
5952.262256,5952.268256,1,voc,178567867,178568047,180,spec2/voc/Bl122_178567867.jpg,Bl122,3
7863.786748,7863.821748,1,voc,235913602,235914652,1050,spec2/voc/Bl122_235913602.jpg,Bl122,3
5951.151256,5951.166256,1,voc,178534537,178534987,450,spec2/voc/Bl122_178534537.jpg,Bl122,3
14817.245551,14817.281551,1,voc,444517366,444518446,1080,spec2/voc/Bl122_444517366.jpg,Bl122,3
3860.672367,3860.675367,1,voc,115820171,115820261,90,spec2/voc/Bl122_115820171.jpg,Bl122,3
6026.279533,6026.282533,1,voc,180788385,180788475,90,spec2/voc/Bl122_180788385.jpg,Bl122,3
9088.538241,9088.543241,1,voc,272656147,272656297,150,spec2/voc/Bl122_272656147.jpg,Bl122,3
6061.288705,6061.291705,1,voc,181838661,181838751,90,spec2/voc/Bl122_181838661.jpg,Bl122,3
10834.464086,10834.518086,1,voc,325033922,325035542,1620,spec2/voc/Bl122_325033922.jpg,Bl122,3
9069.862241,9069.869241,1,voc,272095867,272096077,210,spec2/voc/Bl122_272095867.jpg,Bl122,3
8986.008025,8986.666025,1,voc,269580240,269599980,19740,spec2/voc/Bl122_269580240.jpg,Bl122,3
6012.829533,6012.846533,1,voc,180384885,180385395,510,spec2/voc/Bl122_180384885.jpg,Bl122,3
8950.839967,8950.841967,1,voc,268525199,268525259,60,spec2/voc/Bl122_268525199.jpg,Bl122,3
5971.934256,5971.970256,1,voc,179158027,179159107,1080,spec2/voc/Bl122_179158027.jpg,Bl122,3
7844.390748,7844.393748,1,voc,235331722,235331812,90,spec2/voc/Bl122_235331722.jpg,Bl122,3
6068.656705,6068.695705,1,voc,182059701,182060871,1170,spec2/voc/Bl122_182059701.jpg,Bl122,3
11172.98518,11173.00618,1,voc,335189555,335190185,630,spec2/voc/Bl122_335189555.jpg,Bl122,3
5987.528256,5987.531256,1,voc,179625847,179625937,90,spec2/voc/Bl122_179625847.jpg,Bl122,3
5974.073256,5974.079256,1,voc,179222197,179222377,180,spec2/voc/Bl122_179222197.jpg,Bl122,3
3818.694649,3818.699649,1,voc,114560839,114560989,150,spec2/voc/Bl122_114560839.jpg,Bl122,3
13220.224389,13220.361389,1,voc,396606731,396610841,4110,spec2/voc/Bl122_396606731.jpg,Bl122,3
9095.174241,9095.187241,1,voc,272855227,272855617,390,spec2/voc/Bl122_272855227.jpg,Bl122,3
7803.317748,7803.327748,1,voc,234099532,234099832,300,spec2/voc/Bl122_234099532.jpg,Bl122,3
7992.887748,7992.890748,1,voc,239786632,239786722,90,spec2/voc/Bl122_239786632.jpg,Bl122,3
5947.150256,5947.195256,1,voc,178414507,178415857,1350,spec2/voc/Bl122_178414507.jpg,Bl122,3
13966.597352,13966.621352,1,voc,418997920,418998640,720,spec2/voc/Bl122_418997920.jpg,Bl122,3
14839.547682,14839.572682,1,voc,445186430,445187180,750,spec2/voc/Bl122_445186430.jpg,Bl122,3
9050.320241,9050.324241,1,voc,271509607,271509727,120,spec2/voc/Bl122_271509607.jpg,Bl122,3
12589.060377,12589.077377,1,voc,377671811,377672321,510,spec2/voc/Bl122_377671811.jpg,Bl122,3
7991.914748,7991.939748,1,voc,239757442,239758192,750,spec2/voc/Bl122_239757442.jpg,Bl122,3
8021.769748,8021.781748,1,voc,240653092,240653452,360,spec2/voc/Bl122_240653092.jpg,Bl122,3
8915.266773,8915.309773,1,voc,267458003,267459293,1290,spec2/voc/Bl122_267458003.jpg,Bl122,3
5971.988256,5972.023256,1,voc,179159647,179160697,1050,spec2/voc/Bl122_179159647.jpg,Bl122,3
6050.4282,6050.4432,1,voc,181512846,181513296,450,spec2/voc/Bl122_181512846.jpg,Bl122,3
11172.66118,11172.68818,1,voc,335179835,335180645,810,spec2/voc/Bl122_335179835.jpg,Bl122,3
9169.392604,9169.423604,1,voc,275081778,275082708,930,spec2/voc/Bl122_275081778.jpg,Bl122,3
8017.570748,8017.746748,1,voc,240527122,240532402,5280,spec2/voc/Bl122_240527122.jpg,Bl122,3
8017.128748,8017.134748,1,voc,240513862,240514042,180,spec2/voc/Bl122_240513862.jpg,Bl122,3
14794.999551,14795.008551,1,voc,443849986,443850256,270,spec2/voc/Bl122_443849986.jpg,Bl122,3
13188.181662,13188.199662,1,voc,395645449,395645989,540,spec2/voc/Bl122_395645449.jpg,Bl122,3
10944.962807,10944.971807,1,voc,328348884,328349154,270,spec2/voc/Bl122_328348884.jpg,Bl122,3
3827.610649,3827.613649,1,voc,114828319,114828409,90,spec2/voc/Bl122_114828319.jpg,Bl122,3
9050.347241,9050.561241,1,voc,271510417,271516837,6420,spec2/voc/Bl122_271510417.jpg,Bl122,3
5989.021256,5989.023256,1,voc,179670637,179670697,60,spec2/voc/Bl122_179670637.jpg,Bl122,3
13988.938864,13989.109864,1,voc,419668165,419673295,5130,spec2/voc/Bl122_419668165.jpg,Bl122,3
13219.035389,13219.095389,1,voc,396571061,396572861,1800,spec2/voc/Bl122_396571061.jpg,Bl122,3
6114.875706,6114.884706,1,voc,183446271,183446541,270,spec2/voc/Bl122_183446271.jpg,Bl122,3
7802.401748,7802.404748,1,voc,234072052,234072142,90,spec2/voc/Bl122_234072052.jpg,Bl122,3
14793.611551,14793.640551,1,voc,443808346,443809216,870,spec2/voc/Bl122_443808346.jpg,Bl122,3
11142.044955,11142.048955,1,voc,334261348,334261468,120,spec2/voc/Bl122_334261348.jpg,Bl122,3
6091.77615,6091.79715,1,voc,182753284,182753914,630,spec2/voc/Bl122_182753284.jpg,Bl122,3
14130.265124,14130.473124,1,voc,423907953,423914193,6240,spec2/voc/Bl122_423907953.jpg,Bl122,3
12650.222219,12650.389219,1,voc,379506666,379511676,5010,spec2/voc/Bl122_379506666.jpg,Bl122,3
8923.900773,8923.904773,1,voc,267717023,267717143,120,spec2/voc/Bl122_267717023.jpg,Bl122,3
13156.288066,13156.305066,1,voc,394688641,394689151,510,spec2/voc/Bl122_394688641.jpg,Bl122,3
8950.039967,8950.052967,1,voc,268501199,268501589,390,spec2/voc/Bl122_268501199.jpg,Bl122,3
13208.730389,13208.735389,1,voc,396261911,396262061,150,spec2/voc/Bl122_396261911.jpg,Bl122,3
13188.141662,13188.153662,1,voc,395644249,395644609,360,spec2/voc/Bl122_395644249.jpg,Bl122,3
12828.358025,12828.430025,1,voc,384850740,384852900,2160,spec2/voc/Bl122_384850740.jpg,Bl122,3
6068.535705,6068.538705,1,voc,182056071,182056161,90,spec2/voc/Bl122_182056071.jpg,Bl122,3
3856.077415,3856.107415,1,voc,115682322,115683222,900,spec2/voc/Bl122_115682322.jpg,Bl122,3
3869.838367,3869.917367,1,voc,116095151,116097521,2370,spec2/voc/Bl122_116095151.jpg,Bl122,3
6038.169533,6038.186533,1,voc,181145085,181145595,510,spec2/voc/Bl122_181145085.jpg,Bl122,3
7897.155748,7897.164748,1,voc,236914672,236914942,270,spec2/voc/Bl122_236914672.jpg,Bl122,3
14841.578682,14841.595682,1,voc,445247360,445247870,510,spec2/voc/Bl122_445247360.jpg,Bl122,3
7924.089748,7924.094748,1,voc,237722692,237722842,150,spec2/voc/Bl122_237722692.jpg,Bl122,3
6131.578293,6131.585293,1,voc,183947348,183947558,210,spec2/voc/Bl122_183947348.jpg,Bl122,3
3822.116649,3822.166649,1,voc,114663499,114664999,1500,spec2/voc/Bl122_114663499.jpg,Bl122,3
14362.105031,14362.250031,1,voc,430863150,430867500,4350,spec2/voc/Bl122_430863150.jpg,Bl122,3
5992.477256,5992.499256,1,voc,179774317,179774977,660,spec2/voc/Bl122_179774317.jpg,Bl122,3
6046.7902,6046.9142,1,voc,181403706,181407426,3720,spec2/voc/Bl122_181403706.jpg,Bl122,3
6028.614533,6028.661533,1,voc,180858435,180859845,1410,spec2/voc/Bl122_180858435.jpg,Bl122,3
6096.15415,6096.28115,1,voc,182884624,182888434,3810,spec2/voc/Bl122_182884624.jpg,Bl122,3
9164.930604,9164.934604,1,voc,274947918,274948038,120,spec2/voc/Bl122_274947918.jpg,Bl122,3
8035.249748,8035.278748,1,voc,241057492,241058362,870,spec2/voc/Bl122_241057492.jpg,Bl122,3
6052.2122,6052.2972,1,voc,181566366,181568916,2550,spec2/voc/Bl122_181566366.jpg,Bl122,3
6031.597533,6031.604533,1,voc,180947925,180948135,210,spec2/voc/Bl122_180947925.jpg,Bl122,3
13926.720536,13926.837536,1,voc,417801616,417805126,3510,spec2/voc/Bl122_417801616.jpg,Bl122,3
9016.169241,9016.186241,1,voc,270485077,270485587,510,spec2/voc/Bl122_270485077.jpg,Bl122,3
8957.544967,8957.548967,1,voc,268726349,268726469,120,spec2/voc/Bl122_268726349.jpg,Bl122,3
5990.557256,5990.563256,1,voc,179716717,179716897,180,spec2/voc/Bl122_179716717.jpg,Bl122,3
13193.214662,13193.220662,1,voc,395796439,395796619,180,spec2/voc/Bl122_395796439.jpg,Bl122,3
8920.635773,8920.649773,1,voc,267619073,267619493,420,spec2/voc/Bl122_267619073.jpg,Bl122,3
6016.688533,6016.692533,1,voc,180500655,180500775,120,spec2/voc/Bl122_180500655.jpg,Bl122,3
5948.552256,5948.569256,1,voc,178456567,178457077,510,spec2/voc/Bl122_178456567.jpg,Bl122,3
6047.9442,6047.9762,1,voc,181438326,181439286,960,spec2/voc/Bl122_181438326.jpg,Bl122,3
13815.131617,13815.200617,1,voc,414453948,414456018,2070,spec2/voc/Bl122_414453948.jpg,Bl122,3
14798.483551,14798.670551,1,voc,443954506,443960116,5610,spec2/voc/Bl122_443954506.jpg,Bl122,3
7813.564748,7813.590748,1,voc,234406942,234407722,780,spec2/voc/Bl122_234406942.jpg,Bl122,3
9096.155241,9096.158241,1,voc,272884657,272884747,90,spec2/voc/Bl122_272884657.jpg,Bl122,3
3894.480652,3894.513652,1,voc,116834419,116835409,990,spec2/voc/Bl122_116834419.jpg,Bl122,3
6025.262533,6025.268533,1,voc,180757875,180758055,180,spec2/voc/Bl122_180757875.jpg,Bl122,3
6114.287706,6114.316706,1,voc,183428631,183429501,870,spec2/voc/Bl122_183428631.jpg,Bl122,3
11164.87118,11164.87818,1,voc,334946135,334946345,210,spec2/voc/Bl122_334946135.jpg,Bl122,3
14808.709551,14808.718551,1,voc,444261286,444261556,270,spec2/voc/Bl122_444261286.jpg,Bl122,3
10953.531807,10953.550807,1,voc,328605954,328606524,570,spec2/voc/Bl122_328605954.jpg,Bl122,3
3814.609649,3814.648649,1,voc,114438289,114439459,1170,spec2/voc/Bl122_114438289.jpg,Bl122,3
14801.694551,14801.724551,1,voc,444050836,444051736,900,spec2/voc/Bl122_444050836.jpg,Bl122,3
9166.666604,9167.029604,1,voc,274999998,275010888,10890,spec2/voc/Bl122_274999998.jpg,Bl122,3
9057.239241,9057.242241,1,voc,271717177,271717267,90,spec2/voc/Bl122_271717177.jpg,Bl122,3
8918.719773,8919.013773,1,voc,267561593,267570413,8820,spec2/voc/Bl122_267561593.jpg,Bl122,3
6021.873533,6021.880533,1,voc,180656205,180656415,210,spec2/voc/Bl122_180656205.jpg,Bl122,3
7891.268748,7891.282748,1,voc,236738062,236738482,420,spec2/voc/Bl122_236738062.jpg,Bl122,3
7927.965748,7927.976748,1,voc,237838972,237839302,330,spec2/voc/Bl122_237838972.jpg,Bl122,3
12615.061964,12615.277964,1,voc,378451858,378458338,6480,spec2/voc/Bl122_378451858.jpg,Bl122,3
6056.429705,6056.434705,1,voc,181692891,181693041,150,spec2/voc/Bl122_181692891.jpg,Bl122,3
9080.924241,9080.926241,1,voc,272427727,272427787,60,spec2/voc/Bl122_272427727.jpg,Bl122,3
6000.606256,6000.666256,1,voc,180018187,180019987,1800,spec2/voc/Bl122_180018187.jpg,Bl122,3
7843.477748,7843.486748,1,voc,235304332,235304602,270,spec2/voc/Bl122_235304332.jpg,Bl122,3
8013.800748,8013.810748,1,voc,240414022,240414322,300,spec2/voc/Bl122_240414022.jpg,Bl122,3
10854.916233,10854.922233,1,voc,325647486,325647666,180,spec2/voc/Bl122_325647486.jpg,Bl122,3
9052.232241,9052.254241,1,voc,271566967,271567627,660,spec2/voc/Bl122_271566967.jpg,Bl122,3
13245.127606,13245.150606,1,voc,397353828,397354518,690,spec2/voc/Bl122_397353828.jpg,Bl122,3
5945.172256,5945.180256,1,voc,178355167,178355407,240,spec2/voc/Bl122_178355167.jpg,Bl122,3
14781.549844,14781.558844,1,voc,443446495,443446765,270,spec2/voc/Bl122_443446495.jpg,Bl122,3
7872.392748,7872.409748,1,voc,236171782,236172292,510,spec2/voc/Bl122_236171782.jpg,Bl122,3
7915.695748,7915.712748,1,voc,237470872,237471382,510,spec2/voc/Bl122_237470872.jpg,Bl122,3
10931.869807,10932.067807,1,voc,327956094,327962034,5940,spec2/voc/Bl122_327956094.jpg,Bl122,3
8993.937241,8994.164241,1,voc,269818117,269824927,6810,spec2/voc/Bl122_269818117.jpg,Bl122,3
7908.753748,7908.758748,1,voc,237262612,237262762,150,spec2/voc/Bl122_237262612.jpg,Bl122,3
6084.73915,6084.75115,1,voc,182542174,182542534,360,spec2/voc/Bl122_182542174.jpg,Bl122,3
5948.615256,5948.622256,1,voc,178458457,178458667,210,spec2/voc/Bl122_178458457.jpg,Bl122,3
10939.963807,10939.968807,1,voc,328198914,328199064,150,spec2/voc/Bl122_328198914.jpg,Bl122,3
14842.045682,14842.064682,1,voc,445261370,445261940,570,spec2/voc/Bl122_445261370.jpg,Bl122,3
7886.921748,7886.931748,1,voc,236607652,236607952,300,spec2/voc/Bl122_236607652.jpg,Bl122,3
13601.910736,13602.480736,1,voc,408057322,408074422,17100,spec2/voc/Bl122_408057322.jpg,Bl122,3
13601.708736,13601.760736,1,voc,408051262,408052822,1560,spec2/voc/Bl122_408051262.jpg,Bl122,3
11134.582005,11134.610005,1,voc,334037460,334038300,840,spec2/voc/Bl122_334037460.jpg,Bl122,3
8001.202748,8001.215748,1,voc,240036082,240036472,390,spec2/voc/Bl122_240036082.jpg,Bl122,3
7911.895748,7911.898748,1,voc,237356872,237356962,90,spec2/voc/Bl122_237356872.jpg,Bl122,3
13583.733236,13583.737236,1,voc,407511997,407512117,120,spec2/voc/Bl122_407511997.jpg,Bl122,3
6030.580533,6030.604533,1,voc,180917415,180918135,720,spec2/voc/Bl122_180917415.jpg,Bl122,3
14794.219551,14794.221551,1,voc,443826586,443826646,60,spec2/voc/Bl122_443826586.jpg,Bl122,3
9071.845241,9071.851241,1,voc,272155357,272155537,180,spec2/voc/Bl122_272155357.jpg,Bl122,3
3852.912415,3852.928415,1,voc,115587372,115587852,480,spec2/voc/Bl122_115587372.jpg,Bl122,3
11127.853005,11127.983005,1,voc,333835590,333839490,3900,spec2/voc/Bl122_333835590.jpg,Bl122,3
6056.816705,6056.829705,1,voc,181704501,181704891,390,spec2/voc/Bl122_181704501.jpg,Bl122,3
5939.845256,5939.893256,1,voc,178195357,178196797,1440,spec2/voc/Bl122_178195357.jpg,Bl122,3
7993.860748,7993.870748,1,voc,239815822,239816122,300,spec2/voc/Bl122_239815822.jpg,Bl122,3
8004.136748,8004.195748,1,voc,240124102,240125872,1770,spec2/voc/Bl122_240124102.jpg,Bl122,3
6222.331295,6222.338295,1,voc,186669938,186670148,210,spec2/voc/Bl122_186669938.jpg,Bl122,3
13960.955384,13960.965384,1,voc,418828661,418828961,300,spec2/voc/Bl122_418828661.jpg,Bl122,3
13759.652267,13759.898267,1,voc,412789568,412796948,7380,spec2/voc/Bl122_412789568.jpg,Bl122,3
11888.913845,11888.915845,1,voc,356667415,356667475,60,spec2/voc/Bl122_356667415.jpg,Bl122,3
6198.192327,6198.611327,1,voc,185945769,185958339,12570,spec2/voc/Bl122_185945769.jpg,Bl122,3
9191.74698,9191.82498,1,voc,275752409,275754749,2340,spec2/voc/Bl122_275752409.jpg,Bl122,3
3810.073649,3810.107649,1,voc,114302209,114303229,1020,spec2/voc/Bl122_114302209.jpg,Bl122,3
13209.835389,13210.076389,1,voc,396295061,396302291,7230,spec2/voc/Bl122_396295061.jpg,Bl122,3
3889.626652,3889.636652,1,voc,116688799,116689099,300,spec2/voc/Bl122_116688799.jpg,Bl122,3
6107.799706,6107.804706,1,voc,183233991,183234141,150,spec2/voc/Bl122_183233991.jpg,Bl122,3
5963.538256,5963.832256,1,voc,178906147,178914967,8820,spec2/voc/Bl122_178906147.jpg,Bl122,3
10952.408807,10952.413807,1,voc,328572264,328572414,150,spec2/voc/Bl122_328572264.jpg,Bl122,3
11179.30518,11179.43618,1,voc,335379155,335383085,3930,spec2/voc/Bl122_335379155.jpg,Bl122,3
7840.461748,7840.576748,1,voc,235213852,235217302,3450,spec2/voc/Bl122_235213852.jpg,Bl122,3
6099.19115,6099.21915,1,voc,182975734,182976574,840,spec2/voc/Bl122_182975734.jpg,Bl122,3
10906.752825,10906.764825,1,voc,327202584,327202944,360,spec2/voc/Bl122_327202584.jpg,Bl122,3
5970.853256,5970.865256,1,voc,179125597,179125957,360,spec2/voc/Bl122_179125597.jpg,Bl122,3
13951.554911,13951.574911,1,voc,418546647,418547247,600,spec2/voc/Bl122_418546647.jpg,Bl122,3
5976.444256,5976.512256,1,voc,179293327,179295367,2040,spec2/voc/Bl122_179293327.jpg,Bl122,3
9048.674241,9048.677241,1,voc,271460227,271460317,90,spec2/voc/Bl122_271460227.jpg,Bl122,3
6028.216533,6028.218533,1,voc,180846495,180846555,60,spec2/voc/Bl122_180846495.jpg,Bl122,3
7972.183748,7972.199748,1,voc,239165512,239165992,480,spec2/voc/Bl122_239165512.jpg,Bl122,3
7859.957748,7860.028748,1,voc,235798732,235800862,2130,spec2/voc/Bl122_235798732.jpg,Bl122,3
10961.400807,10961.547807,1,voc,328842024,328846434,4410,spec2/voc/Bl122_328842024.jpg,Bl122,3
13219.772389,13219.787389,1,voc,396593171,396593621,450,spec2/voc/Bl122_396593171.jpg,Bl122,3
3876.835848,3876.899848,1,voc,116305075,116306995,1920,spec2/voc/Bl122_116305075.jpg,Bl122,3
13187.827662,13187.841662,1,voc,395634829,395635249,420,spec2/voc/Bl122_395634829.jpg,Bl122,3
14794.306551,14794.315551,1,voc,443829196,443829466,270,spec2/voc/Bl122_443829196.jpg,Bl122,3
7972.238748,7972.246748,1,voc,239167162,239167402,240,spec2/voc/Bl122_239167162.jpg,Bl122,3
6223.318295,6223.422295,1,voc,186699548,186702668,3120,spec2/voc/Bl122_186699548.jpg,Bl122,3
13245.097606,13245.118606,1,voc,397352928,397353558,630,spec2/voc/Bl122_397352928.jpg,Bl122,3
6096.79415,6096.79815,1,voc,182903824,182903944,120,spec2/voc/Bl122_182903824.jpg,Bl122,3
11896.483631,11896.665631,1,voc,356894508,356899968,5460,spec2/voc/Bl122_356894508.jpg,Bl122,3
13967.551352,13967.618352,1,voc,419026540,419028550,2010,spec2/voc/Bl122_419026540.jpg,Bl122,3
14840.848682,14841.073682,1,voc,445225460,445232210,6750,spec2/voc/Bl122_445225460.jpg,Bl122,3
6059.842705,6059.855705,1,voc,181795281,181795671,390,spec2/voc/Bl122_181795281.jpg,Bl122,3
9098.324241,9098.355241,1,voc,272949727,272950657,930,spec2/voc/Bl122_272949727.jpg,Bl122,3
8018.170748,8018.175748,1,voc,240545122,240545272,150,spec2/voc/Bl122_240545122.jpg,Bl122,3
6114.131706,6114.281706,1,voc,183423951,183428451,4500,spec2/voc/Bl122_183423951.jpg,Bl122,3
6174.183327,6174.375327,1,voc,185225499,185231259,5760,spec2/voc/Bl122_185225499.jpg,Bl122,3
14156.241825,14156.409825,1,voc,424687254,424692294,5040,spec2/voc/Bl122_424687254.jpg,Bl122,3
13823.82022,13823.94822,1,voc,414714606,414718446,3840,spec2/voc/Bl122_414714606.jpg,Bl122,3
6122.965706,6122.969706,1,voc,183688971,183689091,120,spec2/voc/Bl122_183688971.jpg,Bl122,3
9030.364241,9030.366241,1,voc,270910927,270910987,60,spec2/voc/Bl122_270910927.jpg,Bl122,3
13732.795497,13732.806497,1,voc,411983864,411984194,330,spec2/voc/Bl122_411983864.jpg,Bl122,3
5975.282256,5975.286256,1,voc,179258467,179258587,120,spec2/voc/Bl122_179258467.jpg,Bl122,3
9013.360241,9013.382241,1,voc,270400807,270401467,660,spec2/voc/Bl122_270400807.jpg,Bl122,3
9089.311241,9089.326241,1,voc,272679337,272679787,450,spec2/voc/Bl122_272679337.jpg,Bl122,3
3823.878649,3823.922649,1,voc,114716359,114717679,1320,spec2/voc/Bl122_114716359.jpg,Bl122,3
8213.233724,8213.274724,1,voc,246397011,246398241,1230,spec2/voc/Bl122_246397011.jpg,Bl122,3
14334.801707,14334.873707,1,voc,430044051,430046211,2160,spec2/voc/Bl122_430044051.jpg,Bl122,3
3829.862649,3829.870649,1,voc,114895879,114896119,240,spec2/voc/Bl122_114895879.jpg,Bl122,3
6104.964706,6105.110706,1,voc,183148941,183153321,4380,spec2/voc/Bl122_183148941.jpg,Bl122,3
11143.211955,11143.226955,1,voc,334296358,334296808,450,spec2/voc/Bl122_334296358.jpg,Bl122,3
8027.583748,8027.586748,1,voc,240827512,240827602,90,spec2/voc/Bl122_240827512.jpg,Bl122,3
7991.696748,7991.700748,1,voc,239750902,239751022,120,spec2/voc/Bl122_239750902.jpg,Bl122,3
10926.757807,10926.876807,1,voc,327802734,327806304,3570,spec2/voc/Bl122_327802734.jpg,Bl122,3
9001.088241,9001.262241,1,voc,270032647,270037867,5220,spec2/voc/Bl122_270032647.jpg,Bl122,3
6058.834705,6058.839705,1,voc,181765041,181765191,150,spec2/voc/Bl122_181765041.jpg,Bl122,3
13827.65222,13827.87722,1,voc,414829566,414836316,6750,spec2/voc/Bl122_414829566.jpg,Bl122,3
14202.254387,14202.382387,1,voc,426067631,426071471,3840,spec2/voc/Bl122_426067631.jpg,Bl122,3
7843.614748,7843.634748,1,voc,235308442,235309042,600,spec2/voc/Bl122_235308442.jpg,Bl122,3
6098.39315,6098.39915,1,voc,182951794,182951974,180,spec2/voc/Bl122_182951794.jpg,Bl122,3
5972.041256,5972.082256,1,voc,179161237,179162467,1230,spec2/voc/Bl122_179161237.jpg,Bl122,3
14837.721682,14837.781682,1,voc,445131650,445133450,1800,spec2/voc/Bl122_445131650.jpg,Bl122,3
6183.396327,6183.407327,1,voc,185501889,185502219,330,spec2/voc/Bl122_185501889.jpg,Bl122,3
6063.528705,6063.531705,1,voc,181905861,181905951,90,spec2/voc/Bl122_181905861.jpg,Bl122,3
7912.348748,7912.386748,1,voc,237370462,237371602,1140,spec2/voc/Bl122_237370462.jpg,Bl122,3
11200.987894,11201.048894,1,voc,336029636,336031466,1830,spec2/voc/Bl122_336029636.jpg,Bl122,3
6077.394705,6077.407705,1,voc,182321841,182322231,390,spec2/voc/Bl122_182321841.jpg,Bl122,3
14817.287551,14817.418551,1,voc,444518626,444522556,3930,spec2/voc/Bl122_444518626.jpg,Bl122,3
7794.096748,7794.103748,1,voc,233822902,233823112,210,spec2/voc/Bl122_233822902.jpg,Bl122,3
7842.142748,7842.165748,1,voc,235264282,235264972,690,spec2/voc/Bl122_235264282.jpg,Bl122,3
9095.596241,9095.615241,1,voc,272867887,272868457,570,spec2/voc/Bl122_272867887.jpg,Bl122,3
6047.9872,6048.0302,1,voc,181439616,181440906,1290,spec2/voc/Bl122_181439616.jpg,Bl122,3
8916.058773,8916.065773,1,voc,267481763,267481973,210,spec2/voc/Bl122_267481763.jpg,Bl122,3
13966.623352,13966.679352,1,voc,418998700,419000380,1680,spec2/voc/Bl122_418998700.jpg,Bl122,3
13984.628943,13984.680943,1,voc,419538868,419540428,1560,spec2/voc/Bl122_419538868.jpg,Bl122,3
6038.697533,6038.723533,1,voc,181160925,181161705,780,spec2/voc/Bl122_181160925.jpg,Bl122,3
6019.187533,6019.193533,1,voc,180575625,180575805,180,spec2/voc/Bl122_180575625.jpg,Bl122,3
5973.385256,5973.414256,1,voc,179201557,179202427,870,spec2/voc/Bl122_179201557.jpg,Bl122,3
6228.085295,6228.106295,1,voc,186842558,186843188,630,spec2/voc/Bl122_186842558.jpg,Bl122,3
6225.863295,6225.866295,1,voc,186775898,186775988,90,spec2/voc/Bl122_186775898.jpg,Bl122,3
7844.577748,7844.581748,1,voc,235337332,235337452,120,spec2/voc/Bl122_235337332.jpg,Bl122,3
14819.191551,14819.195551,1,voc,444575746,444575866,120,spec2/voc/Bl122_444575746.jpg,Bl122,3
3864.521367,3864.643367,1,voc,115935641,115939301,3660,spec2/voc/Bl122_115935641.jpg,Bl122,3
5944.024256,5944.061256,1,voc,178320727,178321837,1110,spec2/voc/Bl122_178320727.jpg,Bl122,3
13826.84022,13826.87722,1,voc,414805206,414806316,1110,spec2/voc/Bl122_414805206.jpg,Bl122,3
7881.278748,7881.288748,1,voc,236438362,236438662,300,spec2/voc/Bl122_236438362.jpg,Bl122,3
13826.55522,13826.56722,1,voc,414796656,414797016,360,spec2/voc/Bl122_414796656.jpg,Bl122,3
6097.75915,6097.76615,1,voc,182932774,182932984,210,spec2/voc/Bl122_182932774.jpg,Bl122,3
7936.730748,7936.737748,1,voc,238101922,238102132,210,spec2/voc/Bl122_238101922.jpg,Bl122,3
8027.894748,8027.906748,1,voc,240836842,240837202,360,spec2/voc/Bl122_240836842.jpg,Bl122,3
13173.255701,13173.260701,1,voc,395197671,395197821,150,spec2/voc/Bl122_395197671.jpg,Bl122,3
5959.188256,5959.251256,1,voc,178775647,178777537,1890,spec2/voc/Bl122_178775647.jpg,Bl122,3
13929.586797,13929.604797,1,voc,417887603,417888143,540,spec2/voc/Bl122_417887603.jpg,Bl122,3
11177.92118,11178.01118,1,voc,335337635,335340335,2700,spec2/voc/Bl122_335337635.jpg,Bl122,3
13174.948701,13174.963701,1,voc,395248461,395248911,450,spec2/voc/Bl122_395248461.jpg,Bl122,3
13203.255389,13203.441389,1,voc,396097661,396103241,5580,spec2/voc/Bl122_396097661.jpg,Bl122,3
13168.375658,13168.442658,1,voc,395051269,395053279,2010,spec2/voc/Bl122_395051269.jpg,Bl122,3
13973.742117,13973.772117,1,voc,419212263,419213163,900,spec2/voc/Bl122_419212263.jpg,Bl122,3
7884.889748,7884.897748,1,voc,236546692,236546932,240,spec2/voc/Bl122_236546692.jpg,Bl122,3
3822.040649,3822.070649,1,voc,114661219,114662119,900,spec2/voc/Bl122_114661219.jpg,Bl122,3
9005.658241,9005.662241,1,voc,270169747,270169867,120,spec2/voc/Bl122_270169747.jpg,Bl122,3
8016.508748,8016.512748,1,voc,240495262,240495382,120,spec2/voc/Bl122_240495262.jpg,Bl122,3
8915.971773,8915.975773,1,voc,267479153,267479273,120,spec2/voc/Bl122_267479153.jpg,Bl122,3
6201.289327,6201.461327,1,voc,186038679,186043839,5160,spec2/voc/Bl122_186038679.jpg,Bl122,3
11194.80718,11194.81318,1,voc,335844215,335844395,180,spec2/voc/Bl122_335844215.jpg,Bl122,3
3852.725415,3852.778415,1,voc,115581762,115583352,1590,spec2/voc/Bl122_115581762.jpg,Bl122,3
6159.402349,6159.530349,1,voc,184782070,184785910,3840,spec2/voc/Bl122_184782070.jpg,Bl122,3
11139.795955,11140.023955,1,voc,334193878,334200718,6840,spec2/voc/Bl122_334193878.jpg,Bl122,3
8923.419773,8923.471773,1,voc,267702593,267704153,1560,spec2/voc/Bl122_267702593.jpg,Bl122,3
3271.069796,3271.298796,1,voc,98132093,98138963,6870,spec2/voc/Bl122_98132093.jpg,Bl122,3
6182.798327,6182.842327,1,voc,185483949,185485269,1320,spec2/voc/Bl122_185483949.jpg,Bl122,3
13163.264891,13163.325891,1,voc,394897946,394899776,1830,spec2/voc/Bl122_394897946.jpg,Bl122,3
6050.2722,6050.2782,1,voc,181508166,181508346,180,spec2/voc/Bl122_181508166.jpg,Bl122,3
7807.014748,7807.017748,1,voc,234210442,234210532,90,spec2/voc/Bl122_234210442.jpg,Bl122,3
13220.382389,13220.487389,1,voc,396611471,396614621,3150,spec2/voc/Bl122_396611471.jpg,Bl122,3
7902.202748,7902.221748,1,voc,237066082,237066652,570,spec2/voc/Bl122_237066082.jpg,Bl122,3
7907.841748,7907.860748,1,voc,237235252,237235822,570,spec2/voc/Bl122_237235252.jpg,Bl122,3
10943.509807,10943.514807,1,voc,328305294,328305444,150,spec2/voc/Bl122_328305294.jpg,Bl122,3
3862.620367,3862.804367,1,voc,115878611,115884131,5520,spec2/voc/Bl122_115878611.jpg,Bl122,3
9167.092604,9167.095604,1,voc,275012778,275012868,90,spec2/voc/Bl122_275012778.jpg,Bl122,3
6090.45915,6090.46115,1,voc,182713774,182713834,60,spec2/voc/Bl122_182713774.jpg,Bl122,3
11169.86218,11169.92418,1,voc,335095865,335097725,1860,spec2/voc/Bl122_335095865.jpg,Bl122,3
6060.205705,6060.207705,1,voc,181806171,181806231,60,spec2/voc/Bl122_181806171.jpg,Bl122,3
6203.960327,6203.986327,1,voc,186118809,186119589,780,spec2/voc/Bl122_186118809.jpg,Bl122,3
6049.5242,6049.5312,1,voc,181485726,181485936,210,spec2/voc/Bl122_181485726.jpg,Bl122,3
5972.907256,5972.924256,1,voc,179187217,179187727,510,spec2/voc/Bl122_179187217.jpg,Bl122,3
6100.24915,6100.25415,1,voc,183007474,183007624,150,spec2/voc/Bl122_183007474.jpg,Bl122,3
11870.799861,11870.804861,1,voc,356123995,356124145,150,spec2/voc/Bl122_356123995.jpg,Bl122,3
8004.578748,8004.599748,1,voc,240137362,240137992,630,spec2/voc/Bl122_240137362.jpg,Bl122,3
9041.126241,9041.266241,1,voc,271233787,271237987,4200,spec2/voc/Bl122_271233787.jpg,Bl122,3
7882.264748,7882.284748,1,voc,236467942,236468542,600,spec2/voc/Bl122_236467942.jpg,Bl122,3
6112.688706,6112.693706,1,voc,183380661,183380811,150,spec2/voc/Bl122_183380661.jpg,Bl122,3
13967.966352,13967.971352,1,voc,419038990,419039140,150,spec2/voc/Bl122_419038990.jpg,Bl122,3
12639.624849,12639.634849,1,voc,379188745,379189045,300,spec2/voc/Bl122_379188745.jpg,Bl122,3
7844.797748,7844.802748,1,voc,235343932,235344082,150,spec2/voc/Bl122_235343932.jpg,Bl122,3
9057.029241,9057.079241,1,voc,271710877,271712377,1500,spec2/voc/Bl122_271710877.jpg,Bl122,3
6093.08715,6093.17415,1,voc,182792614,182795224,2610,spec2/voc/Bl122_182792614.jpg,Bl122,3
13155.039774,13155.182774,1,voc,394651193,394655483,4290,spec2/voc/Bl122_394651193.jpg,Bl122,3
9002.585241,9002.755241,1,voc,270077557,270082657,5100,spec2/voc/Bl122_270077557.jpg,Bl122,3
7860.491748,7860.542748,1,voc,235814752,235816282,1530,spec2/voc/Bl122_235814752.jpg,Bl122,3
11881.747992,11881.749992,1,voc,356452439,356452499,60,spec2/voc/Bl122_356452439.jpg,Bl122,3
3808.548649,3808.559649,1,voc,114256459,114256789,330,spec2/voc/Bl122_114256459.jpg,Bl122,3
13606.121736,13606.132736,1,voc,408183652,408183982,330,spec2/voc/Bl122_408183652.jpg,Bl122,3
14841.746682,14841.756682,1,voc,445252400,445252700,300,spec2/voc/Bl122_445252400.jpg,Bl122,3
9014.689241,9014.699241,1,voc,270440677,270440977,300,spec2/voc/Bl122_270440677.jpg,Bl122,3
9068.796241,9068.819241,1,voc,272063887,272064577,690,spec2/voc/Bl122_272063887.jpg,Bl122,3
13569.278052,13569.543052,1,voc,407078341,407086291,7950,spec2/voc/Bl122_407078341.jpg,Bl122,3
13999.010512,13999.015512,1,voc,419970315,419970465,150,spec2/voc/Bl122_419970315.jpg,Bl122,3
14790.282551,14790.287551,1,voc,443708476,443708626,150,spec2/voc/Bl122_443708476.jpg,Bl122,3
9018.800241,9018.804241,1,voc,270564007,270564127,120,spec2/voc/Bl122_270564007.jpg,Bl122,3
7885.881748,7885.895748,1,voc,236576452,236576872,420,spec2/voc/Bl122_236576452.jpg,Bl122,3
9069.847241,9069.857241,1,voc,272095417,272095717,300,spec2/voc/Bl122_272095417.jpg,Bl122,3
6189.289327,6189.465327,1,voc,185678679,185683959,5280,spec2/voc/Bl122_185678679.jpg,Bl122,3
10952.422807,10952.447807,1,voc,328572684,328573434,750,spec2/voc/Bl122_328572684.jpg,Bl122,3
7923.967748,7923.976748,1,voc,237719032,237719302,270,spec2/voc/Bl122_237719032.jpg,Bl122,3
7828.430748,7828.435748,1,voc,234852922,234853072,150,spec2/voc/Bl122_234852922.jpg,Bl122,3
14842.089682,14842.125682,1,voc,445262690,445263770,1080,spec2/voc/Bl122_445262690.jpg,Bl122,3
7841.286748,7841.290748,1,voc,235238602,235238722,120,spec2/voc/Bl122_235238602.jpg,Bl122,3
3801.389649,3801.393649,1,voc,114041689,114041809,120,spec2/voc/Bl122_114041689.jpg,Bl122,3
6178.836327,6178.860327,1,voc,185365089,185365809,720,spec2/voc/Bl122_185365089.jpg,Bl122,3
6093.22815,6093.28615,1,voc,182796844,182798584,1740,spec2/voc/Bl122_182796844.jpg,Bl122,3
6138.557293,6138.563293,1,voc,184156718,184156898,180,spec2/voc/Bl122_184156718.jpg,Bl122,3
3806.472649,3806.503649,1,voc,114194179,114195109,930,spec2/voc/Bl122_114194179.jpg,Bl122,3
10938.771807,10938.784807,1,voc,328163154,328163544,390,spec2/voc/Bl122_328163154.jpg,Bl122,3
6132.625293,6132.651293,1,voc,183978758,183979538,780,spec2/voc/Bl122_183978758.jpg,Bl122,3
11159.85218,11159.85718,1,voc,334795565,334795715,150,spec2/voc/Bl122_334795565.jpg,Bl122,3
10957.386807,10957.389807,1,voc,328721604,328721694,90,spec2/voc/Bl122_328721604.jpg,Bl122,3
14822.867551,14822.946551,1,voc,444686026,444688396,2370,spec2/voc/Bl122_444686026.jpg,Bl122,3
8023.385748,8023.403748,1,voc,240701572,240702112,540,spec2/voc/Bl122_240701572.jpg,Bl122,3
5986.606256,5986.671256,1,voc,179598187,179600137,1950,spec2/voc/Bl122_179598187.jpg,Bl122,3
6056.290705,6056.298705,1,voc,181688721,181688961,240,spec2/voc/Bl122_181688721.jpg,Bl122,3
8950.859967,8951.076967,1,voc,268525799,268532309,6510,spec2/voc/Bl122_268525799.jpg,Bl122,3
7915.695931,7915.712931,1,voc,237470877,237471387,510,spec2/voc/Bl122_237470877.jpg,Bl122,3
14810.474551,14810.483551,1,voc,444314236,444314506,270,spec2/voc/Bl122_444314236.jpg,Bl122,3
7841.965748,7841.973748,1,voc,235258972,235259212,240,spec2/voc/Bl122_235258972.jpg,Bl122,3
5994.483256,5994.524256,1,voc,179834497,179835727,1230,spec2/voc/Bl122_179834497.jpg,Bl122,3
11168.27818,11168.41318,1,voc,335048345,335052395,4050,spec2/voc/Bl122_335048345.jpg,Bl122,3
11971.782625,11971.941625,1,voc,359153478,359158248,4770,spec2/voc/Bl122_359153478.jpg,Bl122,3
7968.344748,7968.347748,1,voc,239050342,239050432,90,spec2/voc/Bl122_239050342.jpg,Bl122,3
7911.751748,7911.779748,1,voc,237352552,237353392,840,spec2/voc/Bl122_237352552.jpg,Bl122,3
3809.001649,3809.017649,1,voc,114270049,114270529,480,spec2/voc/Bl122_114270049.jpg,Bl122,3
11188.43718,11188.44018,1,voc,335653115,335653205,90,spec2/voc/Bl122_335653115.jpg,Bl122,3
9024.470241,9024.673241,1,voc,270734107,270740197,6090,spec2/voc/Bl122_270734107.jpg,Bl122,3
9067.911241,9067.944241,1,voc,272037337,272038327,990,spec2/voc/Bl122_272037337.jpg,Bl122,3
8004.077748,8004.110748,1,voc,240122332,240123322,990,spec2/voc/Bl122_240122332.jpg,Bl122,3
3830.623649,3830.775649,1,voc,114918709,114923269,4560,spec2/voc/Bl122_114918709.jpg,Bl122,3
14818.446551,14818.649551,1,voc,444553396,444559486,6090,spec2/voc/Bl122_444553396.jpg,Bl122,3
6075.556705,6075.562705,1,voc,182266701,182266881,180,spec2/voc/Bl122_182266701.jpg,Bl122,3
6170.386327,6170.427327,1,voc,185111589,185112819,1230,spec2/voc/Bl122_185111589.jpg,Bl122,3
12618.89699,12619.09199,1,voc,378566909,378572759,5850,spec2/voc/Bl122_378566909.jpg,Bl122,3
7885.919748,7885.924748,1,voc,236577592,236577742,150,spec2/voc/Bl122_236577592.jpg,Bl122,3
6015.834533,6015.894533,1,voc,180475035,180476835,1800,spec2/voc/Bl122_180475035.jpg,Bl122,3
14840.542682,14840.593682,1,voc,445216280,445217810,1530,spec2/voc/Bl122_445216280.jpg,Bl122,3
13947.943911,13947.958911,1,voc,418438317,418438767,450,spec2/voc/Bl122_418438317.jpg,Bl122,3
11171.97918,11172.11018,1,voc,335159375,335163305,3930,spec2/voc/Bl122_335159375.jpg,Bl122,3
6076.286705,6076.293705,1,voc,182288601,182288811,210,spec2/voc/Bl122_182288601.jpg,Bl122,3
5936.896256,5936.912256,1,voc,178106887,178107367,480,spec2/voc/Bl122_178106887.jpg,Bl122,3
14789.737551,14790.058551,1,voc,443692126,443701756,9630,spec2/voc/Bl122_443692126.jpg,Bl122,3
3807.076649,3807.168649,1,voc,114212299,114215059,2760,spec2/voc/Bl122_114212299.jpg,Bl122,3
11194.75118,11194.76618,1,voc,335842535,335842985,450,spec2/voc/Bl122_335842535.jpg,Bl122,3
11154.49218,11154.85318,1,voc,334634765,334645595,10830,spec2/voc/Bl122_334634765.jpg,Bl122,3
10908.009825,10908.028825,1,voc,327240294,327240864,570,spec2/voc/Bl122_327240294.jpg,Bl122,3
13564.423867,13564.806867,1,voc,406932716,406944206,11490,spec2/voc/Bl122_406932716.jpg,Bl122,3
9071.890241,9071.912241,1,voc,272156707,272157367,660,spec2/voc/Bl122_272156707.jpg,Bl122,3
6222.577295,6222.602295,1,voc,186677318,186678068,750,spec2/voc/Bl122_186677318.jpg,Bl122,3
8017.454748,8017.490748,1,voc,240523642,240524722,1080,spec2/voc/Bl122_240523642.jpg,Bl122,3
13998.230512,13998.392512,1,voc,419946915,419951775,4860,spec2/voc/Bl122_419946915.jpg,Bl122,3
11153.62818,11153.63118,1,voc,334608845,334608935,90,spec2/voc/Bl122_334608845.jpg,Bl122,3
7933.287748,7933.301748,1,voc,237998632,237999052,420,spec2/voc/Bl122_237998632.jpg,Bl122,3
9096.039241,9096.044241,1,voc,272881177,272881327,150,spec2/voc/Bl122_272881177.jpg,Bl122,3
5938.011256,5938.037256,1,voc,178140337,178141117,780,spec2/voc/Bl122_178140337.jpg,Bl122,3
3822.447649,3822.699649,1,voc,114673429,114680989,7560,spec2/voc/Bl122_114673429.jpg,Bl122,3
11164.90118,11165.00118,1,voc,334947035,334950035,3000,spec2/voc/Bl122_334947035.jpg,Bl122,3
12596.894038,12596.950038,1,voc,377906821,377908501,1680,spec2/voc/Bl122_377906821.jpg,Bl122,3
12601.655506,12601.717506,1,voc,378049665,378051525,1860,spec2/voc/Bl122_378049665.jpg,Bl122,3
6174.550327,6174.567327,1,voc,185236509,185237019,510,spec2/voc/Bl122_185236509.jpg,Bl122,3
9058.927241,9058.934241,1,voc,271767817,271768027,210,spec2/voc/Bl122_271767817.jpg,Bl122,3
13200.319389,13200.322389,1,voc,396009581,396009671,90,spec2/voc/Bl122_396009581.jpg,Bl122,3
10886.311162,10886.342162,1,voc,326589334,326590264,930,spec2/voc/Bl122_326589334.jpg,Bl122,3
3891.245652,3891.403652,1,voc,116737369,116742109,4740,spec2/voc/Bl122_116737369.jpg,Bl122,3
10941.878807,10941.930807,1,voc,328256364,328257924,1560,spec2/voc/Bl122_328256364.jpg,Bl122,3
7841.762748,7841.804748,1,voc,235252882,235254142,1260,spec2/voc/Bl122_235252882.jpg,Bl122,3
14842.038682,14842.041682,1,voc,445261160,445261250,90,spec2/voc/Bl122_445261160.jpg,Bl122,3
13659.770334,13659.780334,1,voc,409793110,409793410,300,spec2/voc/Bl122_409793110.jpg,Bl122,3
6194.499327,6194.502327,1,voc,185834979,185835069,90,spec2/voc/Bl122_185834979.jpg,Bl122,3
6078.497705,6078.569705,1,voc,182354931,182357091,2160,spec2/voc/Bl122_182354931.jpg,Bl122,3
11154.36518,11154.40318,1,voc,334630955,334632095,1140,spec2/voc/Bl122_334630955.jpg,Bl122,3
7810.444748,7810.483748,1,voc,234313342,234314512,1170,spec2/voc/Bl122_234313342.jpg,Bl122,3
8037.738748,8037.744748,1,voc,241132162,241132342,180,spec2/voc/Bl122_241132162.jpg,Bl122,3
6152.360349,6152.403349,1,voc,184570810,184572100,1290,spec2/voc/Bl122_184570810.jpg,Bl122,3
5947.317256,5947.321256,1,voc,178419517,178419637,120,spec2/voc/Bl122_178419517.jpg,Bl122,3
6192.617327,6192.707327,1,voc,185778519,185781219,2700,spec2/voc/Bl122_185778519.jpg,Bl122,3
10898.85456,10898.95656,1,voc,326965636,326968696,3060,spec2/voc/Bl122_326965636.jpg,Bl122,3
5940.623256,5940.792256,1,voc,178218697,178223767,5070,spec2/voc/Bl122_178218697.jpg,Bl122,3
9130.670981,9130.681981,1,voc,273920129,273920459,330,spec2/voc/Bl122_273920129.jpg,Bl122,3
9051.213241,9051.256241,1,voc,271536397,271537687,1290,spec2/voc/Bl122_271536397.jpg,Bl122,3
14821.287551,14821.313551,1,voc,444638626,444639406,780,spec2/voc/Bl122_444638626.jpg,Bl122,3
11099.961855,11099.986855,1,voc,332998855,332999605,750,spec2/voc/Bl122_332998855.jpg,Bl122,3
7843.690748,7843.751748,1,voc,235310722,235312552,1830,spec2/voc/Bl122_235310722.jpg,Bl122,3
7860.422748,7860.425748,1,voc,235812682,235812772,90,spec2/voc/Bl122_235812682.jpg,Bl122,3
7962.420748,7962.431748,1,voc,238872622,238872952,330,spec2/voc/Bl122_238872622.jpg,Bl122,3
3799.833649,3799.871649,1,voc,113995009,113996149,1140,spec2/voc/Bl122_113995009.jpg,Bl122,3
5975.456256,5975.908256,1,voc,179263687,179277247,13560,spec2/voc/Bl122_179263687.jpg,Bl122,3
9030.169241,9030.180241,1,voc,270905077,270905407,330,spec2/voc/Bl122_270905077.jpg,Bl122,3
6090.20315,6090.21315,1,voc,182706094,182706394,300,spec2/voc/Bl122_182706094.jpg,Bl122,3
10855.929233,10855.984233,1,voc,325677876,325679526,1650,spec2/voc/Bl122_325677876.jpg,Bl122,3
7789.403748,7789.408748,1,voc,233682112,233682262,150,spec2/voc/Bl122_233682112.jpg,Bl122,3
11973.465379,11973.746379,1,voc,359203961,359212391,8430,spec2/voc/Bl122_359203961.jpg,Bl122,3
6019.504533,6019.508533,1,voc,180585135,180585255,120,spec2/voc/Bl122_180585135.jpg,Bl122,3
6015.427533,6015.439533,1,voc,180462825,180463185,360,spec2/voc/Bl122_180462825.jpg,Bl122,3
12639.768849,12639.847849,1,voc,379193065,379195435,2370,spec2/voc/Bl122_379193065.jpg,Bl122,3
9031.476241,9031.490241,1,voc,270944287,270944707,420,spec2/voc/Bl122_270944287.jpg,Bl122,3
11163.71118,11163.75318,1,voc,334911335,334912595,1260,spec2/voc/Bl122_334911335.jpg,Bl122,3
13819.039617,13819.046617,1,voc,414571188,414571398,210,spec2/voc/Bl122_414571188.jpg,Bl122,3
14840.172682,14840.271682,1,voc,445205180,445208150,2970,spec2/voc/Bl122_445205180.jpg,Bl122,3
14839.633682,14839.641682,1,voc,445189010,445189250,240,spec2/voc/Bl122_445189010.jpg,Bl122,3
7920.119748,7920.139748,1,voc,237603592,237604192,600,spec2/voc/Bl122_237603592.jpg,Bl122,3
13816.336617,13816.339617,1,voc,414490098,414490188,90,spec2/voc/Bl122_414490098.jpg,Bl122,3
8999.935241,9000.038241,1,voc,269998057,270001147,3090,spec2/voc/Bl122_269998057.jpg,Bl122,3
6120.400706,6120.485706,1,voc,183612021,183614571,2550,spec2/voc/Bl122_183612021.jpg,Bl122,3
7975.757748,7975.770748,1,voc,239272732,239273122,390,spec2/voc/Bl122_239272732.jpg,Bl122,3
5956.185256,5956.196256,1,voc,178685557,178685887,330,spec2/voc/Bl122_178685557.jpg,Bl122,3
8016.632748,8016.648748,1,voc,240498982,240499462,480,spec2/voc/Bl122_240498982.jpg,Bl122,3
14349.370116,14349.567116,1,voc,430481103,430487013,5910,spec2/voc/Bl122_430481103.jpg,Bl122,3
13811.544352,13811.549352,1,voc,414346330,414346480,150,spec2/voc/Bl122_414346330.jpg,Bl122,3
12671.704513,12671.979513,1,voc,380151135,380159385,8250,spec2/voc/Bl122_380151135.jpg,Bl122,3
9146.541342,9146.555342,1,voc,274396240,274396660,420,spec2/voc/Bl122_274396240.jpg,Bl122,3
14154.865825,14154.869825,1,voc,424645974,424646094,120,spec2/voc/Bl122_424645974.jpg,Bl122,3
8917.917773,8918.077773,1,voc,267537533,267542333,4800,spec2/voc/Bl122_267537533.jpg,Bl122,3
14797.761551,14797.766551,1,voc,443932846,443932996,150,spec2/voc/Bl122_443932846.jpg,Bl122,3
9096.268241,9096.411241,1,voc,272888047,272892337,4290,spec2/voc/Bl122_272888047.jpg,Bl122,3
14627.274797,14627.523797,1,voc,438818243,438825713,7470,spec2/voc/Bl122_438818243.jpg,Bl122,3
5947.729256,5947.764256,1,voc,178431877,178432927,1050,spec2/voc/Bl122_178431877.jpg,Bl122,3
8018.006748,8018.011748,1,voc,240540202,240540352,150,spec2/voc/Bl122_240540202.jpg,Bl122,3
11127.285005,11127.288005,1,voc,333818550,333818640,90,spec2/voc/Bl122_333818550.jpg,Bl122,3
13199.545389,13199.553389,1,voc,395986361,395986601,240,spec2/voc/Bl122_395986361.jpg,Bl122,3
13949.106911,13949.111911,1,voc,418473207,418473357,150,spec2/voc/Bl122_418473207.jpg,Bl122,3
14708.637469,14708.824469,1,voc,441259124,441264734,5610,spec2/voc/Bl122_441259124.jpg,Bl122,3
13973.776117,13974.065117,1,voc,419213283,419221953,8670,spec2/voc/Bl122_419213283.jpg,Bl122,3
13743.444896,13743.447896,1,voc,412303346,412303436,90,spec2/voc/Bl122_412303346.jpg,Bl122,3
11195.16218,11195.20418,1,voc,335854865,335856125,1260,spec2/voc/Bl122_335854865.jpg,Bl122,3
6012.169533,6012.219533,1,voc,180365085,180366585,1500,spec2/voc/Bl122_180365085.jpg,Bl122,3
5985.665256,5985.667256,1,voc,179569957,179570017,60,spec2/voc/Bl122_179569957.jpg,Bl122,3
9087.798241,9087.808241,1,voc,272633947,272634247,300,spec2/voc/Bl122_272633947.jpg,Bl122,3
6073.445705,6073.450705,1,voc,182203371,182203521,150,spec2/voc/Bl122_182203371.jpg,Bl122,3
13939.2779,13939.5519,1,voc,418178337,418186557,8220,spec2/voc/Bl122_418178337.jpg,Bl122,3
14803.685551,14803.711551,1,voc,444110566,444111346,780,spec2/voc/Bl122_444110566.jpg,Bl122,3
7842.062748,7842.070748,1,voc,235261882,235262122,240,spec2/voc/Bl122_235261882.jpg,Bl122,3
6096.82415,6096.88715,1,voc,182904724,182906614,1890,spec2/voc/Bl122_182904724.jpg,Bl122,3
13822.98322,13822.98522,1,voc,414689496,414689556,60,spec2/voc/Bl122_414689496.jpg,Bl122,3
6040.932065,6040.935065,1,voc,181227961,181228051,90,spec2/voc/Bl122_181227961.jpg,Bl122,3
3822.995649,3823.021649,1,voc,114689869,114690649,780,spec2/voc/Bl122_114689869.jpg,Bl122,3
8021.859748,8021.909748,1,voc,240655792,240657292,1500,spec2/voc/Bl122_240655792.jpg,Bl122,3
9099.172241,9099.176241,1,voc,272975167,272975287,120,spec2/voc/Bl122_272975167.jpg,Bl122,3
6040.206065,6040.264065,1,voc,181206181,181207921,1740,spec2/voc/Bl122_181206181.jpg,Bl122,3
7843.557748,7843.591748,1,voc,235306732,235307752,1020,spec2/voc/Bl122_235306732.jpg,Bl122,3
10875.344466,10875.347466,1,voc,326260333,326260423,90,spec2/voc/Bl122_326260333.jpg,Bl122,3
5948.024256,5948.082256,1,voc,178440727,178442467,1740,spec2/voc/Bl122_178440727.jpg,Bl122,3
6055.485705,6055.523705,1,voc,181664571,181665711,1140,spec2/voc/Bl122_181664571.jpg,Bl122,3
3817.294649,3817.332649,1,voc,114518839,114519979,1140,spec2/voc/Bl122_114518839.jpg,Bl122,3
7884.831748,7884.835748,1,voc,236544952,236545072,120,spec2/voc/Bl122_236544952.jpg,Bl122,3
14794.401551,14794.557551,1,voc,443832046,443836726,4680,spec2/voc/Bl122_443832046.jpg,Bl122,3
11150.01518,11150.03718,1,voc,334500455,334501115,660,spec2/voc/Bl122_334500455.jpg,Bl122,3
12592.336947,12592.457947,1,voc,377770108,377773738,3630,spec2/voc/Bl122_377770108.jpg,Bl122,3
14157.175825,14157.247825,1,voc,424715274,424717434,2160,spec2/voc/Bl122_424715274.jpg,Bl122,3
7844.625748,7844.630748,1,voc,235338772,235338922,150,spec2/voc/Bl122_235338772.jpg,Bl122,3
14799.979551,14800.031551,1,voc,443999386,444000946,1560,spec2/voc/Bl122_443999386.jpg,Bl122,3
9028.902241,9028.930241,1,voc,270867067,270867907,840,spec2/voc/Bl122_270867067.jpg,Bl122,3
9098.172241,9098.236241,1,voc,272945167,272947087,1920,spec2/voc/Bl122_272945167.jpg,Bl122,3
8911.530773,8911.538773,1,voc,267345923,267346163,240,spec2/voc/Bl122_267345923.jpg,Bl122,3
13998.927512,13999.005512,1,voc,419967825,419970165,2340,spec2/voc/Bl122_419967825.jpg,Bl122,3
11172.39218,11172.48418,1,voc,335171765,335174525,2760,spec2/voc/Bl122_335171765.jpg,Bl122,3
5982.700256,5982.702256,1,voc,179481007,179481067,60,spec2/voc/Bl122_179481007.jpg,Bl122,3
6023.758533,6023.763533,1,voc,180712755,180712905,150,spec2/voc/Bl122_180712755.jpg,Bl122,3
6204.154327,6204.180327,1,voc,186124629,186125409,780,spec2/voc/Bl122_186124629.jpg,Bl122,3
14835.841682,14835.845682,1,voc,445075250,445075370,120,spec2/voc/Bl122_445075250.jpg,Bl122,3
10934.624807,10934.627807,1,voc,328038744,328038834,90,spec2/voc/Bl122_328038744.jpg,Bl122,3
14843.933682,14843.942682,1,voc,445318010,445318280,270,spec2/voc/Bl122_445318010.jpg,Bl122,3
8968.653712,8968.714712,1,voc,269059611,269061441,1830,spec2/voc/Bl122_269059611.jpg,Bl122,3
3051.391329,3051.447329,1,voc,91541739,91543419,1680,spec2/voc/Bl122_91541739.jpg,Bl122,3
14820.934551,14821.007551,1,voc,444628036,444630226,2190,spec2/voc/Bl122_444628036.jpg,Bl122,3
13744.151896,13744.222896,1,voc,412324556,412326686,2130,spec2/voc/Bl122_412324556.jpg,Bl122,3
7920.104748,7920.107748,1,voc,237603142,237603232,90,spec2/voc/Bl122_237603142.jpg,Bl122,3
10958.224807,10958.373807,1,voc,328746744,328751214,4470,spec2/voc/Bl122_328746744.jpg,Bl122,3
3825.418649,3825.970649,1,voc,114762559,114779119,16560,spec2/voc/Bl122_114762559.jpg,Bl122,3
5978.842256,5978.847256,1,voc,179365267,179365417,150,spec2/voc/Bl122_179365267.jpg,Bl122,3
6170.834327,6170.865327,1,voc,185125029,185125959,930,spec2/voc/Bl122_185125029.jpg,Bl122,3
6188.000327,6188.004327,1,voc,185640009,185640129,120,spec2/voc/Bl122_185640009.jpg,Bl122,3
7860.135748,7860.273748,1,voc,235804072,235808212,4140,spec2/voc/Bl122_235804072.jpg,Bl122,3
10907.755825,10907.757825,1,voc,327232674,327232734,60,spec2/voc/Bl122_327232674.jpg,Bl122,3
5985.353256,5985.358256,1,voc,179560597,179560747,150,spec2/voc/Bl122_179560597.jpg,Bl122,3
6068.169705,6068.178705,1,voc,182045091,182045361,270,spec2/voc/Bl122_182045091.jpg,Bl122,3
3808.898649,3808.920649,1,voc,114266959,114267619,660,spec2/voc/Bl122_114266959.jpg,Bl122,3
12582.522041,12582.680041,1,voc,377475661,377480401,4740,spec2/voc/Bl122_377475661.jpg,Bl122,3
5934.204256,5934.214256,1,voc,178026127,178026427,300,spec2/voc/Bl122_178026127.jpg,Bl122,3
5983.391256,5983.397256,1,voc,179501737,179501917,180,spec2/voc/Bl122_179501737.jpg,Bl122,3
9070.000241,9070.017241,1,voc,272100007,272100517,510,spec2/voc/Bl122_272100007.jpg,Bl122,3
13725.67041,13725.67741,1,voc,411770112,411770322,210,spec2/voc/Bl122_411770112.jpg,Bl122,3
6182.497327,6182.529327,1,voc,185474919,185475879,960,spec2/voc/Bl122_185474919.jpg,Bl122,3
6137.365293,6137.368293,1,voc,184120958,184121048,90,spec2/voc/Bl122_184120958.jpg,Bl122,3
7885.771748,7885.828748,1,voc,236573152,236574862,1710,spec2/voc/Bl122_236573152.jpg,Bl122,3
9053.587241,9053.711241,1,voc,271607617,271611337,3720,spec2/voc/Bl122_271607617.jpg,Bl122,3
7802.771748,7802.773748,1,voc,234083152,234083212,60,spec2/voc/Bl122_234083152.jpg,Bl122,3
11040.939892,11040.943892,1,voc,331228196,331228316,120,spec2/voc/Bl122_331228196.jpg,Bl122,3
9064.448241,9064.476241,1,voc,271933447,271934287,840,spec2/voc/Bl122_271933447.jpg,Bl122,3
13584.010236,13584.018236,1,voc,407520307,407520547,240,spec2/voc/Bl122_407520307.jpg,Bl122,3
6134.862293,6135.105293,1,voc,184045868,184053158,7290,spec2/voc/Bl122_184045868.jpg,Bl122,3
6208.040327,6208.047327,1,voc,186241209,186241419,210,spec2/voc/Bl122_186241209.jpg,Bl122,3
3815.795649,3815.800649,1,voc,114473869,114474019,150,spec2/voc/Bl122_114473869.jpg,Bl122,3
7828.421748,7828.424748,1,voc,234852652,234852742,90,spec2/voc/Bl122_234852652.jpg,Bl122,3
10955.501807,10955.598807,1,voc,328665054,328667964,2910,spec2/voc/Bl122_328665054.jpg,Bl122,3
11162.57218,11162.59118,1,voc,334877165,334877735,570,spec2/voc/Bl122_334877165.jpg,Bl122,3
8979.416025,8979.444025,1,voc,269382480,269383320,840,spec2/voc/Bl122_269382480.jpg,Bl122,3
5998.347256,5998.381256,1,voc,179950417,179951437,1020,spec2/voc/Bl122_179950417.jpg,Bl122,3
9039.015241,9039.023241,1,voc,271170457,271170697,240,spec2/voc/Bl122_271170457.jpg,Bl122,3
10880.193609,10880.195609,1,voc,326405808,326405868,60,spec2/voc/Bl122_326405808.jpg,Bl122,3
5958.935256,5958.944256,1,voc,178768057,178768327,270,spec2/voc/Bl122_178768057.jpg,Bl122,3
13156.311066,13156.398066,1,voc,394689331,394691941,2610,spec2/voc/Bl122_394689331.jpg,Bl122,3
3840.693415,3840.739415,1,voc,115220802,115222182,1380,spec2/voc/Bl122_115220802.jpg,Bl122,3
5988.104256,5988.122256,1,voc,179643127,179643667,540,spec2/voc/Bl122_179643127.jpg,Bl122,3
7995.196748,7995.223748,1,voc,239855902,239856712,810,spec2/voc/Bl122_239855902.jpg,Bl122,3
14808.006551,14808.017551,1,voc,444240196,444240526,330,spec2/voc/Bl122_444240196.jpg,Bl122,3
6195.575327,6195.677327,1,voc,185867259,185870319,3060,spec2/voc/Bl122_185867259.jpg,Bl122,3
9021.270241,9021.279241,1,voc,270638107,270638377,270,spec2/voc/Bl122_270638107.jpg,Bl122,3
13201.841389,13201.843389,1,voc,396055241,396055301,60,spec2/voc/Bl122_396055241.jpg,Bl122,3
10943.628807,10943.640807,1,voc,328308864,328309224,360,spec2/voc/Bl122_328308864.jpg,Bl122,3
5959.529256,5959.570256,1,voc,178785877,178787107,1230,spec2/voc/Bl122_178785877.jpg,Bl122,3
13790.52946,13790.53546,1,voc,413715883,413716063,180,spec2/voc/Bl122_413715883.jpg,Bl122,3
14789.574551,14789.674551,1,voc,443687236,443690236,3000,spec2/voc/Bl122_443687236.jpg,Bl122,3
11155.22618,11155.25118,1,voc,334656785,334657535,750,spec2/voc/Bl122_334656785.jpg,Bl122,3
12583.020041,12583.074041,1,voc,377490601,377492221,1620,spec2/voc/Bl122_377490601.jpg,Bl122,3
14842.346682,14842.360682,1,voc,445270400,445270820,420,spec2/voc/Bl122_445270400.jpg,Bl122,3
5994.152256,5994.379256,1,voc,179824567,179831377,6810,spec2/voc/Bl122_179824567.jpg,Bl122,3
7777.199748,7777.210748,1,voc,233315992,233316322,330,spec2/voc/Bl122_233315992.jpg,Bl122,3
9147.234342,9147.237342,1,voc,274417030,274417120,90,spec2/voc/Bl122_274417030.jpg,Bl122,3
13968.102352,13968.131352,1,voc,419043070,419043940,870,spec2/voc/Bl122_419043070.jpg,Bl122,3
10896.613557,10896.625557,1,voc,326898406,326898766,360,spec2/voc/Bl122_326898406.jpg,Bl122,3
13587.064236,13587.088236,1,voc,407611927,407612647,720,spec2/voc/Bl122_407611927.jpg,Bl122,3
9098.358241,9098.363241,1,voc,272950747,272950897,150,spec2/voc/Bl122_272950747.jpg,Bl122,3
10932.315807,10932.318807,1,voc,327969474,327969564,90,spec2/voc/Bl122_327969474.jpg,Bl122,3
9097.662241,9097.667241,1,voc,272929867,272930017,150,spec2/voc/Bl122_272929867.jpg,Bl122,3
8362.150263,8362.357263,1,voc,250864507,250870717,6210,spec2/voc/Bl122_250864507.jpg,Bl122,3
13167.720658,13167.779658,1,voc,395031619,395033389,1770,spec2/voc/Bl122_395031619.jpg,Bl122,3
8346.807566,8346.809566,1,voc,250404226,250404286,60,spec2/voc/Bl122_250404226.jpg,Bl122,3
10952.799807,10952.904807,1,voc,328583994,328587144,3150,spec2/voc/Bl122_328583994.jpg,Bl122,3
8951.441967,8951.541967,1,voc,268543259,268546259,3000,spec2/voc/Bl122_268543259.jpg,Bl122,3
10900.649004,10900.779004,1,voc,327019470,327023370,3900,spec2/voc/Bl122_327019470.jpg,Bl122,3
6051.6912,6051.7192,1,voc,181550736,181551576,840,spec2/voc/Bl122_181550736.jpg,Bl122,3
5946.395256,5946.404256,1,voc,178391857,178392127,270,spec2/voc/Bl122_178391857.jpg,Bl122,3
6021.466533,6021.685533,1,voc,180643995,180650565,6570,spec2/voc/Bl122_180643995.jpg,Bl122,3
7919.312748,7919.325748,1,voc,237579382,237579772,390,spec2/voc/Bl122_237579382.jpg,Bl122,3
7962.645748,7962.648748,1,voc,238879372,238879462,90,spec2/voc/Bl122_238879372.jpg,Bl122,3
14792.436551,14792.438551,1,voc,443773096,443773156,60,spec2/voc/Bl122_443773096.jpg,Bl122,3
5975.204256,5975.214256,1,voc,179256127,179256427,300,spec2/voc/Bl122_179256127.jpg,Bl122,3
6104.102706,6104.124706,1,voc,183123081,183123741,660,spec2/voc/Bl122_183123081.jpg,Bl122,3
14807.197551,14807.760551,1,voc,444215926,444232816,16890,spec2/voc/Bl122_444215926.jpg,Bl122,3
10935.562807,10935.568807,1,voc,328066884,328067064,180,spec2/voc/Bl122_328066884.jpg,Bl122,3
9166.518604,9166.575604,1,voc,274995558,274997268,1710,spec2/voc/Bl122_274995558.jpg,Bl122,3
7969.256748,7969.259748,1,voc,239077702,239077792,90,spec2/voc/Bl122_239077702.jpg,Bl122,3
7879.297748,7879.302748,1,voc,236378932,236379082,150,spec2/voc/Bl122_236378932.jpg,Bl122,3
14836.322682,14836.325682,1,voc,445089680,445089770,90,spec2/voc/Bl122_445089680.jpg,Bl122,3
10943.867807,10943.942807,1,voc,328316034,328318284,2250,spec2/voc/Bl122_328316034.jpg,Bl122,3
6034.063533,6034.069533,1,voc,181021905,181022085,180,spec2/voc/Bl122_181021905.jpg,Bl122,3
10946.063807,10946.181807,1,voc,328381914,328385454,3540,spec2/voc/Bl122_328381914.jpg,Bl122,3
13155.914066,13155.935066,1,voc,394677421,394678051,630,spec2/voc/Bl122_394677421.jpg,Bl122,3
11129.934005,11129.936005,1,voc,333898020,333898080,60,spec2/voc/Bl122_333898020.jpg,Bl122,3
10924.635807,10924.650807,1,voc,327739074,327739524,450,spec2/voc/Bl122_327739074.jpg,Bl122,3
8026.646748,8026.657748,1,voc,240799402,240799732,330,spec2/voc/Bl122_240799402.jpg,Bl122,3
7962.016748,7962.039748,1,voc,238860502,238861192,690,spec2/voc/Bl122_238860502.jpg,Bl122,3
11968.578795,11968.645795,1,voc,359057363,359059373,2010,spec2/voc/Bl122_359057363.jpg,Bl122,3
8016.089748,8016.110748,1,voc,240482692,240483322,630,spec2/voc/Bl122_240482692.jpg,Bl122,3
5929.426364,5929.430364,1,voc,177882790,177882910,120,spec2/voc/Bl122_177882790.jpg,Bl122,3
7866.913748,7866.915748,1,voc,236007412,236007472,60,spec2/voc/Bl122_236007412.jpg,Bl122,3
7905.063748,7905.119748,1,voc,237151912,237153592,1680,spec2/voc/Bl122_237151912.jpg,Bl122,3
3867.120367,3867.124367,1,voc,116013611,116013731,120,spec2/voc/Bl122_116013611.jpg,Bl122,3
6027.344533,6027.349533,1,voc,180820335,180820485,150,spec2/voc/Bl122_180820335.jpg,Bl122,3
8967.218712,8967.242712,1,voc,269016561,269017281,720,spec2/voc/Bl122_269016561.jpg,Bl122,3
11197.64718,11197.65918,1,voc,335929415,335929775,360,spec2/voc/Bl122_335929415.jpg,Bl122,3
6099.31315,6099.36115,1,voc,182979394,182980834,1440,spec2/voc/Bl122_182979394.jpg,Bl122,3
11195.26418,11195.28818,1,voc,335857925,335858645,720,spec2/voc/Bl122_335857925.jpg,Bl122,3
10898.46456,10898.46756,1,voc,326953936,326954026,90,spec2/voc/Bl122_326953936.jpg,Bl122,3
8032.302748,8032.311748,1,voc,240969082,240969352,270,spec2/voc/Bl122_240969082.jpg,Bl122,3
11133.244005,11133.439005,1,voc,333997320,334003170,5850,spec2/voc/Bl122_333997320.jpg,Bl122,3
14820.021551,14820.273551,1,voc,444600646,444608206,7560,spec2/voc/Bl122_444600646.jpg,Bl122,3
13989.704864,13989.977864,1,voc,419691145,419699335,8190,spec2/voc/Bl122_419691145.jpg,Bl122,3
6014.215533,6014.407533,1,voc,180426465,180432225,5760,spec2/voc/Bl122_180426465.jpg,Bl122,3
10963.792807,10963.927807,1,voc,328913784,328917834,4050,spec2/voc/Bl122_328913784.jpg,Bl122,3
14822.623551,14822.625551,1,voc,444678706,444678766,60,spec2/voc/Bl122_444678706.jpg,Bl122,3
8966.186712,8966.222712,1,voc,268985601,268986681,1080,spec2/voc/Bl122_268985601.jpg,Bl122,3
13732.050497,13732.060497,1,voc,411961514,411961814,300,spec2/voc/Bl122_411961514.jpg,Bl122,3
10906.646825,10906.666825,1,voc,327199404,327200004,600,spec2/voc/Bl122_327199404.jpg,Bl122,3
13599.776736,13599.781736,1,voc,407993302,407993452,150,spec2/voc/Bl122_407993302.jpg,Bl122,3
14321.818978,14321.981978,1,voc,429654569,429659459,4890,spec2/voc/Bl122_429654569.jpg,Bl122,3
9084.318241,9084.425241,1,voc,272529547,272532757,3210,spec2/voc/Bl122_272529547.jpg,Bl122,3
3869.149367,3869.368367,1,voc,116074481,116081051,6570,spec2/voc/Bl122_116074481.jpg,Bl122,3
14526.710046,14526.903046,1,voc,435801301,435807091,5790,spec2/voc/Bl122_435801301.jpg,Bl122,3
6107.382706,6107.386706,1,voc,183221481,183221601,120,spec2/voc/Bl122_183221481.jpg,Bl122,3
6110.546706,6110.569706,1,voc,183316401,183317091,690,spec2/voc/Bl122_183316401.jpg,Bl122,3
14023.02505,14023.02905,1,voc,420690751,420690871,120,spec2/voc/Bl122_420690751.jpg,Bl122,3
7860.587748,7860.592748,1,voc,235817632,235817782,150,spec2/voc/Bl122_235817632.jpg,Bl122,3
5931.584256,5931.593256,1,voc,177947527,177947797,270,spec2/voc/Bl122_177947527.jpg,Bl122,3
10907.127825,10907.207825,1,voc,327213834,327216234,2400,spec2/voc/Bl122_327213834.jpg,Bl122,3
7975.308748,7975.406748,1,voc,239259262,239262202,2940,spec2/voc/Bl122_239259262.jpg,Bl122,3
9076.359241,9076.404241,1,voc,272290777,272292127,1350,spec2/voc/Bl122_272290777.jpg,Bl122,3
13984.238943,13984.242943,1,voc,419527168,419527288,120,spec2/voc/Bl122_419527168.jpg,Bl122,3
10885.414162,10885.435162,1,voc,326562424,326563054,630,spec2/voc/Bl122_326562424.jpg,Bl122,3
9090.277241,9090.364241,1,voc,272708317,272710927,2610,spec2/voc/Bl122_272708317.jpg,Bl122,3
6136.472293,6136.481293,1,voc,184094168,184094438,270,spec2/voc/Bl122_184094168.jpg,Bl122,3
6084.67215,6084.68215,1,voc,182540164,182540464,300,spec2/voc/Bl122_182540164.jpg,Bl122,3
14791.698551,14791.705551,1,voc,443750956,443751166,210,spec2/voc/Bl122_443750956.jpg,Bl122,3
11152.05518,11152.26118,1,voc,334561655,334567835,6180,spec2/voc/Bl122_334561655.jpg,Bl122,3
6120.718706,6120.760706,1,voc,183621561,183622821,1260,spec2/voc/Bl122_183621561.jpg,Bl122,3
7802.415748,7802.439748,1,voc,234072472,234073192,720,spec2/voc/Bl122_234072472.jpg,Bl122,3
6096.76015,6096.76515,1,voc,182902804,182902954,150,spec2/voc/Bl122_182902804.jpg,Bl122,3
14709.866469,14709.871469,1,voc,441295994,441296144,150,spec2/voc/Bl122_441295994.jpg,Bl122,3
7956.950748,7956.962748,1,voc,238708522,238708882,360,spec2/voc/Bl122_238708522.jpg,Bl122,3
13588.698236,13588.732236,1,voc,407660947,407661967,1020,spec2/voc/Bl122_407660947.jpg,Bl122,3
3896.196652,3896.223652,1,voc,116885899,116886709,810,spec2/voc/Bl122_116885899.jpg,Bl122,3
6097.85615,6097.88515,1,voc,182935684,182936554,870,spec2/voc/Bl122_182935684.jpg,Bl122,3
9010.836241,9010.854241,1,voc,270325087,270325627,540,spec2/voc/Bl122_270325087.jpg,Bl122,3
5960.231256,5960.239256,1,voc,178806937,178807177,240,spec2/voc/Bl122_178806937.jpg,Bl122,3
11202.264894,11202.269894,1,voc,336067946,336068096,150,spec2/voc/Bl122_336067946.jpg,Bl122,3
13648.129941,13648.217941,1,voc,409443898,409446538,2640,spec2/voc/Bl122_409443898.jpg,Bl122,3
9161.312057,9161.352057,1,voc,274839361,274840561,1200,spec2/voc/Bl122_274839361.jpg,Bl122,3
8929.709773,8929.715773,1,voc,267891293,267891473,180,spec2/voc/Bl122_267891293.jpg,Bl122,3
8008.301748,8008.306748,1,voc,240249052,240249202,150,spec2/voc/Bl122_240249052.jpg,Bl122,3
5983.309256,5983.313256,1,voc,179499277,179499397,120,spec2/voc/Bl122_179499277.jpg,Bl122,3
7845.987748,7846.004748,1,voc,235379632,235380142,510,spec2/voc/Bl122_235379632.jpg,Bl122,3
5934.440256,5934.447256,1,voc,178033207,178033417,210,spec2/voc/Bl122_178033207.jpg,Bl122,3
7850.509748,7850.512748,1,voc,235515292,235515382,90,spec2/voc/Bl122_235515292.jpg,Bl122,3
11163.92618,11163.94618,1,voc,334917785,334918385,600,spec2/voc/Bl122_334917785.jpg,Bl122,3
11141.538955,11141.592955,1,voc,334246168,334247788,1620,spec2/voc/Bl122_334246168.jpg,Bl122,3
8949.166967,8949.274967,1,voc,268475009,268478249,3240,spec2/voc/Bl122_268475009.jpg,Bl122,3
8912.864773,8912.866773,1,voc,267385943,267386003,60,spec2/voc/Bl122_267385943.jpg,Bl122,3
13659.963334,13659.988334,1,voc,409798900,409799650,750,spec2/voc/Bl122_409798900.jpg,Bl122,3
3836.730415,3836.908415,1,voc,115101912,115107252,5340,spec2/voc/Bl122_115101912.jpg,Bl122,3
7891.326748,7891.339748,1,voc,236739802,236740192,390,spec2/voc/Bl122_236739802.jpg,Bl122,3
13818.750617,13818.756617,1,voc,414562518,414562698,180,spec2/voc/Bl122_414562518.jpg,Bl122,3
9004.821241,9004.909241,1,voc,270144637,270147277,2640,spec2/voc/Bl122_270144637.jpg,Bl122,3
8304.427054,8304.480054,1,voc,249132811,249134401,1590,spec2/voc/Bl122_249132811.jpg,Bl122,3
9137.266255,9137.375255,1,voc,274117987,274121257,3270,spec2/voc/Bl122_274117987.jpg,Bl122,3
9018.774241,9018.796241,1,voc,270563227,270563887,660,spec2/voc/Bl122_270563227.jpg,Bl122,3
6063.966705,6063.991705,1,voc,181919001,181919751,750,spec2/voc/Bl122_181919001.jpg,Bl122,3
13156.038066,13156.049066,1,voc,394681141,394681471,330,spec2/voc/Bl122_394681141.jpg,Bl122,3
14796.596551,14796.658551,1,voc,443897896,443899756,1860,spec2/voc/Bl122_443897896.jpg,Bl122,3
14183.371102,14183.409102,1,voc,425501133,425502273,1140,spec2/voc/Bl122_425501133.jpg,Bl122,3
6028.674533,6028.749533,1,voc,180860235,180862485,2250,spec2/voc/Bl122_180860235.jpg,Bl122,3
6050.2452,6050.2542,1,voc,181507356,181507626,270,spec2/voc/Bl122_181507356.jpg,Bl122,3
14811.990551,14812.084551,1,voc,444359716,444362536,2820,spec2/voc/Bl122_444359716.jpg,Bl122,3
9114.145184,9114.323184,1,voc,273424355,273429695,5340,spec2/voc/Bl122_273424355.jpg,Bl122,3
5996.968256,5996.975256,1,voc,179909047,179909257,210,spec2/voc/Bl122_179909047.jpg,Bl122,3
6062.015705,6062.021705,1,voc,181860471,181860651,180,spec2/voc/Bl122_181860471.jpg,Bl122,3
6130.891293,6130.930293,1,voc,183926738,183927908,1170,spec2/voc/Bl122_183926738.jpg,Bl122,3
6180.258327,6180.297327,1,voc,185407749,185408919,1170,spec2/voc/Bl122_185407749.jpg,Bl122,3
13188.546662,13188.551662,1,voc,395656399,395656549,150,spec2/voc/Bl122_395656399.jpg,Bl122,3
7998.932748,7998.936748,1,voc,239967982,239968102,120,spec2/voc/Bl122_239967982.jpg,Bl122,3
13920.908981,13920.990981,1,voc,417627269,417629729,2460,spec2/voc/Bl122_417627269.jpg,Bl122,3
8928.326773,8928.357773,1,voc,267849803,267850733,930,spec2/voc/Bl122_267849803.jpg,Bl122,3
6174.470327,6174.488327,1,voc,185234109,185234649,540,spec2/voc/Bl122_185234109.jpg,Bl122,3
8951.267967,8951.283967,1,voc,268538039,268538519,480,spec2/voc/Bl122_268538039.jpg,Bl122,3
14843.659682,14843.696682,1,voc,445309790,445310900,1110,spec2/voc/Bl122_445309790.jpg,Bl122,3
11160.75718,11160.79418,1,voc,334822715,334823825,1110,spec2/voc/Bl122_334822715.jpg,Bl122,3
14841.078682,14841.243682,1,voc,445232360,445237310,4950,spec2/voc/Bl122_445232360.jpg,Bl122,3
9063.522241,9063.728241,1,voc,271905667,271911847,6180,spec2/voc/Bl122_271905667.jpg,Bl122,3
14795.294551,14795.298551,1,voc,443858836,443858956,120,spec2/voc/Bl122_443858836.jpg,Bl122,3
7853.077748,7853.081748,1,voc,235592332,235592452,120,spec2/voc/Bl122_235592332.jpg,Bl122,3
7961.899748,7961.913748,1,voc,238856992,238857412,420,spec2/voc/Bl122_238856992.jpg,Bl122,3
5970.795256,5970.812256,1,voc,179123857,179124367,510,spec2/voc/Bl122_179123857.jpg,Bl122,3
7940.170748,7940.174748,1,voc,238205122,238205242,120,spec2/voc/Bl122_238205122.jpg,Bl122,3
12640.248849,12640.252849,1,voc,379207465,379207585,120,spec2/voc/Bl122_379207465.jpg,Bl122,3
11197.94118,11198.00518,1,voc,335938235,335940155,1920,spec2/voc/Bl122_335938235.jpg,Bl122,3
11872.068577,11872.324577,1,voc,356162057,356169737,7680,spec2/voc/Bl122_356162057.jpg,Bl122,3
11202.257894,11202.261894,1,voc,336067736,336067856,120,spec2/voc/Bl122_336067736.jpg,Bl122,3
8303.530054,8303.793054,1,voc,249105901,249113791,7890,spec2/voc/Bl122_249105901.jpg,Bl122,3
13927.541536,13927.711536,1,voc,417826246,417831346,5100,spec2/voc/Bl122_417826246.jpg,Bl122,3
8028.716748,8028.749748,1,voc,240861502,240862492,990,spec2/voc/Bl122_240861502.jpg,Bl122,3
7833.462748,7833.495748,1,voc,235003882,235004872,990,spec2/voc/Bl122_235003882.jpg,Bl122,3
9031.206241,9031.335241,1,voc,270936187,270940057,3870,spec2/voc/Bl122_270936187.jpg,Bl122,3
3841.436415,3841.467415,1,voc,115243092,115244022,930,spec2/voc/Bl122_115243092.jpg,Bl122,3
13998.395512,13998.441512,1,voc,419951865,419953245,1380,spec2/voc/Bl122_419951865.jpg,Bl122,3
11171.07018,11171.23218,1,voc,335132105,335136965,4860,spec2/voc/Bl122_335132105.jpg,Bl122,3
11188.22018,11188.34518,1,voc,335646605,335650355,3750,spec2/voc/Bl122_335646605.jpg,Bl122,3
7941.817748,7941.822748,1,voc,238254532,238254682,150,spec2/voc/Bl122_238254532.jpg,Bl122,3
13605.913736,13605.918736,1,voc,408177412,408177562,150,spec2/voc/Bl122_408177412.jpg,Bl122,3
11211.309894,11211.312894,1,voc,336339296,336339386,90,spec2/voc/Bl122_336339296.jpg,Bl122,3
6047.6822,6047.6982,1,voc,181430466,181430946,480,spec2/voc/Bl122_181430466.jpg,Bl122,3
6083.35915,6083.37115,1,voc,182500774,182501134,360,spec2/voc/Bl122_182500774.jpg,Bl122,3
9040.392241,9040.429241,1,voc,271211767,271212877,1110,spec2/voc/Bl122_271211767.jpg,Bl122,3
6030.513533,6030.546533,1,voc,180915405,180916395,990,spec2/voc/Bl122_180915405.jpg,Bl122,3
14330.684456,14330.838456,1,voc,429920533,429925153,4620,spec2/voc/Bl122_429920533.jpg,Bl122,3
9078.802241,9078.807241,1,voc,272364067,272364217,150,spec2/voc/Bl122_272364067.jpg,Bl122,3
9020.275241,9020.359241,1,voc,270608257,270610777,2520,spec2/voc/Bl122_270608257.jpg,Bl122,3
9043.360241,9043.367241,1,voc,271300807,271301017,210,spec2/voc/Bl122_271300807.jpg,Bl122,3
6090.47415,6090.73415,1,voc,182714224,182722024,7800,spec2/voc/Bl122_182714224.jpg,Bl122,3
9037.566241,9037.606241,1,voc,271126987,271128187,1200,spec2/voc/Bl122_271126987.jpg,Bl122,3
9123.012182,9123.060182,1,voc,273690365,273691805,1440,spec2/voc/Bl122_273690365.jpg,Bl122,3
8916.473773,8916.485773,1,voc,267494213,267494573,360,spec2/voc/Bl122_267494213.jpg,Bl122,3
11156.07518,11156.14518,1,voc,334682255,334684355,2100,spec2/voc/Bl122_334682255.jpg,Bl122,3
13580.338236,13580.391236,1,voc,407410147,407411737,1590,spec2/voc/Bl122_407410147.jpg,Bl122,3
13949.121911,13949.125911,1,voc,418473657,418473777,120,spec2/voc/Bl122_418473657.jpg,Bl122,3
6030.884533,6031.140533,1,voc,180926535,180934215,7680,spec2/voc/Bl122_180926535.jpg,Bl122,3
9056.361241,9056.374241,1,voc,271690837,271691227,390,spec2/voc/Bl122_271690837.jpg,Bl122,3
9137.641255,9137.711255,1,voc,274129237,274131337,2100,spec2/voc/Bl122_274129237.jpg,Bl122,3
6136.138293,6136.145293,1,voc,184084148,184084358,210,spec2/voc/Bl122_184084148.jpg,Bl122,3
9101.406241,9101.462241,1,voc,273042187,273043867,1680,spec2/voc/Bl122_273042187.jpg,Bl122,3
10946.843807,10946.845807,1,voc,328405314,328405374,60,spec2/voc/Bl122_328405314.jpg,Bl122,3
5946.677256,5946.717256,1,voc,178400317,178401517,1200,spec2/voc/Bl122_178400317.jpg,Bl122,3
11163.55618,11163.58918,1,voc,334906685,334907675,990,spec2/voc/Bl122_334906685.jpg,Bl122,3
6047.8762,6047.9142,1,voc,181436286,181437426,1140,spec2/voc/Bl122_181436286.jpg,Bl122,3
6105.443706,6105.477706,1,voc,183163311,183164331,1020,spec2/voc/Bl122_183163311.jpg,Bl122,3
3816.496649,3816.739649,1,voc,114494899,114502189,7290,spec2/voc/Bl122_114494899.jpg,Bl122,3
6138.413293,6138.424293,1,voc,184152398,184152728,330,spec2/voc/Bl122_184152398.jpg,Bl122,3
5970.195256,5970.202256,1,voc,179105857,179106067,210,spec2/voc/Bl122_179105857.jpg,Bl122,3
8017.795748,8018.001748,1,voc,240533872,240540052,6180,spec2/voc/Bl122_240533872.jpg,Bl122,3
6021.450533,6021.455533,1,voc,180643515,180643665,150,spec2/voc/Bl122_180643515.jpg,Bl122,3
10913.407807,10913.437807,1,voc,327402234,327403134,900,spec2/voc/Bl122_327402234.jpg,Bl122,3
11180.34418,11180.34818,1,voc,335410325,335410445,120,spec2/voc/Bl122_335410325.jpg,Bl122,3
14221.394015,14221.595015,1,voc,426641820,426647850,6030,spec2/voc/Bl122_426641820.jpg,Bl122,3
11133.639005,11133.760005,1,voc,334009170,334012800,3630,spec2/voc/Bl122_334009170.jpg,Bl122,3
7841.361748,7841.368748,1,voc,235240852,235241062,210,spec2/voc/Bl122_235240852.jpg,Bl122,3
12634.809885,12634.893885,1,voc,379044296,379046816,2520,spec2/voc/Bl122_379044296.jpg,Bl122,3
11178.36218,11178.38118,1,voc,335350865,335351435,570,spec2/voc/Bl122_335350865.jpg,Bl122,3
9114.104184,9114.112184,1,voc,273423125,273423365,240,spec2/voc/Bl122_273423125.jpg,Bl122,3
8928.248773,8928.258773,1,voc,267847463,267847763,300,spec2/voc/Bl122_267847463.jpg,Bl122,3
6076.382705,6076.471705,1,voc,182291481,182294151,2670,spec2/voc/Bl122_182291481.jpg,Bl122,3
11187.38818,11187.69518,1,voc,335621645,335630855,9210,spec2/voc/Bl122_335621645.jpg,Bl122,3
12140.670924,12140.836924,1,voc,364220127,364225107,4980,spec2/voc/Bl122_364220127.jpg,Bl122,3
6108.785706,6108.791706,1,voc,183263571,183263751,180,spec2/voc/Bl122_183263571.jpg,Bl122,3
10916.280807,10916.385807,1,voc,327488424,327491574,3150,spec2/voc/Bl122_327488424.jpg,Bl122,3
7986.076748,7986.085748,1,voc,239582302,239582572,270,spec2/voc/Bl122_239582302.jpg,Bl122,3
3849.844415,3849.913415,1,voc,115495332,115497402,2070,spec2/voc/Bl122_115495332.jpg,Bl122,3
6093.45015,6093.58915,1,voc,182803504,182807674,4170,spec2/voc/Bl122_182803504.jpg,Bl122,3
13162.037891,13162.044891,1,voc,394861136,394861346,210,spec2/voc/Bl122_394861136.jpg,Bl122,3
8978.365025,8978.778025,1,voc,269350950,269363340,12390,spec2/voc/Bl122_269350950.jpg,Bl122,3
6026.551533,6026.572533,1,voc,180796545,180797175,630,spec2/voc/Bl122_180796545.jpg,Bl122,3
6075.468705,6075.473705,1,voc,182264061,182264211,150,spec2/voc/Bl122_182264061.jpg,Bl122,3
13947.392911,13947.398911,1,voc,418421787,418421967,180,spec2/voc/Bl122_418421787.jpg,Bl122,3
6222.520295,6222.526295,1,voc,186675608,186675788,180,spec2/voc/Bl122_186675608.jpg,Bl122,3
7963.196748,7963.202748,1,voc,238895902,238896082,180,spec2/voc/Bl122_238895902.jpg,Bl122,3
3795.345649,3795.353649,1,voc,113860369,113860609,240,spec2/voc/Bl122_113860369.jpg,Bl122,3
7852.203748,7852.260748,1,voc,235566112,235567822,1710,spec2/voc/Bl122_235566112.jpg,Bl122,3
14794.287551,14794.295551,1,voc,443828626,443828866,240,spec2/voc/Bl122_443828626.jpg,Bl122,3
7861.886748,7861.924748,1,voc,235856602,235857742,1140,spec2/voc/Bl122_235856602.jpg,Bl122,3
14154.892825,14154.895825,1,voc,424646784,424646874,90,spec2/voc/Bl122_424646784.jpg,Bl122,3
10913.052807,10913.055807,1,voc,327391584,327391674,90,spec2/voc/Bl122_327391584.jpg,Bl122,3
10915.859807,10915.864807,1,voc,327475794,327475944,150,spec2/voc/Bl122_327475794.jpg,Bl122,3
10909.857807,10910.025807,1,voc,327295734,327300774,5040,spec2/voc/Bl122_327295734.jpg,Bl122,3
13952.935911,13952.939911,1,voc,418588077,418588197,120,spec2/voc/Bl122_418588077.jpg,Bl122,3
9113.625184,9113.628184,1,voc,273408755,273408845,90,spec2/voc/Bl122_273408755.jpg,Bl122,3
6051.8352,6051.8412,1,voc,181555056,181555236,180,spec2/voc/Bl122_181555056.jpg,Bl122,3
10908.346825,10908.375825,1,voc,327250404,327251274,870,spec2/voc/Bl122_327250404.jpg,Bl122,3
14843.630682,14843.655682,1,voc,445308920,445309670,750,spec2/voc/Bl122_445308920.jpg,Bl122,3
5954.320256,5954.327256,1,voc,178629607,178629817,210,spec2/voc/Bl122_178629607.jpg,Bl122,3
5988.027256,5988.034256,1,voc,179640817,179641027,210,spec2/voc/Bl122_179640817.jpg,Bl122,3
6118.927706,6118.936706,1,voc,183567831,183568101,270,spec2/voc/Bl122_183567831.jpg,Bl122,3
11981.232066,11981.256066,1,voc,359436961,359437681,720,spec2/voc/Bl122_359436961.jpg,Bl122,3
5937.444256,5937.460256,1,voc,178123327,178123807,480,spec2/voc/Bl122_178123327.jpg,Bl122,3
9046.419241,9046.556241,1,voc,271392577,271396687,4110,spec2/voc/Bl122_271392577.jpg,Bl122,3
9070.350241,9070.479241,1,voc,272110507,272114377,3870,spec2/voc/Bl122_272110507.jpg,Bl122,3
7872.017748,7872.022748,1,voc,236160532,236160682,150,spec2/voc/Bl122_236160532.jpg,Bl122,3
13976.988117,13976.998117,1,voc,419309643,419309943,300,spec2/voc/Bl122_419309643.jpg,Bl122,3
10863.139845,10863.209845,1,voc,325894195,325896295,2100,spec2/voc/Bl122_325894195.jpg,Bl122,3
11143.741955,11143.776955,1,voc,334312258,334313308,1050,spec2/voc/Bl122_334312258.jpg,Bl122,4
9108.370935,9108.504935,1,voc,273251128,273255148,4020,spec2/voc/Bl122_273251128.jpg,Bl122,4
10958.198807,10958.211807,1,voc,328745964,328746354,390,spec2/voc/Bl122_328745964.jpg,Bl122,4
14172.981581,14173.027581,1,voc,425189447,425190827,1380,spec2/voc/Bl122_425189447.jpg,Bl122,4
9037.756241,9038.114241,1,voc,271132687,271143427,10740,spec2/voc/Bl122_271132687.jpg,Bl122,4
8949.867967,8949.875967,1,voc,268496039,268496279,240,spec2/voc/Bl122_268496039.jpg,Bl122,4
9088.069241,9088.092241,1,voc,272642077,272642767,690,spec2/voc/Bl122_272642077.jpg,Bl122,4
5990.799256,5990.849256,1,voc,179723977,179725477,1500,spec2/voc/Bl122_179723977.jpg,Bl122,4
5950.308256,5950.310256,1,voc,178509247,178509307,60,spec2/voc/Bl122_178509247.jpg,Bl122,4
13727.911106,13727.973106,1,voc,411837333,411839193,1860,spec2/voc/Bl122_411837333.jpg,Bl122,4
8039.434748,8039.443748,1,voc,241183042,241183312,270,spec2/voc/Bl122_241183042.jpg,Bl122,4
10960.547807,10960.567807,1,voc,328816434,328817034,600,spec2/voc/Bl122_328816434.jpg,Bl122,4
7876.264748,7876.290748,1,voc,236287942,236288722,780,spec2/voc/Bl122_236287942.jpg,Bl122,4
6170.937327,6170.977327,1,voc,185128119,185129319,1200,spec2/voc/Bl122_185128119.jpg,Bl122,4
9014.959241,9015.201241,1,voc,270448777,270456037,7260,spec2/voc/Bl122_270448777.jpg,Bl122,4
6030.607533,6030.612533,1,voc,180918225,180918375,150,spec2/voc/Bl122_180918225.jpg,Bl122,4
7899.311748,7899.314748,1,voc,236979352,236979442,90,spec2/voc/Bl122_236979352.jpg,Bl122,4
6137.242293,6137.293293,1,voc,184117268,184118798,1530,spec2/voc/Bl122_184117268.jpg,Bl122,4
10950.204807,10950.315807,1,voc,328506144,328509474,3330,spec2/voc/Bl122_328506144.jpg,Bl122,4
13224.435389,13224.438389,1,voc,396733061,396733151,90,spec2/voc/Bl122_396733061.jpg,Bl122,4
5956.222256,5956.240256,1,voc,178686667,178687207,540,spec2/voc/Bl122_178686667.jpg,Bl122,4
6121.219706,6121.354706,1,voc,183636591,183640641,4050,spec2/voc/Bl122_183636591.jpg,Bl122,4
8938.416967,8938.497967,1,voc,268152509,268154939,2430,spec2/voc/Bl122_268152509.jpg,Bl122,4
14812.838551,14812.842551,1,voc,444385156,444385276,120,spec2/voc/Bl122_444385156.jpg,Bl122,4
11163.90518,11163.92318,1,voc,334917155,334917695,540,spec2/voc/Bl122_334917155.jpg,Bl122,4
10947.276807,10947.282807,1,voc,328418304,328418484,180,spec2/voc/Bl122_328418304.jpg,Bl122,4
9052.022241,9052.061241,1,voc,271560667,271561837,1170,spec2/voc/Bl122_271560667.jpg,Bl122,4
7872.214748,7872.248748,1,voc,236166442,236167462,1020,spec2/voc/Bl122_236166442.jpg,Bl122,4
7845.795748,7845.798748,1,voc,235373872,235373962,90,spec2/voc/Bl122_235373872.jpg,Bl122,4
8027.876748,8027.886748,1,voc,240836302,240836602,300,spec2/voc/Bl122_240836302.jpg,Bl122,4
13952.865911,13952.890911,1,voc,418585977,418586727,750,spec2/voc/Bl122_418585977.jpg,Bl122,4
3840.518415,3840.538415,1,voc,115215552,115216152,600,spec2/voc/Bl122_115215552.jpg,Bl122,4
14823.536551,14823.798551,1,voc,444706096,444713956,7860,spec2/voc/Bl122_444706096.jpg,Bl122,4
11180.75118,11180.77718,1,voc,335422535,335423315,780,spec2/voc/Bl122_335422535.jpg,Bl122,4
5966.386256,5966.447256,1,voc,178991587,178993417,1830,spec2/voc/Bl122_178991587.jpg,Bl122,4
6146.888349,6146.900349,1,voc,184406650,184407010,360,spec2/voc/Bl122_184406650.jpg,Bl122,4
13824.32422,13824.32722,1,voc,414729726,414729816,90,spec2/voc/Bl122_414729726.jpg,Bl122,4
3802.779649,3802.785649,1,voc,114083389,114083569,180,spec2/voc/Bl122_114083389.jpg,Bl122,4
9071.324241,9071.340241,1,voc,272139727,272140207,480,spec2/voc/Bl122_272139727.jpg,Bl122,4
9010.821241,9010.829241,1,voc,270324637,270324877,240,spec2/voc/Bl122_270324637.jpg,Bl122,4
2959.280975,2959.602975,1,voc,88778429,88788089,9660,spec2/voc/Bl122_88778429.jpg,Bl122,4
3844.880415,3844.892415,1,voc,115346412,115346772,360,spec2/voc/Bl122_115346412.jpg,Bl122,4
5965.316256,5965.396256,1,voc,178959487,178961887,2400,spec2/voc/Bl122_178959487.jpg,Bl122,4
6026.135533,6026.154533,1,voc,180784065,180784635,570,spec2/voc/Bl122_180784065.jpg,Bl122,4
14795.425551,14795.462551,1,voc,443862766,443863876,1110,spec2/voc/Bl122_443862766.jpg,Bl122,4
8035.818748,8035.829748,1,voc,241074562,241074892,330,spec2/voc/Bl122_241074562.jpg,Bl122,4
11201.709894,11201.764894,1,voc,336051296,336052946,1650,spec2/voc/Bl122_336051296.jpg,Bl122,4
5941.168256,5941.186256,1,voc,178235047,178235587,540,spec2/voc/Bl122_178235047.jpg,Bl122,4
10907.778825,10907.860825,1,voc,327233364,327235824,2460,spec2/voc/Bl122_327233364.jpg,Bl122,4
6050.3422,6050.3642,1,voc,181510266,181510926,660,spec2/voc/Bl122_181510266.jpg,Bl122,4
5941.882256,5941.953256,1,voc,178256467,178258597,2130,spec2/voc/Bl122_178256467.jpg,Bl122,4
3896.001652,3896.006652,1,voc,116880049,116880199,150,spec2/voc/Bl122_116880049.jpg,Bl122,4
10896.563557,10896.572557,1,voc,326896906,326897176,270,spec2/voc/Bl122_326896906.jpg,Bl122,4
3890.393652,3890.471652,1,voc,116711809,116714149,2340,spec2/voc/Bl122_116711809.jpg,Bl122,4
7968.609748,7968.643748,1,voc,239058292,239059312,1020,spec2/voc/Bl122_239058292.jpg,Bl122,4
6029.631533,6029.664533,1,voc,180888945,180889935,990,spec2/voc/Bl122_180888945.jpg,Bl122,4
9010.678241,9010.688241,1,voc,270320347,270320647,300,spec2/voc/Bl122_270320347.jpg,Bl122,4
8361.430263,8361.571263,1,voc,250842907,250847137,4230,spec2/voc/Bl122_250842907.jpg,Bl122,4
14149.639855,14149.641855,1,voc,424489195,424489255,60,spec2/voc/Bl122_424489195.jpg,Bl122,4
6222.791295,6222.903295,1,voc,186683738,186687098,3360,spec2/voc/Bl122_186683738.jpg,Bl122,4
6046.9922,6047.0102,1,voc,181409766,181410306,540,spec2/voc/Bl122_181409766.jpg,Bl122,4
13723.1259,13723.1379,1,voc,411693777,411694137,360,spec2/voc/Bl122_411693777.jpg,Bl122,4
13968.706352,13968.796352,1,voc,419061190,419063890,2700,spec2/voc/Bl122_419061190.jpg,Bl122,4
5964.318256,5964.323256,1,voc,178929547,178929697,150,spec2/voc/Bl122_178929547.jpg,Bl122,4
9053.719241,9053.728241,1,voc,271611577,271611847,270,spec2/voc/Bl122_271611577.jpg,Bl122,4
7850.521748,7850.524748,1,voc,235515652,235515742,90,spec2/voc/Bl122_235515652.jpg,Bl122,4
5992.431256,5992.438256,1,voc,179772937,179773147,210,spec2/voc/Bl122_179772937.jpg,Bl122,4
11143.481955,11143.485955,1,voc,334304458,334304578,120,spec2/voc/Bl122_334304458.jpg,Bl122,4
14810.487551,14810.494551,1,voc,444314626,444314836,210,spec2/voc/Bl122_444314626.jpg,Bl122,4
7911.861748,7911.882748,1,voc,237355852,237356482,630,spec2/voc/Bl122_237355852.jpg,Bl122,4
12627.906577,12627.986577,1,voc,378837197,378839597,2400,spec2/voc/Bl122_378837197.jpg,Bl122,4
7845.762748,7845.768748,1,voc,235372882,235373062,180,spec2/voc/Bl122_235372882.jpg,Bl122,4
7884.150748,7884.154748,1,voc,236524522,236524642,120,spec2/voc/Bl122_236524522.jpg,Bl122,4
13988.684864,13988.687864,1,voc,419660545,419660635,90,spec2/voc/Bl122_419660545.jpg,Bl122,4
6223.496295,6223.499295,1,voc,186704888,186704978,90,spec2/voc/Bl122_186704888.jpg,Bl122,4
11208.545894,11208.567894,1,voc,336256376,336257036,660,spec2/voc/Bl122_336256376.jpg,Bl122,4
10940.403807,10940.412807,1,voc,328212114,328212384,270,spec2/voc/Bl122_328212114.jpg,Bl122,4
5981.305256,5981.331256,1,voc,179439157,179439937,780,spec2/voc/Bl122_179439157.jpg,Bl122,4
6048.0332,6048.0492,1,voc,181440996,181441476,480,spec2/voc/Bl122_181440996.jpg,Bl122,4
10842.177842,10842.180842,1,voc,325265335,325265425,90,spec2/voc/Bl122_325265335.jpg,Bl122,4
6071.450705,6071.459705,1,voc,182143521,182143791,270,spec2/voc/Bl122_182143521.jpg,Bl122,4
10918.046807,10918.051807,1,voc,327541404,327541554,150,spec2/voc/Bl122_327541404.jpg,Bl122,4
7841.528748,7841.537748,1,voc,235245862,235246132,270,spec2/voc/Bl122_235245862.jpg,Bl122,4
6069.925705,6069.931705,1,voc,182097771,182097951,180,spec2/voc/Bl122_182097771.jpg,Bl122,4
6108.587706,6108.591706,1,voc,183257631,183257751,120,spec2/voc/Bl122_183257631.jpg,Bl122,4
6028.751533,6028.754533,1,voc,180862545,180862635,90,spec2/voc/Bl122_180862545.jpg,Bl122,4
3795.969649,3796.026649,1,voc,113879089,113880799,1710,spec2/voc/Bl122_113879089.jpg,Bl122,4
9003.163241,9003.232241,1,voc,270094897,270096967,2070,spec2/voc/Bl122_270094897.jpg,Bl122,4
11172.97518,11172.97918,1,voc,335189255,335189375,120,spec2/voc/Bl122_335189255.jpg,Bl122,4
14709.450469,14709.694469,1,voc,441283514,441290834,7320,spec2/voc/Bl122_441283514.jpg,Bl122,4
6056.797705,6056.810705,1,voc,181703931,181704321,390,spec2/voc/Bl122_181703931.jpg,Bl122,4
14841.449682,14841.460682,1,voc,445243490,445243820,330,spec2/voc/Bl122_445243490.jpg,Bl122,4
10957.410807,10957.443807,1,voc,328722324,328723314,990,spec2/voc/Bl122_328722324.jpg,Bl122,4
6074.332705,6074.627705,1,voc,182229981,182238831,8850,spec2/voc/Bl122_182229981.jpg,Bl122,4
11132.512005,11132.708005,1,voc,333975360,333981240,5880,spec2/voc/Bl122_333975360.jpg,Bl122,4
14825.503551,14825.675551,1,voc,444765106,444770266,5160,spec2/voc/Bl122_444765106.jpg,Bl122,4
14823.299551,14823.364551,1,voc,444698986,444700936,1950,spec2/voc/Bl122_444698986.jpg,Bl122,4
6089.02415,6089.05315,1,voc,182670724,182671594,870,spec2/voc/Bl122_182670724.jpg,Bl122,4
6169.902327,6169.910327,1,voc,185097069,185097309,240,spec2/voc/Bl122_185097069.jpg,Bl122,4
9068.709241,9068.712241,1,voc,272061277,272061367,90,spec2/voc/Bl122_272061277.jpg,Bl122,4
10963.480807,10963.484807,1,voc,328904424,328904544,120,spec2/voc/Bl122_328904424.jpg,Bl122,4
10931.074807,10931.081807,1,voc,327932244,327932454,210,spec2/voc/Bl122_327932244.jpg,Bl122,4
8346.048566,8346.556566,1,voc,250381456,250396696,15240,spec2/voc/Bl122_250381456.jpg,Bl122,4
5960.729256,5960.777256,1,voc,178821877,178823317,1440,spec2/voc/Bl122_178821877.jpg,Bl122,4
8946.925967,8946.929967,1,voc,268407779,268407899,120,spec2/voc/Bl122_268407779.jpg,Bl122,4
11211.257894,11211.302894,1,voc,336337736,336339086,1350,spec2/voc/Bl122_336337736.jpg,Bl122,4
11046.367537,11046.381537,1,voc,331391026,331391446,420,spec2/voc/Bl122_331391026.jpg,Bl122,4
10943.517807,10943.550807,1,voc,328305534,328306524,990,spec2/voc/Bl122_328305534.jpg,Bl122,4
8922.129773,8922.172773,1,voc,267663893,267665183,1290,spec2/voc/Bl122_267663893.jpg,Bl122,4
6205.075327,6205.110327,1,voc,186152259,186153309,1050,spec2/voc/Bl122_186152259.jpg,Bl122,4
14708.830469,14708.888469,1,voc,441264914,441266654,1740,spec2/voc/Bl122_441264914.jpg,Bl122,4
14842.889682,14842.896682,1,voc,445286690,445286900,210,spec2/voc/Bl122_445286690.jpg,Bl122,4
9075.823241,9075.829241,1,voc,272274697,272274877,180,spec2/voc/Bl122_272274697.jpg,Bl122,4
13585.224236,13585.357236,1,voc,407556727,407560717,3990,spec2/voc/Bl122_407556727.jpg,Bl122,4
3895.459652,3895.464652,1,voc,116863789,116863939,150,spec2/voc/Bl122_116863789.jpg,Bl122,4
6202.499327,6202.509327,1,voc,186074979,186075279,300,spec2/voc/Bl122_186074979.jpg,Bl122,4
11045.863537,11045.919537,1,voc,331375906,331377586,1680,spec2/voc/Bl122_331375906.jpg,Bl122,4
9003.302241,9003.467241,1,voc,270099067,270104017,4950,spec2/voc/Bl122_270099067.jpg,Bl122,4
12673.033513,12673.047513,1,voc,380191005,380191425,420,spec2/voc/Bl122_380191005.jpg,Bl122,4
14803.836551,14803.969551,1,voc,444115096,444119086,3990,spec2/voc/Bl122_444115096.jpg,Bl122,4
9012.429241,9012.459241,1,voc,270372877,270373777,900,spec2/voc/Bl122_270372877.jpg,Bl122,4
6095.84715,6096.03615,1,voc,182875414,182881084,5670,spec2/voc/Bl122_182875414.jpg,Bl122,4
14815.027551,14815.089551,1,voc,444450826,444452686,1860,spec2/voc/Bl122_444450826.jpg,Bl122,4
10965.007807,10965.110807,1,voc,328950234,328953324,3090,spec2/voc/Bl122_328950234.jpg,Bl122,4
5952.441256,5952.659256,1,voc,178573237,178579777,6540,spec2/voc/Bl122_178573237.jpg,Bl122,4
13213.985389,13213.995389,1,voc,396419561,396419861,300,spec2/voc/Bl122_396419561.jpg,Bl122,4
10928.581807,10928.708807,1,voc,327857454,327861264,3810,spec2/voc/Bl122_327857454.jpg,Bl122,4
13208.480389,13208.482389,1,voc,396254411,396254471,60,spec2/voc/Bl122_396254411.jpg,Bl122,4
5947.202256,5947.213256,1,voc,178416067,178416397,330,spec2/voc/Bl122_178416067.jpg,Bl122,4
14842.724682,14842.836682,1,voc,445281740,445285100,3360,spec2/voc/Bl122_445281740.jpg,Bl122,4
5961.137256,5961.260256,1,voc,178834117,178837807,3690,spec2/voc/Bl122_178834117.jpg,Bl122,4
7881.740748,7881.781748,1,voc,236452222,236453452,1230,spec2/voc/Bl122_236452222.jpg,Bl122,4
9004.245241,9004.249241,1,voc,270127357,270127477,120,spec2/voc/Bl122_270127357.jpg,Bl122,4
11123.352005,11123.606005,1,voc,333700560,333708180,7620,spec2/voc/Bl122_333700560.jpg,Bl122,4
9159.412796,9159.661796,1,voc,274782383,274789853,7470,spec2/voc/Bl122_274782383.jpg,Bl122,4
7928.507748,7928.517748,1,voc,237855232,237855532,300,spec2/voc/Bl122_237855232.jpg,Bl122,4
11156.96418,11157.00418,1,voc,334708925,334710125,1200,spec2/voc/Bl122_334708925.jpg,Bl122,4
9131.519981,9131.672981,1,voc,273945599,273950189,4590,spec2/voc/Bl122_273945599.jpg,Bl122,4
8999.384241,8999.508241,1,voc,269981527,269985247,3720,spec2/voc/Bl122_269981527.jpg,Bl122,4
11160.50718,11160.51018,1,voc,334815215,334815305,90,spec2/voc/Bl122_334815215.jpg,Bl122,4
9078.694241,9078.800241,1,voc,272360827,272364007,3180,spec2/voc/Bl122_272360827.jpg,Bl122,4
6026.377533,6026.440533,1,voc,180791325,180793215,1890,spec2/voc/Bl122_180791325.jpg,Bl122,4
14335.129707,14335.165707,1,voc,430053891,430054971,1080,spec2/voc/Bl122_430053891.jpg,Bl122,4
9051.980241,9052.000241,1,voc,271559407,271560007,600,spec2/voc/Bl122_271559407.jpg,Bl122,4
8013.578748,8013.580748,1,voc,240407362,240407422,60,spec2/voc/Bl122_240407362.jpg,Bl122,4
6050.9052,6050.9932,1,voc,181527156,181529796,2640,spec2/voc/Bl122_181527156.jpg,Bl122,4
6199.290327,6199.379327,1,voc,185978709,185981379,2670,spec2/voc/Bl122_185978709.jpg,Bl122,4
5997.658256,5997.813256,1,voc,179929747,179934397,4650,spec2/voc/Bl122_179929747.jpg,Bl122,4
8208.009882,8208.068882,1,voc,246240296,246242066,1770,spec2/voc/Bl122_246240296.jpg,Bl122,4
3825.994649,3826.021649,1,voc,114779839,114780649,810,spec2/voc/Bl122_114779839.jpg,Bl122,4
12932.54229,12932.88929,1,voc,387976268,387986678,10410,spec2/voc/Bl122_387976268.jpg,Bl122,4
13710.918399,13710.946399,1,voc,411327551,411328391,840,spec2/voc/Bl122_411327551.jpg,Bl122,4
8943.366967,8943.429967,1,voc,268301009,268302899,1890,spec2/voc/Bl122_268301009.jpg,Bl122,4
7860.594748,7860.599748,1,voc,235817842,235817992,150,spec2/voc/Bl122_235817842.jpg,Bl122,4
6024.083533,6024.118533,1,voc,180722505,180723555,1050,spec2/voc/Bl122_180722505.jpg,Bl122,4
9098.005241,9098.022241,1,voc,272940157,272940667,510,spec2/voc/Bl122_272940157.jpg,Bl122,4
5959.320256,5959.328256,1,voc,178779607,178779847,240,spec2/voc/Bl122_178779607.jpg,Bl122,4
7768.267748,7768.271748,1,voc,233048032,233048152,120,spec2/voc/Bl122_233048032.jpg,Bl122,4
13823.14522,13823.15022,1,voc,414694356,414694506,150,spec2/voc/Bl122_414694356.jpg,Bl122,4
13162.259891,13162.263891,1,voc,394867796,394867916,120,spec2/voc/Bl122_394867796.jpg,Bl122,4
13156.260066,13156.275066,1,voc,394687801,394688251,450,spec2/voc/Bl122_394687801.jpg,Bl122,4
8345.839566,8345.935566,1,voc,250375186,250378066,2880,spec2/voc/Bl122_250375186.jpg,Bl122,4
5930.849256,5931.117256,1,voc,177925477,177933517,8040,spec2/voc/Bl122_177925477.jpg,Bl122,4
12671.524513,12671.559513,1,voc,380145735,380146785,1050,spec2/voc/Bl122_380145735.jpg,Bl122,4
5969.878256,5969.918256,1,voc,179096347,179097547,1200,spec2/voc/Bl122_179096347.jpg,Bl122,4
7841.370748,7841.391748,1,voc,235241122,235241752,630,spec2/voc/Bl122_235241122.jpg,Bl122,4
14160.124921,14160.326921,1,voc,424803747,424809807,6060,spec2/voc/Bl122_424803747.jpg,Bl122,4
14149.244855,14149.247855,1,voc,424477345,424477435,90,spec2/voc/Bl122_424477345.jpg,Bl122,4
10926.882807,10926.913807,1,voc,327806484,327807414,930,spec2/voc/Bl122_327806484.jpg,Bl122,4
11209.571894,11209.602894,1,voc,336287156,336288086,930,spec2/voc/Bl122_336287156.jpg,Bl122,4
11099.727855,11099.782855,1,voc,332991835,332993485,1650,spec2/voc/Bl122_332991835.jpg,Bl122,4
13199.782389,13199.789389,1,voc,395993471,395993681,210,spec2/voc/Bl122_395993471.jpg,Bl122,4
10935.623807,10935.641807,1,voc,328068714,328069254,540,spec2/voc/Bl122_328068714.jpg,Bl122,4
8956.131967,8956.302967,1,voc,268683959,268689089,5130,spec2/voc/Bl122_268683959.jpg,Bl122,4
8039.488748,8039.491748,1,voc,241184662,241184752,90,spec2/voc/Bl122_241184662.jpg,Bl122,4
14807.860551,14807.864551,1,voc,444235816,444235936,120,spec2/voc/Bl122_444235816.jpg,Bl122,4
9049.439241,9049.448241,1,voc,271483177,271483447,270,spec2/voc/Bl122_271483177.jpg,Bl122,4
6181.256327,6181.309327,1,voc,185437689,185439279,1590,spec2/voc/Bl122_185437689.jpg,Bl122,4
6065.044705,6065.046705,1,voc,181951341,181951401,60,spec2/voc/Bl122_181951341.jpg,Bl122,4
10932.649807,10932.653807,1,voc,327979494,327979614,120,spec2/voc/Bl122_327979494.jpg,Bl122,4
13968.319352,13968.529352,1,voc,419049580,419055880,6300,spec2/voc/Bl122_419049580.jpg,Bl122,4
8016.185748,8016.189748,1,voc,240485572,240485692,120,spec2/voc/Bl122_240485572.jpg,Bl122,4
13580.253236,13580.268236,1,voc,407407597,407408047,450,spec2/voc/Bl122_407407597.jpg,Bl122,4
14814.385551,14814.441551,1,voc,444431566,444433246,1680,spec2/voc/Bl122_444431566.jpg,Bl122,4
8995.505241,8995.525241,1,voc,269865157,269865757,600,spec2/voc/Bl122_269865157.jpg,Bl122,4
13946.267911,13946.275911,1,voc,418388037,418388277,240,spec2/voc/Bl122_418388037.jpg,Bl122,4
3827.550649,3827.602649,1,voc,114826519,114828079,1560,spec2/voc/Bl122_114826519.jpg,Bl122,4
6010.615533,6010.641533,1,voc,180318465,180319245,780,spec2/voc/Bl122_180318465.jpg,Bl122,4
6019.195533,6019.201533,1,voc,180575865,180576045,180,spec2/voc/Bl122_180575865.jpg,Bl122,4
11140.542955,11140.684955,1,voc,334216288,334220548,4260,spec2/voc/Bl122_334216288.jpg,Bl122,4
9036.688241,9036.721241,1,voc,271100647,271101637,990,spec2/voc/Bl122_271100647.jpg,Bl122,4
9098.424241,9098.428241,1,voc,272952727,272952847,120,spec2/voc/Bl122_272952727.jpg,Bl122,4
5959.268256,5959.315256,1,voc,178778047,178779457,1410,spec2/voc/Bl122_178778047.jpg,Bl122,4
13541.666816,13541.802816,1,voc,406250004,406254084,4080,spec2/voc/Bl122_406250004.jpg,Bl122,4
3890.599652,3890.692652,1,voc,116717989,116720779,2790,spec2/voc/Bl122_116717989.jpg,Bl122,4
3849.957415,3850.024415,1,voc,115498722,115500732,2010,spec2/voc/Bl122_115498722.jpg,Bl122,4
7937.944748,7937.947748,1,voc,238138342,238138432,90,spec2/voc/Bl122_238138342.jpg,Bl122,4
13829.615664,13829.622664,1,voc,414888469,414888679,210,spec2/voc/Bl122_414888469.jpg,Bl122,4
10936.431807,10936.438807,1,voc,328092954,328093164,210,spec2/voc/Bl122_328092954.jpg,Bl122,4
14709.727469,14709.739469,1,voc,441291824,441292184,360,spec2/voc/Bl122_441291824.jpg,Bl122,4
9168.212604,9168.219604,1,voc,275046378,275046588,210,spec2/voc/Bl122_275046378.jpg,Bl122,4
9034.928241,9034.938241,1,voc,271047847,271048147,300,spec2/voc/Bl122_271047847.jpg,Bl122,4
9086.271241,9086.278241,1,voc,272588137,272588347,210,spec2/voc/Bl122_272588137.jpg,Bl122,4
6108.722706,6108.730706,1,voc,183261681,183261921,240,spec2/voc/Bl122_183261681.jpg,Bl122,4
14799.021551,14799.023551,1,voc,443970646,443970706,60,spec2/voc/Bl122_443970646.jpg,Bl122,4
6020.544533,6020.568533,1,voc,180616335,180617055,720,spec2/voc/Bl122_180616335.jpg,Bl122,4
13949.509911,13949.517911,1,voc,418485297,418485537,240,spec2/voc/Bl122_418485297.jpg,Bl122,4
6224.854295,6224.888295,1,voc,186745628,186746648,1020,spec2/voc/Bl122_186745628.jpg,Bl122,4
13790.46246,13790.52446,1,voc,413713873,413715733,1860,spec2/voc/Bl122_413713873.jpg,Bl122,4
7985.728748,7985.754748,1,voc,239571862,239572642,780,spec2/voc/Bl122_239571862.jpg,Bl122,4
7976.578748,7976.583748,1,voc,239297362,239297512,150,spec2/voc/Bl122_239297362.jpg,Bl122,4
3820.599649,3820.945649,1,voc,114617989,114628369,10380,spec2/voc/Bl122_114617989.jpg,Bl122,4
9096.636241,9096.650241,1,voc,272899087,272899507,420,spec2/voc/Bl122_272899087.jpg,Bl122,4
5983.672256,5983.676256,1,voc,179510167,179510287,120,spec2/voc/Bl122_179510167.jpg,Bl122,4
13203.822389,13203.825389,1,voc,396114671,396114761,90,spec2/voc/Bl122_396114671.jpg,Bl122,4
8015.986748,8015.990748,1,voc,240479602,240479722,120,spec2/voc/Bl122_240479602.jpg,Bl122,4
10931.671807,10931.690807,1,voc,327950154,327950724,570,spec2/voc/Bl122_327950154.jpg,Bl122,4
7975.483748,7975.519748,1,voc,239264512,239265592,1080,spec2/voc/Bl122_239264512.jpg,Bl122,4
6114.106706,6114.114706,1,voc,183423201,183423441,240,spec2/voc/Bl122_183423201.jpg,Bl122,4
6026.578533,6026.605533,1,voc,180797355,180798165,810,spec2/voc/Bl122_180797355.jpg,Bl122,4
14154.516825,14154.518825,1,voc,424635504,424635564,60,spec2/voc/Bl122_424635504.jpg,Bl122,4
13586.753236,13586.814236,1,voc,407602597,407604427,1830,spec2/voc/Bl122_407602597.jpg,Bl122,4
8994.208241,8994.214241,1,voc,269826247,269826427,180,spec2/voc/Bl122_269826247.jpg,Bl122,4
3806.051649,3806.074649,1,voc,114181549,114182239,690,spec2/voc/Bl122_114181549.jpg,Bl122,4
5971.073256,5971.077256,1,voc,179132197,179132317,120,spec2/voc/Bl122_179132197.jpg,Bl122,4
14796.896551,14797.174551,1,voc,443906896,443915236,8340,spec2/voc/Bl122_443906896.jpg,Bl122,4
14825.678551,14825.691551,1,voc,444770356,444770746,390,spec2/voc/Bl122_444770356.jpg,Bl122,4
10937.164807,10937.209807,1,voc,328114944,328116294,1350,spec2/voc/Bl122_328114944.jpg,Bl122,4
8195.96775,8196.00675,1,voc,245879032,245880202,1170,spec2/voc/Bl122_245879032.jpg,Bl122,4
9069.341241,9069.348241,1,voc,272080237,272080447,210,spec2/voc/Bl122_272080237.jpg,Bl122,4
10909.151807,10909.154807,1,voc,327274554,327274644,90,spec2/voc/Bl122_327274554.jpg,Bl122,4
6036.322533,6036.327533,1,voc,181089675,181089825,150,spec2/voc/Bl122_181089675.jpg,Bl122,4
3817.403649,3817.443649,1,voc,114522109,114523309,1200,spec2/voc/Bl122_114522109.jpg,Bl122,4
10950.681807,10950.710807,1,voc,328520454,328521324,870,spec2/voc/Bl122_328520454.jpg,Bl122,4
7843.448748,7843.464748,1,voc,235303462,235303942,480,spec2/voc/Bl122_235303462.jpg,Bl122,4
7844.133748,7844.169748,1,voc,235324012,235325092,1080,spec2/voc/Bl122_235324012.jpg,Bl122,4
13192.159662,13192.369662,1,voc,395764789,395771089,6300,spec2/voc/Bl122_395764789.jpg,Bl122,4
3804.998649,3805.279649,1,voc,114149959,114158389,8430,spec2/voc/Bl122_114149959.jpg,Bl122,4
6029.520533,6029.523533,1,voc,180885615,180885705,90,spec2/voc/Bl122_180885615.jpg,Bl122,4
10937.894807,10938.126807,1,voc,328136844,328143804,6960,spec2/voc/Bl122_328136844.jpg,Bl122,4
13946.811911,13946.832911,1,voc,418404357,418404987,630,spec2/voc/Bl122_418404357.jpg,Bl122,4
5992.296256,5992.357256,1,voc,179768887,179770717,1830,spec2/voc/Bl122_179768887.jpg,Bl122,4
13178.724701,13178.770701,1,voc,395361741,395363121,1380,spec2/voc/Bl122_395361741.jpg,Bl122,4
5938.721256,5938.726256,1,voc,178161637,178161787,150,spec2/voc/Bl122_178161637.jpg,Bl122,4
8026.742748,8026.786748,1,voc,240802282,240803602,1320,spec2/voc/Bl122_240802282.jpg,Bl122,4
11953.297309,11953.432309,1,voc,358598919,358602969,4050,spec2/voc/Bl122_358598919.jpg,Bl122,4
9008.401241,9008.406241,1,voc,270252037,270252187,150,spec2/voc/Bl122_270252037.jpg,Bl122,4
9099.180241,9099.197241,1,voc,272975407,272975917,510,spec2/voc/Bl122_272975407.jpg,Bl122,4
11152.66418,11152.66818,1,voc,334579925,334580045,120,spec2/voc/Bl122_334579925.jpg,Bl122,4
6084.13315,6084.15615,1,voc,182523994,182524684,690,spec2/voc/Bl122_182523994.jpg,Bl122,4
5990.861256,5990.893256,1,voc,179725837,179726797,960,spec2/voc/Bl122_179725837.jpg,Bl122,4
7837.824748,7837.838748,1,voc,235134742,235135162,420,spec2/voc/Bl122_235134742.jpg,Bl122,4
6057.878705,6057.885705,1,voc,181736361,181736571,210,spec2/voc/Bl122_181736361.jpg,Bl122,4
9051.547241,9051.561241,1,voc,271546417,271546837,420,spec2/voc/Bl122_271546417.jpg,Bl122,4
11168.11118,11168.13618,1,voc,335043335,335044085,750,spec2/voc/Bl122_335043335.jpg,Bl122,4
13774.224473,13774.397473,1,voc,413226734,413231924,5190,spec2/voc/Bl122_413226734.jpg,Bl122,4
14819.447551,14819.471551,1,voc,444583426,444584146,720,spec2/voc/Bl122_444583426.jpg,Bl122,4
6160.652349,6160.656349,1,voc,184819570,184819690,120,spec2/voc/Bl122_184819570.jpg,Bl122,4
14202.037387,14202.039387,1,voc,426061121,426061181,60,spec2/voc/Bl122_426061121.jpg,Bl122,4
6176.176327,6176.185327,1,voc,185285289,185285559,270,spec2/voc/Bl122_185285289.jpg,Bl122,4
7892.384748,7892.405748,1,voc,236771542,236772172,630,spec2/voc/Bl122_236771542.jpg,Bl122,4
6107.779706,6107.794706,1,voc,183233391,183233841,450,spec2/voc/Bl122_183233391.jpg,Bl122,4
9098.845241,9098.863241,1,voc,272965357,272965897,540,spec2/voc/Bl122_272965357.jpg,Bl122,4
5974.258256,5974.272256,1,voc,179227747,179228167,420,spec2/voc/Bl122_179227747.jpg,Bl122,4
9072.720241,9072.922241,1,voc,272181607,272187667,6060,spec2/voc/Bl122_272181607.jpg,Bl122,4
14823.859551,14823.867551,1,voc,444715786,444716026,240,spec2/voc/Bl122_444715786.jpg,Bl122,4
11209.172894,11209.193894,1,voc,336275186,336275816,630,spec2/voc/Bl122_336275186.jpg,Bl122,4
3895.308652,3895.320652,1,voc,116859259,116859619,360,spec2/voc/Bl122_116859259.jpg,Bl122,4
5962.753256,5962.776256,1,voc,178882597,178883287,690,spec2/voc/Bl122_178882597.jpg,Bl122,4
5946.660256,5946.666256,1,voc,178399807,178399987,180,spec2/voc/Bl122_178399807.jpg,Bl122,4
3847.137415,3847.179415,1,voc,115414122,115415382,1260,spec2/voc/Bl122_115414122.jpg,Bl122,4
12002.987987,12003.157987,1,voc,360089639,360094739,5100,spec2/voc/Bl122_360089639.jpg,Bl122,4
3822.315649,3822.323649,1,voc,114669469,114669709,240,spec2/voc/Bl122_114669469.jpg,Bl122,4
6034.734533,6034.737533,1,voc,181042035,181042125,90,spec2/voc/Bl122_181042035.jpg,Bl122,4
5972.384256,5972.395256,1,voc,179171527,179171857,330,spec2/voc/Bl122_179171527.jpg,Bl122,4
7985.356748,7985.372748,1,voc,239560702,239561182,480,spec2/voc/Bl122_239560702.jpg,Bl122,4
3897.217652,3897.380652,1,voc,116916529,116921419,4890,spec2/voc/Bl122_116916529.jpg,Bl122,4
5989.929256,5989.935256,1,voc,179697877,179698057,180,spec2/voc/Bl122_179697877.jpg,Bl122,4
6169.856327,6169.875327,1,voc,185095689,185096259,570,spec2/voc/Bl122_185095689.jpg,Bl122,4
7907.609748,7907.626748,1,voc,237228292,237228802,510,spec2/voc/Bl122_237228292.jpg,Bl122,4
9069.429241,9069.447241,1,voc,272082877,272083417,540,spec2/voc/Bl122_272082877.jpg,Bl122,4
6033.790533,6033.806533,1,voc,181013715,181014195,480,spec2/voc/Bl122_181013715.jpg,Bl122,4
9034.129241,9034.135241,1,voc,271023877,271024057,180,spec2/voc/Bl122_271023877.jpg,Bl122,4
10875.544466,10875.549466,1,voc,326266333,326266483,150,spec2/voc/Bl122_326266333.jpg,Bl122,4
9072.647241,9072.652241,1,voc,272179417,272179567,150,spec2/voc/Bl122_272179417.jpg,Bl122,4
12939.361352,12939.376352,1,voc,388180840,388181290,450,spec2/voc/Bl122_388180840.jpg,Bl122,4
9070.064241,9070.081241,1,voc,272101927,272102437,510,spec2/voc/Bl122_272101927.jpg,Bl122,4
9100.765241,9100.823241,1,voc,273022957,273024697,1740,spec2/voc/Bl122_273022957.jpg,Bl122,4
6208.561327,6208.571327,1,voc,186256839,186257139,300,spec2/voc/Bl122_186256839.jpg,Bl122,4
3836.438415,3836.441415,1,voc,115093152,115093242,90,spec2/voc/Bl122_115093152.jpg,Bl122,4
9049.909241,9050.113241,1,voc,271497277,271503397,6120,spec2/voc/Bl122_271497277.jpg,Bl122,4
6030.551533,6030.569533,1,voc,180916545,180917085,540,spec2/voc/Bl122_180916545.jpg,Bl122,4
3045.075066,3045.237066,1,voc,91352251,91357111,4860,spec2/voc/Bl122_91352251.jpg,Bl122,4
8987.472025,8987.610025,1,voc,269624160,269628300,4140,spec2/voc/Bl122_269624160.jpg,Bl122,4
11046.254537,11046.259537,1,voc,331387636,331387786,150,spec2/voc/Bl122_331387636.jpg,Bl122,4
9115.044184,9115.048184,1,voc,273451325,273451445,120,spec2/voc/Bl122_273451325.jpg,Bl122,4
6169.694327,6169.722327,1,voc,185090829,185091669,840,spec2/voc/Bl122_185090829.jpg,Bl122,4
10881.438609,10881.461609,1,voc,326443158,326443848,690,spec2/voc/Bl122_326443158.jpg,Bl122,4
13214.131389,13214.135389,1,voc,396423941,396424061,120,spec2/voc/Bl122_396423941.jpg,Bl122,4
11143.276955,11143.319955,1,voc,334298308,334299598,1290,spec2/voc/Bl122_334298308.jpg,Bl122,4
11991.305785,11991.470785,1,voc,359739173,359744123,4950,spec2/voc/Bl122_359739173.jpg,Bl122,4
6047.0702,6047.3672,1,voc,181412106,181421016,8910,spec2/voc/Bl122_181412106.jpg,Bl122,4
11158.41718,11158.66418,1,voc,334752515,334759925,7410,spec2/voc/Bl122_334752515.jpg,Bl122,4
6119.680706,6119.761706,1,voc,183590421,183592851,2430,spec2/voc/Bl122_183590421.jpg,Bl122,4
6107.530706,6107.538706,1,voc,183225921,183226161,240,spec2/voc/Bl122_183225921.jpg,Bl122,4
13163.235891,13163.245891,1,voc,394897076,394897376,300,spec2/voc/Bl122_394897076.jpg,Bl122,4
5997.503256,5997.509256,1,voc,179925097,179925277,180,spec2/voc/Bl122_179925097.jpg,Bl122,4
13976.463117,13976.531117,1,voc,419293893,419295933,2040,spec2/voc/Bl122_419293893.jpg,Bl122,4
9123.649182,9123.654182,1,voc,273709475,273709625,150,spec2/voc/Bl122_273709475.jpg,Bl122,4
10941.868807,10941.870807,1,voc,328256064,328256124,60,spec2/voc/Bl122_328256064.jpg,Bl122,4
6118.467706,6118.470706,1,voc,183554031,183554121,90,spec2/voc/Bl122_183554031.jpg,Bl122,4
7860.806748,7860.846748,1,voc,235824202,235825402,1200,spec2/voc/Bl122_235824202.jpg,Bl122,4
5959.799256,5959.821256,1,voc,178793977,178794637,660,spec2/voc/Bl122_178793977.jpg,Bl122,4
6183.201327,6183.247327,1,voc,185496039,185497419,1380,spec2/voc/Bl122_185496039.jpg,Bl122,4
6171.256327,6171.321327,1,voc,185137689,185139639,1950,spec2/voc/Bl122_185137689.jpg,Bl122,4
9148.232842,9148.266842,1,voc,274446985,274448005,1020,spec2/voc/Bl122_274446985.jpg,Bl122,4
13744.564896,13744.582896,1,voc,412336946,412337486,540,spec2/voc/Bl122_412336946.jpg,Bl122,4
9174.554287,9174.567287,1,voc,275236628,275237018,390,spec2/voc/Bl122_275236628.jpg,Bl122,4
5974.118256,5974.134256,1,voc,179223547,179224027,480,spec2/voc/Bl122_179223547.jpg,Bl122,4
6027.797533,6027.802533,1,voc,180833925,180834075,150,spec2/voc/Bl122_180833925.jpg,Bl122,4
13187.804662,13187.818662,1,voc,395634139,395634559,420,spec2/voc/Bl122_395634139.jpg,Bl122,4
9025.126241,9025.156241,1,voc,270753787,270754687,900,spec2/voc/Bl122_270753787.jpg,Bl122,4
6050.3982,6050.4042,1,voc,181511946,181512126,180,spec2/voc/Bl122_181511946.jpg,Bl122,4
14820.598551,14820.603551,1,voc,444617956,444618106,150,spec2/voc/Bl122_444617956.jpg,Bl122,4
11179.19318,11179.25318,1,voc,335375795,335377595,1800,spec2/voc/Bl122_335375795.jpg,Bl122,4
6102.901706,6102.985706,1,voc,183087051,183089571,2520,spec2/voc/Bl122_183087051.jpg,Bl122,4
6028.050533,6028.090533,1,voc,180841515,180842715,1200,spec2/voc/Bl122_180841515.jpg,Bl122,4
7944.204748,7944.214748,1,voc,238326142,238326442,300,spec2/voc/Bl122_238326142.jpg,Bl122,4
13588.491236,13588.513236,1,voc,407654737,407655397,660,spec2/voc/Bl122_407654737.jpg,Bl122,4
5975.293256,5975.346256,1,voc,179258797,179260387,1590,spec2/voc/Bl122_179258797.jpg,Bl122,4
8345.939566,8345.975566,1,voc,250378186,250379266,1080,spec2/voc/Bl122_250378186.jpg,Bl122,4
5930.368256,5930.387256,1,voc,177911047,177911617,570,spec2/voc/Bl122_177911047.jpg,Bl122,4
7807.020748,7807.031748,1,voc,234210622,234210952,330,spec2/voc/Bl122_234210622.jpg,Bl122,4
9015.848241,9015.851241,1,voc,270475447,270475537,90,spec2/voc/Bl122_270475447.jpg,Bl122,4
13920.828981,13920.833981,1,voc,417624869,417625019,150,spec2/voc/Bl122_417624869.jpg,Bl122,4
13574.557572,13574.592572,1,voc,407236727,407237777,1050,spec2/voc/Bl122_407236727.jpg,Bl122,4
13588.447236,13588.488236,1,voc,407653417,407654647,1230,spec2/voc/Bl122_407653417.jpg,Bl122,4
9006.041241,9006.110241,1,voc,270181237,270183307,2070,spec2/voc/Bl122_270181237.jpg,Bl122,4
11184.24918,11184.66018,1,voc,335527475,335539805,12330,spec2/voc/Bl122_335527475.jpg,Bl122,4
10919.200807,10919.261807,1,voc,327576024,327577854,1830,spec2/voc/Bl122_327576024.jpg,Bl122,4
11134.564005,11134.567005,1,voc,334036920,334037010,90,spec2/voc/Bl122_334036920.jpg,Bl122,4
6070.483705,6070.651705,1,voc,182114511,182119551,5040,spec2/voc/Bl122_182114511.jpg,Bl122,4
8938.238967,8938.254967,1,voc,268147169,268147649,480,spec2/voc/Bl122_268147169.jpg,Bl122,4
7983.872748,7983.878748,1,voc,239516182,239516362,180,spec2/voc/Bl122_239516182.jpg,Bl122,4
6034.741533,6034.743533,1,voc,181042245,181042305,60,spec2/voc/Bl122_181042245.jpg,Bl122,4
6080.714511,6080.720511,1,voc,182421435,182421615,180,spec2/voc/Bl122_182421435.jpg,Bl122,4
9016.190241,9016.200241,1,voc,270485707,270486007,300,spec2/voc/Bl122_270485707.jpg,Bl122,4
13974.713117,13974.793117,1,voc,419241393,419243793,2400,spec2/voc/Bl122_419241393.jpg,Bl122,4
13920.835981,13920.879981,1,voc,417625079,417626399,1320,spec2/voc/Bl122_417625079.jpg,Bl122,4
6072.084705,6072.087705,1,voc,182162541,182162631,90,spec2/voc/Bl122_182162541.jpg,Bl122,4
6109.471706,6109.483706,1,voc,183284151,183284511,360,spec2/voc/Bl122_183284151.jpg,Bl122,4
10947.327807,10947.335807,1,voc,328419834,328420074,240,spec2/voc/Bl122_328419834.jpg,Bl122,4
8966.172712,8966.181712,1,voc,268985181,268985451,270,spec2/voc/Bl122_268985181.jpg,Bl122,4
3054.920464,3055.114464,1,voc,91647613,91653433,5820,spec2/voc/Bl122_91647613.jpg,Bl122,4
13210.956389,13210.960389,1,voc,396328691,396328811,120,spec2/voc/Bl122_396328691.jpg,Bl122,4
10918.165807,10918.190807,1,voc,327544974,327545724,750,spec2/voc/Bl122_327544974.jpg,Bl122,4
8994.216241,8994.226241,1,voc,269826487,269826787,300,spec2/voc/Bl122_269826487.jpg,Bl122,4
7885.600748,7885.606748,1,voc,236568022,236568202,180,spec2/voc/Bl122_236568022.jpg,Bl122,4
10936.751807,10936.754807,1,voc,328102554,328102644,90,spec2/voc/Bl122_328102554.jpg,Bl122,4
10955.486807,10955.496807,1,voc,328664604,328664904,300,spec2/voc/Bl122_328664604.jpg,Bl122,4
7908.161748,7908.204748,1,voc,237244852,237246142,1290,spec2/voc/Bl122_237244852.jpg,Bl122,4
7923.767748,7923.769748,1,voc,237713032,237713092,60,spec2/voc/Bl122_237713032.jpg,Bl122,4
3824.274649,3824.422649,1,voc,114728239,114732679,4440,spec2/voc/Bl122_114728239.jpg,Bl122,4
11164.06418,11164.21418,1,voc,334921925,334926425,4500,spec2/voc/Bl122_334921925.jpg,Bl122,4
3895.296652,3895.305652,1,voc,116858899,116859169,270,spec2/voc/Bl122_116858899.jpg,Bl122,4
9050.797241,9050.801241,1,voc,271523917,271524037,120,spec2/voc/Bl122_271523917.jpg,Bl122,4
11188.20918,11188.21318,1,voc,335646275,335646395,120,spec2/voc/Bl122_335646275.jpg,Bl122,4
7983.124748,7983.128748,1,voc,239493742,239493862,120,spec2/voc/Bl122_239493742.jpg,Bl122,4
3856.109415,3856.276415,1,voc,115683282,115688292,5010,spec2/voc/Bl122_115683282.jpg,Bl122,4
12591.391947,12591.394947,1,voc,377741758,377741848,90,spec2/voc/Bl122_377741758.jpg,Bl122,4
13179.053701,13179.072701,1,voc,395371611,395372181,570,spec2/voc/Bl122_395371611.jpg,Bl122,4
5842.485221,5842.487221,1,voc,175274556,175274616,60,spec2/voc/Bl122_175274556.jpg,Bl122,4
9168.096604,9168.199604,1,voc,275042898,275045988,3090,spec2/voc/Bl122_275042898.jpg,Bl122,4
13582.520236,13582.731236,1,voc,407475607,407481937,6330,spec2/voc/Bl122_407475607.jpg,Bl122,4
9004.639241,9004.679241,1,voc,270139177,270140377,1200,spec2/voc/Bl122_270139177.jpg,Bl122,4
7935.323748,7935.328748,1,voc,238059712,238059862,150,spec2/voc/Bl122_238059712.jpg,Bl122,4
8955.603967,8955.886967,1,voc,268668119,268676609,8490,spec2/voc/Bl122_268668119.jpg,Bl122,4
12587.397744,12587.420744,1,voc,377621932,377622622,690,spec2/voc/Bl122_377621932.jpg,Bl122,4
8000.554748,8000.572748,1,voc,240016642,240017182,540,spec2/voc/Bl122_240016642.jpg,Bl122,4
3859.629367,3859.636367,1,voc,115788881,115789091,210,spec2/voc/Bl122_115788881.jpg,Bl122,4
11183.42618,11183.46218,1,voc,335502785,335503865,1080,spec2/voc/Bl122_335502785.jpg,Bl122,4
9078.618241,9078.640241,1,voc,272358547,272359207,660,spec2/voc/Bl122_272358547.jpg,Bl122,4
3821.996649,3822.001649,1,voc,114659899,114660049,150,spec2/voc/Bl122_114659899.jpg,Bl122,4
6144.500349,6144.548349,1,voc,184335010,184336450,1440,spec2/voc/Bl122_184335010.jpg,Bl122,4
10929.489807,10929.576807,1,voc,327884694,327887304,2610,spec2/voc/Bl122_327884694.jpg,Bl122,4
3837.927415,3838.224415,1,voc,115137822,115146732,8910,spec2/voc/Bl122_115137822.jpg,Bl122,4
9089.961241,9089.993241,1,voc,272698837,272699797,960,spec2/voc/Bl122_272698837.jpg,Bl122,4
3816.024649,3816.032649,1,voc,114480739,114480979,240,spec2/voc/Bl122_114480739.jpg,Bl122,4
6122.288706,6122.381706,1,voc,183668661,183671451,2790,spec2/voc/Bl122_183668661.jpg,Bl122,4
6117.386706,6117.392706,1,voc,183521601,183521781,180,spec2/voc/Bl122_183521601.jpg,Bl122,4
7985.829748,7985.835748,1,voc,239574892,239575072,180,spec2/voc/Bl122_239574892.jpg,Bl122,4
7892.174748,7892.190748,1,voc,236765242,236765722,480,spec2/voc/Bl122_236765242.jpg,Bl122,4
8017.559748,8017.565748,1,voc,240526792,240526972,180,spec2/voc/Bl122_240526792.jpg,Bl122,4
6115.876706,6116.207706,1,voc,183476301,183486231,9930,spec2/voc/Bl122_183476301.jpg,Bl122,4
9066.408241,9066.514241,1,voc,271992247,271995427,3180,spec2/voc/Bl122_271992247.jpg,Bl122,4
6205.310327,6205.394327,1,voc,186159309,186161829,2520,spec2/voc/Bl122_186159309.jpg,Bl122,4
6182.165327,6182.176327,1,voc,185464959,185465289,330,spec2/voc/Bl122_185464959.jpg,Bl122,4
5996.001256,5996.247256,1,voc,179880037,179887417,7380,spec2/voc/Bl122_179880037.jpg,Bl122,4
11186.57418,11186.60018,1,voc,335597225,335598005,780,spec2/voc/Bl122_335597225.jpg,Bl122,4
8955.544967,8955.599967,1,voc,268666349,268667999,1650,spec2/voc/Bl122_268666349.jpg,Bl122,4
6152.919349,6152.927349,1,voc,184587580,184587820,240,spec2/voc/Bl122_184587580.jpg,Bl122,4
6110.918706,6110.921706,1,voc,183327561,183327651,90,spec2/voc/Bl122_183327561.jpg,Bl122,4
5948.376256,5948.472256,1,voc,178451287,178454167,2880,spec2/voc/Bl122_178451287.jpg,Bl122,4
5981.768256,5981.820256,1,voc,179453047,179454607,1560,spec2/voc/Bl122_179453047.jpg,Bl122,4
5961.988256,5962.248256,1,voc,178859647,178867447,7800,spec2/voc/Bl122_178859647.jpg,Bl122,4
6134.722293,6134.777293,1,voc,184041668,184043318,1650,spec2/voc/Bl122_184041668.jpg,Bl122,4
7970.213748,7970.267748,1,voc,239106412,239108032,1620,spec2/voc/Bl122_239106412.jpg,Bl122,4
9013.662241,9013.677241,1,voc,270409867,270410317,450,spec2/voc/Bl122_270409867.jpg,Bl122,4
14201.083387,14201.159387,1,voc,426032501,426034781,2280,spec2/voc/Bl122_426032501.jpg,Bl122,4
10918.248807,10918.276807,1,voc,327547464,327548304,840,spec2/voc/Bl122_327547464.jpg,Bl122,4
6059.813705,6059.830705,1,voc,181794411,181794921,510,spec2/voc/Bl122_181794411.jpg,Bl122,4
10942.917807,10942.932807,1,voc,328287534,328287984,450,spec2/voc/Bl122_328287534.jpg,Bl122,4
3859.487367,3859.491367,1,voc,115784621,115784741,120,spec2/voc/Bl122_115784621.jpg,Bl122,4
3808.937649,3808.979649,1,voc,114268129,114269389,1260,spec2/voc/Bl122_114268129.jpg,Bl122,4
6171.035327,6171.050327,1,voc,185131059,185131509,450,spec2/voc/Bl122_185131059.jpg,Bl122,4
5960.779256,5960.826256,1,voc,178823377,178824787,1410,spec2/voc/Bl122_178823377.jpg,Bl122,4
14156.210825,14156.232825,1,voc,424686324,424686984,660,spec2/voc/Bl122_424686324.jpg,Bl122,4
7846.136748,7846.147748,1,voc,235384102,235384432,330,spec2/voc/Bl122_235384102.jpg,Bl122,4
10880.483609,10880.507609,1,voc,326414508,326415228,720,spec2/voc/Bl122_326414508.jpg,Bl122,4
6189.498327,6189.553327,1,voc,185684949,185686599,1650,spec2/voc/Bl122_185684949.jpg,Bl122,4
9151.195842,9151.208842,1,voc,274535875,274536265,390,spec2/voc/Bl122_274535875.jpg,Bl122,4
7928.215748,7928.219748,1,voc,237846472,237846592,120,spec2/voc/Bl122_237846472.jpg,Bl122,4
9137.495255,9137.561255,1,voc,274124857,274126837,1980,spec2/voc/Bl122_274124857.jpg,Bl122,4
9124.215182,9124.421182,1,voc,273726455,273732635,6180,spec2/voc/Bl122_273726455.jpg,Bl122,4
11185.22218,11185.24318,1,voc,335556665,335557295,630,spec2/voc/Bl122_335556665.jpg,Bl122,4
9048.028241,9048.133241,1,voc,271440847,271443997,3150,spec2/voc/Bl122_271440847.jpg,Bl122,4
13733.446497,13733.458497,1,voc,412003394,412003754,360,spec2/voc/Bl122_412003394.jpg,Bl122,4
5937.344256,5937.346256,1,voc,178120327,178120387,60,spec2/voc/Bl122_178120327.jpg,Bl122,4
8929.194773,8929.270773,1,voc,267875843,267878123,2280,spec2/voc/Bl122_267875843.jpg,Bl122,4
6192.394327,6192.408327,1,voc,185771829,185772249,420,spec2/voc/Bl122_185771829.jpg,Bl122,4
13818.686617,13818.697617,1,voc,414560598,414560928,330,spec2/voc/Bl122_414560598.jpg,Bl122,4
3811.322649,3811.491649,1,voc,114339679,114344749,5070,spec2/voc/Bl122_114339679.jpg,Bl122,4
7823.747748,7823.753748,1,voc,234712432,234712612,180,spec2/voc/Bl122_234712432.jpg,Bl122,4
7976.948748,7976.964748,1,voc,239308462,239308942,480,spec2/voc/Bl122_239308462.jpg,Bl122,4
9032.145241,9032.249241,1,voc,270964357,270967477,3120,spec2/voc/Bl122_270964357.jpg,Bl122,4
8036.602748,8036.606748,1,voc,241098082,241098202,120,spec2/voc/Bl122_241098082.jpg,Bl122,4
10932.728807,10932.744807,1,voc,327981864,327982344,480,spec2/voc/Bl122_327981864.jpg,Bl122,4
10957.917807,10957.920807,1,voc,328737534,328737624,90,spec2/voc/Bl122_328737534.jpg,Bl122,4
11210.835894,11210.845894,1,voc,336325076,336325376,300,spec2/voc/Bl122_336325076.jpg,Bl122,4
7985.781748,7985.783748,1,voc,239573452,239573512,60,spec2/voc/Bl122_239573452.jpg,Bl122,4
9010.768241,9010.776241,1,voc,270323047,270323287,240,spec2/voc/Bl122_270323047.jpg,Bl122,4
6105.839706,6105.908706,1,voc,183175191,183177261,2070,spec2/voc/Bl122_183175191.jpg,Bl122,4
13822.55122,13822.55422,1,voc,414676536,414676626,90,spec2/voc/Bl122_414676536.jpg,Bl122,4
6094.50915,6094.51615,1,voc,182835274,182835484,210,spec2/voc/Bl122_182835274.jpg,Bl122,4
13191.069662,13191.073662,1,voc,395732089,395732209,120,spec2/voc/Bl122_395732089.jpg,Bl122,4
8968.918712,8968.925712,1,voc,269067561,269067771,210,spec2/voc/Bl122_269067561.jpg,Bl122,4
10952.982807,10953.004807,1,voc,328589484,328590144,660,spec2/voc/Bl122_328589484.jpg,Bl122,4
10915.241807,10915.251807,1,voc,327457254,327457554,300,spec2/voc/Bl122_327457254.jpg,Bl122,4
6033.384533,6033.408533,1,voc,181001535,181002255,720,spec2/voc/Bl122_181001535.jpg,Bl122,4
6083.98915,6083.99615,1,voc,182519674,182519884,210,spec2/voc/Bl122_182519674.jpg,Bl122,4
8985.771025,8985.774025,1,voc,269573130,269573220,90,spec2/voc/Bl122_269573130.jpg,Bl122,4
9192.40598,9192.42298,1,voc,275772179,275772689,510,spec2/voc/Bl122_275772179.jpg,Bl122,4
6156.144349,6156.163349,1,voc,184684330,184684900,570,spec2/voc/Bl122_184684330.jpg,Bl122,4
11209.621894,11209.629894,1,voc,336288656,336288896,240,spec2/voc/Bl122_336288656.jpg,Bl122,4
12828.494025,12828.498025,1,voc,384854820,384854940,120,spec2/voc/Bl122_384854820.jpg,Bl122,4
7820.084748,7820.092748,1,voc,234602542,234602782,240,spec2/voc/Bl122_234602542.jpg,Bl122,4
6149.010349,6149.152349,1,voc,184470310,184474570,4260,spec2/voc/Bl122_184470310.jpg,Bl122,4
6137.616293,6137.626293,1,voc,184128488,184128788,300,spec2/voc/Bl122_184128488.jpg,Bl122,4
10958.111807,10958.128807,1,voc,328743354,328743864,510,spec2/voc/Bl122_328743354.jpg,Bl122,4
13580.656236,13580.843236,1,voc,407419687,407425297,5610,spec2/voc/Bl122_407419687.jpg,Bl122,4
11151.61118,11151.62318,1,voc,334548335,334548695,360,spec2/voc/Bl122_334548335.jpg,Bl122,4
3040.899833,3041.072833,1,voc,91226994,91232184,5190,spec2/voc/Bl122_91226994.jpg,Bl122,4
9065.437241,9065.455241,1,voc,271963117,271963657,540,spec2/voc/Bl122_271963117.jpg,Bl122,4
6050.8002,6050.8032,1,voc,181524006,181524096,90,spec2/voc/Bl122_181524006.jpg,Bl122,4
10931.412807,10931.415807,1,voc,327942384,327942474,90,spec2/voc/Bl122_327942384.jpg,Bl122,4
6003.096256,6003.100256,1,voc,180092887,180093007,120,spec2/voc/Bl122_180092887.jpg,Bl122,4
9028.603241,9028.612241,1,voc,270858097,270858367,270,spec2/voc/Bl122_270858097.jpg,Bl122,4
7934.033748,7934.037748,1,voc,238021012,238021132,120,spec2/voc/Bl122_238021012.jpg,Bl122,4
7860.608748,7860.632748,1,voc,235818262,235818982,720,spec2/voc/Bl122_235818262.jpg,Bl122,4
7973.802748,7973.827748,1,voc,239214082,239214832,750,spec2/voc/Bl122_239214082.jpg,Bl122,4
5937.214256,5937.218256,1,voc,178116427,178116547,120,spec2/voc/Bl122_178116427.jpg,Bl122,4
11189.48218,11189.50918,1,voc,335684465,335685275,810,spec2/voc/Bl122_335684465.jpg,Bl122,4
8912.921773,8912.965773,1,voc,267387653,267388973,1320,spec2/voc/Bl122_267387653.jpg,Bl122,4
6108.636706,6108.650706,1,voc,183259101,183259521,420,spec2/voc/Bl122_183259101.jpg,Bl122,4
10909.159807,10909.185807,1,voc,327274794,327275574,780,spec2/voc/Bl122_327274794.jpg,Bl122,4
5997.442256,5997.445256,1,voc,179923267,179923357,90,spec2/voc/Bl122_179923267.jpg,Bl122,4
6034.656533,6034.732533,1,voc,181039695,181041975,2280,spec2/voc/Bl122_181039695.jpg,Bl122,4
9062.803241,9062.808241,1,voc,271884097,271884247,150,spec2/voc/Bl122_271884097.jpg,Bl122,4
6034.135533,6034.155533,1,voc,181024065,181024665,600,spec2/voc/Bl122_181024065.jpg,Bl122,4
13156.603066,13156.617066,1,voc,394698091,394698511,420,spec2/voc/Bl122_394698091.jpg,Bl122,4
7978.001748,7978.007748,1,voc,239340052,239340232,180,spec2/voc/Bl122_239340052.jpg,Bl122,4
6018.784533,6018.790533,1,voc,180563535,180563715,180,spec2/voc/Bl122_180563535.jpg,Bl122,4
5960.717256,5960.727256,1,voc,178821517,178821817,300,spec2/voc/Bl122_178821517.jpg,Bl122,4
9030.242241,9030.252241,1,voc,270907267,270907567,300,spec2/voc/Bl122_270907267.jpg,Bl122,4
14149.649855,14149.652855,1,voc,424489495,424489585,90,spec2/voc/Bl122_424489495.jpg,Bl122,4
7949.029748,7949.032748,1,voc,238470892,238470982,90,spec2/voc/Bl122_238470892.jpg,Bl122,4
13207.581389,13207.583389,1,voc,396227441,396227501,60,spec2/voc/Bl122_396227441.jpg,Bl122,4
6099.66515,6099.68715,1,voc,182989954,182990614,660,spec2/voc/Bl122_182989954.jpg,Bl122,4
9098.297241,9098.305241,1,voc,272948917,272949157,240,spec2/voc/Bl122_272948917.jpg,Bl122,4
8016.887748,8016.896748,1,voc,240506632,240506902,270,spec2/voc/Bl122_240506632.jpg,Bl122,4
9151.634842,9151.643842,1,voc,274549045,274549315,270,spec2/voc/Bl122_274549045.jpg,Bl122,4
9063.006241,9063.058241,1,voc,271890187,271891747,1560,spec2/voc/Bl122_271890187.jpg,Bl122,4
10927.778807,10927.791807,1,voc,327833364,327833754,390,spec2/voc/Bl122_327833364.jpg,Bl122,4
6092.73915,6092.74315,1,voc,182782174,182782294,120,spec2/voc/Bl122_182782174.jpg,Bl122,4
13565.100867,13565.298867,1,voc,406953026,406958966,5940,spec2/voc/Bl122_406953026.jpg,Bl122,4
14809.332551,14809.334551,1,voc,444279976,444280036,60,spec2/voc/Bl122_444279976.jpg,Bl122,4
13824.68522,13824.68722,1,voc,414740556,414740616,60,spec2/voc/Bl122_414740556.jpg,Bl122,4
6105.426706,6105.441706,1,voc,183162801,183163251,450,spec2/voc/Bl122_183162801.jpg,Bl122,4
5957.666256,5957.673256,1,voc,178729987,178730197,210,spec2/voc/Bl122_178729987.jpg,Bl122,4
10925.804807,10925.857807,1,voc,327774144,327775734,1590,spec2/voc/Bl122_327774144.jpg,Bl122,4
14162.669897,14162.834897,1,voc,424880096,424885046,4950,spec2/voc/Bl122_424880096.jpg,Bl122,4
12638.689849,12638.692849,1,voc,379160695,379160785,90,spec2/voc/Bl122_379160695.jpg,Bl122,4
13582.087236,13582.106236,1,voc,407462617,407463187,570,spec2/voc/Bl122_407462617.jpg,Bl122,4
11174.55918,11174.67718,1,voc,335236775,335240315,3540,spec2/voc/Bl122_335236775.jpg,Bl122,4
6131.899293,6131.946293,1,voc,183956978,183958388,1410,spec2/voc/Bl122_183956978.jpg,Bl122,4
14792.550551,14792.553551,1,voc,443776516,443776606,90,spec2/voc/Bl122_443776516.jpg,Bl122,4
10915.123807,10915.138807,1,voc,327453714,327454164,450,spec2/voc/Bl122_327453714.jpg,Bl122,4
10960.820807,10960.993807,1,voc,328824624,328829814,5190,spec2/voc/Bl122_328824624.jpg,Bl122,4
14624.847569,14625.028569,1,voc,438745427,438750857,5430,spec2/voc/Bl122_438745427.jpg,Bl122,4
7853.569748,7853.591748,1,voc,235607092,235607752,660,spec2/voc/Bl122_235607092.jpg,Bl122,4
8023.269748,8023.273748,1,voc,240698092,240698212,120,spec2/voc/Bl122_240698092.jpg,Bl122,4
11127.590005,11127.595005,1,voc,333827700,333827850,150,spec2/voc/Bl122_333827700.jpg,Bl122,4
14791.637551,14791.641551,1,voc,443749126,443749246,120,spec2/voc/Bl122_443749126.jpg,Bl122,4
6160.039349,6160.045349,1,voc,184801180,184801360,180,spec2/voc/Bl122_184801180.jpg,Bl122,4
14802.305551,14802.862551,1,voc,444069166,444085876,16710,spec2/voc/Bl122_444069166.jpg,Bl122,4
11049.923,11050.093,1,voc,331497690,331502790,5100,spec2/voc/Bl122_331497690.jpg,Bl122,4
13173.098701,13173.134701,1,voc,395192961,395194041,1080,spec2/voc/Bl122_395192961.jpg,Bl122,4
8969.833712,8969.883712,1,voc,269095011,269096511,1500,spec2/voc/Bl122_269095011.jpg,Bl122,4
6017.761533,6017.770533,1,voc,180532845,180533115,270,spec2/voc/Bl122_180532845.jpg,Bl122,4
3863.114367,3863.216367,1,voc,115893431,115896491,3060,spec2/voc/Bl122_115893431.jpg,Bl122,4
3825.037649,3825.307649,1,voc,114751129,114759229,8100,spec2/voc/Bl122_114751129.jpg,Bl122,4
7907.186748,7907.205748,1,voc,237215602,237216172,570,spec2/voc/Bl122_237215602.jpg,Bl122,4
14820.748551,14820.792551,1,voc,444622456,444623776,1320,spec2/voc/Bl122_444622456.jpg,Bl122,4
7853.664748,7853.673748,1,voc,235609942,235610212,270,spec2/voc/Bl122_235609942.jpg,Bl122,4
10896.756557,10896.758557,1,voc,326902696,326902756,60,spec2/voc/Bl122_326902696.jpg,Bl122,4
10938.252807,10938.305807,1,voc,328147584,328149174,1590,spec2/voc/Bl122_328147584.jpg,Bl122,4
6099.98515,6100.24215,1,voc,182999554,183007264,7710,spec2/voc/Bl122_182999554.jpg,Bl122,4
10961.303807,10961.327807,1,voc,328839114,328839834,720,spec2/voc/Bl122_328839114.jpg,Bl122,4
5946.180256,5946.197256,1,voc,178385407,178385917,510,spec2/voc/Bl122_178385407.jpg,Bl122,4
6067.479705,6067.489705,1,voc,182024391,182024691,300,spec2/voc/Bl122_182024391.jpg,Bl122,4
9048.556241,9048.644241,1,voc,271456687,271459327,2640,spec2/voc/Bl122_271456687.jpg,Bl122,4
6037.494533,6037.510533,1,voc,181124835,181125315,480,spec2/voc/Bl122_181124835.jpg,Bl122,4
11190.86418,11190.88718,1,voc,335725925,335726615,690,spec2/voc/Bl122_335725925.jpg,Bl122,4
6014.874533,6014.909533,1,voc,180446235,180447285,1050,spec2/voc/Bl122_180446235.jpg,Bl122,4
7995.059748,7995.066748,1,voc,239851792,239852002,210,spec2/voc/Bl122_239851792.jpg,Bl122,4
8920.680773,8920.694773,1,voc,267620423,267620843,420,spec2/voc/Bl122_267620423.jpg,Bl122,4
14800.360551,14800.371551,1,voc,444010816,444011146,330,spec2/voc/Bl122_444010816.jpg,Bl122,4
7897.233748,7897.273748,1,voc,236917012,236918212,1200,spec2/voc/Bl122_236917012.jpg,Bl122,4
6138.445293,6138.447293,1,voc,184153358,184153418,60,spec2/voc/Bl122_184153358.jpg,Bl122,4
6069.008705,6069.074705,1,voc,182070261,182072241,1980,spec2/voc/Bl122_182070261.jpg,Bl122,4
11186.60218,11186.61218,1,voc,335598065,335598365,300,spec2/voc/Bl122_335598065.jpg,Bl122,4
8999.733241,8999.746241,1,voc,269991997,269992387,390,spec2/voc/Bl122_269991997.jpg,Bl122,4
10938.606807,10938.640807,1,voc,328158204,328159224,1020,spec2/voc/Bl122_328158204.jpg,Bl122,4
8367.569166,8367.580166,1,voc,251027074,251027404,330,spec2/voc/Bl122_251027074.jpg,Bl122,4
7978.071748,7978.073748,1,voc,239342152,239342212,60,spec2/voc/Bl122_239342152.jpg,Bl122,4
6097.79515,6097.82315,1,voc,182933854,182934694,840,spec2/voc/Bl122_182933854.jpg,Bl122,4
5314.872252,5315.095252,1,voc,159446167,159452857,6690,spec2/voc/Bl122_159446167.jpg,Bl122,4
6144.912349,6144.947349,1,voc,184347370,184348420,1050,spec2/voc/Bl122_184347370.jpg,Bl122,4
13959.822384,13959.829384,1,voc,418794671,418794881,210,spec2/voc/Bl122_418794671.jpg,Bl122,4
10856.047233,10856.269233,1,voc,325681416,325688076,6660,spec2/voc/Bl122_325681416.jpg,Bl122,4
6023.800533,6023.897533,1,voc,180714015,180716925,2910,spec2/voc/Bl122_180714015.jpg,Bl122,4
6051.7482,6051.7512,1,voc,181552446,181552536,90,spec2/voc/Bl122_181552446.jpg,Bl122,4
10959.593807,10959.785807,1,voc,328787814,328793574,5760,spec2/voc/Bl122_328787814.jpg,Bl122,4
5951.461256,5951.474256,1,voc,178543837,178544227,390,spec2/voc/Bl122_178543837.jpg,Bl122,4
13826.95422,13826.99122,1,voc,414808626,414809736,1110,spec2/voc/Bl122_414808626.jpg,Bl122,4
13951.999911,13952.195911,1,voc,418559997,418565877,5880,spec2/voc/Bl122_418559997.jpg,Bl122,4
11208.629894,11208.647894,1,voc,336258896,336259436,540,spec2/voc/Bl122_336258896.jpg,Bl122,4
10927.734807,10927.771807,1,voc,327832044,327833154,1110,spec2/voc/Bl122_327832044.jpg,Bl122,4
3818.154649,3818.181649,1,voc,114544639,114545449,810,spec2/voc/Bl122_114544639.jpg,Bl122,4
7901.321481,7901.713481,1,voc,237039644,237051404,11760,spec2/voc/Bl122_237039644.jpg,Bl122,4
6042.8412,6043.0362,1,voc,181285236,181291086,5850,spec2/voc/Bl122_181285236.jpg,Bl122,4
8035.239748,8035.246748,1,voc,241057192,241057402,210,spec2/voc/Bl122_241057192.jpg,Bl122,4
9002.410241,9002.456241,1,voc,270072307,270073687,1380,spec2/voc/Bl122_270072307.jpg,Bl122,4
14818.657551,14818.804551,1,voc,444559726,444564136,4410,spec2/voc/Bl122_444559726.jpg,Bl122,4
8943.994967,8944.090967,1,voc,268319849,268322729,2880,spec2/voc/Bl122_268319849.jpg,Bl122,4
5997.112256,5997.328256,1,voc,179913367,179919847,6480,spec2/voc/Bl122_179913367.jpg,Bl122,4
6017.457533,6017.625533,1,voc,180523725,180528765,5040,spec2/voc/Bl122_180523725.jpg,Bl122,4
13170.248701,13170.260701,1,voc,395107461,395107821,360,spec2/voc/Bl122_395107461.jpg,Bl122,4
14811.128551,14811.197551,1,voc,444333856,444335926,2070,spec2/voc/Bl122_444333856.jpg,Bl122,4
10929.590807,10929.759807,1,voc,327887724,327892794,5070,spec2/voc/Bl122_327887724.jpg,Bl122,4
10933.927807,10933.940807,1,voc,328017834,328018224,390,spec2/voc/Bl122_328017834.jpg,Bl122,4
9051.087241,9051.095241,1,voc,271532617,271532857,240,spec2/voc/Bl122_271532617.jpg,Bl122,4
8947.894967,8948.036967,1,voc,268436849,268441109,4260,spec2/voc/Bl122_268436849.jpg,Bl122,4
6148.206349,6148.268349,1,voc,184446190,184448050,1860,spec2/voc/Bl122_184446190.jpg,Bl122,4
9013.510241,9013.528241,1,voc,270405307,270405847,540,spec2/voc/Bl122_270405307.jpg,Bl122,4
11157.90118,11157.95718,1,voc,334737035,334738715,1680,spec2/voc/Bl122_334737035.jpg,Bl122,4
9069.605241,9069.609241,1,voc,272088157,272088277,120,spec2/voc/Bl122_272088157.jpg,Bl122,4
9083.038241,9083.091241,1,voc,272491147,272492737,1590,spec2/voc/Bl122_272491147.jpg,Bl122,4
8966.723712,8966.752712,1,voc,269001711,269002581,870,spec2/voc/Bl122_269001711.jpg,Bl122,4
5953.677256,5953.680256,1,voc,178610317,178610407,90,spec2/voc/Bl122_178610317.jpg,Bl122,4
6108.988706,6109.002706,1,voc,183269661,183270081,420,spec2/voc/Bl122_183269661.jpg,Bl122,4
11181.98018,11182.14118,1,voc,335459405,335464235,4830,spec2/voc/Bl122_335459405.jpg,Bl122,4
5995.337256,5995.374256,1,voc,179860117,179861227,1110,spec2/voc/Bl122_179860117.jpg,Bl122,4
10881.471609,10881.562609,1,voc,326444148,326446878,2730,spec2/voc/Bl122_326444148.jpg,Bl122,4
9085.794241,9085.845241,1,voc,272573827,272575357,1530,spec2/voc/Bl122_272573827.jpg,Bl122,4
5978.561256,5978.773256,1,voc,179356837,179363197,6360,spec2/voc/Bl122_179356837.jpg,Bl122,4
3866.341367,3866.757367,1,voc,115990241,116002721,12480,spec2/voc/Bl122_115990241.jpg,Bl122,4
11166.77718,11166.81218,1,voc,335003315,335004365,1050,spec2/voc/Bl122_335003315.jpg,Bl122,4
3813.772649,3814.007649,1,voc,114413179,114420229,7050,spec2/voc/Bl122_114413179.jpg,Bl122,4
9164.246604,9164.330604,1,voc,274927398,274929918,2520,spec2/voc/Bl122_274927398.jpg,Bl122,4
11188.94718,11188.99218,1,voc,335668415,335669765,1350,spec2/voc/Bl122_335668415.jpg,Bl122,4
10925.077807,10925.261807,1,voc,327752334,327757854,5520,spec2/voc/Bl122_327752334.jpg,Bl122,4
7920.097748,7920.099748,1,voc,237602932,237602992,60,spec2/voc/Bl122_237602932.jpg,Bl122,4
3894.242652,3894.269652,1,voc,116827279,116828089,810,spec2/voc/Bl122_116827279.jpg,Bl122,4
11168.04618,11168.06218,1,voc,335041385,335041865,480,spec2/voc/Bl122_335041385.jpg,Bl122,4
5943.789256,5943.801256,1,voc,178313677,178314037,360,spec2/voc/Bl122_178313677.jpg,Bl122,4
10909.385807,10909.397807,1,voc,327281574,327281934,360,spec2/voc/Bl122_327281574.jpg,Bl122,4
9074.037241,9074.045241,1,voc,272221117,272221357,240,spec2/voc/Bl122_272221117.jpg,Bl122,4
9060.530241,9060.543241,1,voc,271815907,271816297,390,spec2/voc/Bl122_271815907.jpg,Bl122,4
6106.114706,6106.181706,1,voc,183183441,183185451,2010,spec2/voc/Bl122_183183441.jpg,Bl122,4
6010.995533,6011.003533,1,voc,180329865,180330105,240,spec2/voc/Bl122_180329865.jpg,Bl122,4
14843.242682,14843.479682,1,voc,445297280,445304390,7110,spec2/voc/Bl122_445297280.jpg,Bl122,4
13956.298384,13956.323384,1,voc,418688951,418689701,750,spec2/voc/Bl122_418688951.jpg,Bl122,4
6108.212706,6108.218706,1,voc,183246381,183246561,180,spec2/voc/Bl122_183246381.jpg,Bl122,4
11144.815955,11145.139955,1,voc,334344478,334354198,9720,spec2/voc/Bl122_334344478.jpg,Bl122,4
6016.101533,6016.202533,1,voc,180483045,180486075,3030,spec2/voc/Bl122_180483045.jpg,Bl122,4
13201.324389,13201.375389,1,voc,396039731,396041261,1530,spec2/voc/Bl122_396039731.jpg,Bl122,4
9043.817241,9043.819241,1,voc,271314517,271314577,60,spec2/voc/Bl122_271314517.jpg,Bl122,4
9002.835241,9002.868241,1,voc,270085057,270086047,990,spec2/voc/Bl122_270085057.jpg,Bl122,4
5981.951256,5981.960256,1,voc,179458537,179458807,270,spec2/voc/Bl122_179458537.jpg,Bl122,4
13582.942236,13583.001236,1,voc,407488267,407490037,1770,spec2/voc/Bl122_407488267.jpg,Bl122,4
3846.548415,3846.557415,1,voc,115396452,115396722,270,spec2/voc/Bl122_115396452.jpg,Bl122,4
5941.304256,5941.423256,1,voc,178239127,178242697,3570,spec2/voc/Bl122_178239127.jpg,Bl122,4
8303.517054,8303.523054,1,voc,249105511,249105691,180,spec2/voc/Bl122_249105511.jpg,Bl122,4
13961.795384,13961.797384,1,voc,418853861,418853921,60,spec2/voc/Bl122_418853861.jpg,Bl122,4
13163.193891,13163.209891,1,voc,394895816,394896296,480,spec2/voc/Bl122_394895816.jpg,Bl122,4
13206.070389,13206.073389,1,voc,396182111,396182201,90,spec2/voc/Bl122_396182111.jpg,Bl122,4
5948.297256,5948.343256,1,voc,178448917,178450297,1380,spec2/voc/Bl122_178448917.jpg,Bl122,4
6170.039327,6170.048327,1,voc,185101179,185101449,270,spec2/voc/Bl122_185101179.jpg,Bl122,4
7984.094748,7984.130748,1,voc,239522842,239523922,1080,spec2/voc/Bl122_239522842.jpg,Bl122,4
12828.287025,12828.289025,1,voc,384848610,384848670,60,spec2/voc/Bl122_384848610.jpg,Bl122,4
7919.362748,7919.367748,1,voc,237580882,237581032,150,spec2/voc/Bl122_237580882.jpg,Bl122,4
6183.147327,6183.193327,1,voc,185494419,185495799,1380,spec2/voc/Bl122_185494419.jpg,Bl122,4
6024.764533,6024.825533,1,voc,180742935,180744765,1830,spec2/voc/Bl122_180742935.jpg,Bl122,4
5946.168256,5946.178256,1,voc,178385047,178385347,300,spec2/voc/Bl122_178385047.jpg,Bl122,4
3811.308649,3811.313649,1,voc,114339259,114339409,150,spec2/voc/Bl122_114339259.jpg,Bl122,4
13477.139365,13477.164365,1,voc,404314180,404314930,750,spec2/voc/Bl122_404314180.jpg,Bl122,4
8015.389748,8015.401748,1,voc,240461692,240462052,360,spec2/voc/Bl122_240461692.jpg,Bl122,4
6127.139706,6127.251706,1,voc,183814191,183817551,3360,spec2/voc/Bl122_183814191.jpg,Bl122,4
6131.693293,6131.741293,1,voc,183950798,183952238,1440,spec2/voc/Bl122_183950798.jpg,Bl122,4
3820.285649,3820.291649,1,voc,114608569,114608749,180,spec2/voc/Bl122_114608569.jpg,Bl122,4
9174.478287,9174.545287,1,voc,275234348,275236358,2010,spec2/voc/Bl122_275234348.jpg,Bl122,4
11124.502005,11124.506005,1,voc,333735060,333735180,120,spec2/voc/Bl122_333735060.jpg,Bl122,4
13988.834864,13988.883864,1,voc,419665045,419666515,1470,spec2/voc/Bl122_419665045.jpg,Bl122,4
13915.603392,13915.607392,1,voc,417468101,417468221,120,spec2/voc/Bl122_417468101.jpg,Bl122,4
14805.802551,14805.911551,1,voc,444174076,444177346,3270,spec2/voc/Bl122_444174076.jpg,Bl122,4
5960.107256,5960.110256,1,voc,178803217,178803307,90,spec2/voc/Bl122_178803217.jpg,Bl122,4
13947.328911,13947.347911,1,voc,418419867,418420437,570,spec2/voc/Bl122_418419867.jpg,Bl122,4
5962.783256,5962.789256,1,voc,178883497,178883677,180,spec2/voc/Bl122_178883497.jpg,Bl122,4
8980.360025,8980.386025,1,voc,269410800,269411580,780,spec2/voc/Bl122_269410800.jpg,Bl122,4
5946.220256,5946.351256,1,voc,178386607,178390537,3930,spec2/voc/Bl122_178386607.jpg,Bl122,4
14809.108551,14809.113551,1,voc,444273256,444273406,150,spec2/voc/Bl122_444273256.jpg,Bl122,4
6090.01515,6090.05315,1,voc,182700454,182701594,1140,spec2/voc/Bl122_182700454.jpg,Bl122,4
5981.220256,5981.226256,1,voc,179436607,179436787,180,spec2/voc/Bl122_179436607.jpg,Bl122,4
9152.870842,9152.875842,1,voc,274586125,274586275,150,spec2/voc/Bl122_274586125.jpg,Bl122,4
7937.186748,7937.192748,1,voc,238115602,238115782,180,spec2/voc/Bl122_238115602.jpg,Bl122,4
6204.621327,6204.631327,1,voc,186138639,186138939,300,spec2/voc/Bl122_186138639.jpg,Bl122,4
8946.966967,8946.992967,1,voc,268409009,268409789,780,spec2/voc/Bl122_268409009.jpg,Bl122,4
13733.363497,13733.366497,1,voc,412000904,412000994,90,spec2/voc/Bl122_412000904.jpg,Bl122,4
3800.397649,3800.483649,1,voc,114011929,114014509,2580,spec2/voc/Bl122_114011929.jpg,Bl122,4
12594.847868,12595.007868,1,voc,377845436,377850236,4800,spec2/voc/Bl122_377845436.jpg,Bl122,4
7932.413748,7932.418748,1,voc,237972412,237972562,150,spec2/voc/Bl122_237972412.jpg,Bl122,4
13732.354497,13732.360497,1,voc,411970634,411970814,180,spec2/voc/Bl122_411970634.jpg,Bl122,4
13583.550236,13583.554236,1,voc,407506507,407506627,120,spec2/voc/Bl122_407506507.jpg,Bl122,4
6169.527327,6169.535327,1,voc,185085819,185086059,240,spec2/voc/Bl122_185085819.jpg,Bl122,4
13600.613736,13600.623736,1,voc,408018412,408018712,300,spec2/voc/Bl122_408018412.jpg,Bl122,4
9090.733241,9090.738241,1,voc,272721997,272722147,150,spec2/voc/Bl122_272721997.jpg,Bl122,4
10959.502807,10959.535807,1,voc,328785084,328786074,990,spec2/voc/Bl122_328785084.jpg,Bl122,4
7868.912748,7868.916748,1,voc,236067382,236067502,120,spec2/voc/Bl122_236067382.jpg,Bl122,4
6058.820705,6058.827705,1,voc,181764621,181764831,210,spec2/voc/Bl122_181764621.jpg,Bl122,4
7952.860821,7952.930821,1,voc,238585824,238587924,2100,spec2/voc/Bl122_238585824.jpg,Bl122,4
7882.963748,7882.965748,1,voc,236488912,236488972,60,spec2/voc/Bl122_236488912.jpg,Bl122,4
7975.213748,7975.239748,1,voc,239256412,239257192,780,spec2/voc/Bl122_239256412.jpg,Bl122,4
11193.17418,11193.26218,1,voc,335795225,335797865,2640,spec2/voc/Bl122_335795225.jpg,Bl122,4
9088.124241,9088.132241,1,voc,272643727,272643967,240,spec2/voc/Bl122_272643727.jpg,Bl122,4
5935.836256,5935.904256,1,voc,178075087,178077127,2040,spec2/voc/Bl122_178075087.jpg,Bl122,4
8033.202748,8033.210748,1,voc,240996082,240996322,240,spec2/voc/Bl122_240996082.jpg,Bl122,4
6040.953065,6040.961065,1,voc,181228591,181228831,240,spec2/voc/Bl122_181228591.jpg,Bl122,4
8943.520967,8943.848967,1,voc,268305629,268315469,9840,spec2/voc/Bl122_268305629.jpg,Bl122,4
11210.273894,11210.301894,1,voc,336308216,336309056,840,spec2/voc/Bl122_336308216.jpg,Bl122,4
5938.323256,5938.376256,1,voc,178149697,178151287,1590,spec2/voc/Bl122_178149697.jpg,Bl122,4
3852.462415,3852.548415,1,voc,115573872,115576452,2580,spec2/voc/Bl122_115573872.jpg,Bl122,4
5963.419256,5963.478256,1,voc,178902577,178904347,1770,spec2/voc/Bl122_178902577.jpg,Bl122,4
7844.584748,7844.601748,1,voc,235337542,235338052,510,spec2/voc/Bl122_235337542.jpg,Bl122,4
13221.276389,13221.287389,1,voc,396638291,396638621,330,spec2/voc/Bl122_396638291.jpg,Bl122,4
9013.276241,9013.354241,1,voc,270398287,270400627,2340,spec2/voc/Bl122_270398287.jpg,Bl122,4
9031.456241,9031.459241,1,voc,270943687,270943777,90,spec2/voc/Bl122_270943687.jpg,Bl122,4
14815.588551,14815.591551,1,voc,444467656,444467746,90,spec2/voc/Bl122_444467656.jpg,Bl122,4
5967.449256,5967.507256,1,voc,179023477,179025217,1740,spec2/voc/Bl122_179023477.jpg,Bl122,4
9049.475241,9049.485241,1,voc,271484257,271484557,300,spec2/voc/Bl122_271484257.jpg,Bl122,4
5941.295256,5941.301256,1,voc,178238857,178239037,180,spec2/voc/Bl122_178238857.jpg,Bl122,4
13163.866891,13163.882891,1,voc,394916006,394916486,480,spec2/voc/Bl122_394916006.jpg,Bl122,4
7976.887748,7976.894748,1,voc,239306632,239306842,210,spec2/voc/Bl122_239306632.jpg,Bl122,4
5970.994256,5970.998256,1,voc,179129827,179129947,120,spec2/voc/Bl122_179129827.jpg,Bl122,4
3840.504415,3840.507415,1,voc,115215132,115215222,90,spec2/voc/Bl122_115215132.jpg,Bl122,4
10846.065344,10846.069344,1,voc,325381960,325382080,120,spec2/voc/Bl122_325381960.jpg,Bl122,4
7803.338748,7803.343748,1,voc,234100162,234100312,150,spec2/voc/Bl122_234100162.jpg,Bl122,4
11145.151955,11145.176955,1,voc,334354558,334355308,750,spec2/voc/Bl122_334354558.jpg,Bl122,4
6091.46915,6091.47415,1,voc,182744074,182744224,150,spec2/voc/Bl122_182744074.jpg,Bl122,4
8038.924748,8038.927748,1,voc,241167742,241167832,90,spec2/voc/Bl122_241167742.jpg,Bl122,4
9098.307241,9098.317241,1,voc,272949217,272949517,300,spec2/voc/Bl122_272949217.jpg,Bl122,4
7876.307748,7876.329748,1,voc,236289232,236289892,660,spec2/voc/Bl122_236289232.jpg,Bl122,4
11157.77518,11157.89018,1,voc,334733255,334736705,3450,spec2/voc/Bl122_334733255.jpg,Bl122,4
14791.736551,14791.756551,1,voc,443752096,443752696,600,spec2/voc/Bl122_443752096.jpg,Bl122,4
8954.817967,8954.903967,1,voc,268644539,268647119,2580,spec2/voc/Bl122_268644539.jpg,Bl122,4
10834.661086,10835.193086,1,voc,325039832,325055792,15960,spec2/voc/Bl122_325039832.jpg,Bl122,4
10965.166807,10965.169807,1,voc,328955004,328955094,90,spec2/voc/Bl122_328955004.jpg,Bl122,4
7970.096748,7970.123748,1,voc,239102902,239103712,810,spec2/voc/Bl122_239102902.jpg,Bl122,4
6084.70815,6084.72015,1,voc,182541244,182541604,360,spec2/voc/Bl122_182541244.jpg,Bl122,4
12592.462947,12592.465947,1,voc,377773888,377773978,90,spec2/voc/Bl122_377773888.jpg,Bl122,4
9065.972241,9065.980241,1,voc,271979167,271979407,240,spec2/voc/Bl122_271979167.jpg,Bl122,4
9071.956241,9071.961241,1,voc,272158687,272158837,150,spec2/voc/Bl122_272158687.jpg,Bl122,4
13222.249389,13222.331389,1,voc,396667481,396669941,2460,spec2/voc/Bl122_396667481.jpg,Bl122,4
8039.635748,8039.645748,1,voc,241189072,241189372,300,spec2/voc/Bl122_241189072.jpg,Bl122,4
13927.795536,13927.889536,1,voc,417833866,417836686,2820,spec2/voc/Bl122_417833866.jpg,Bl122,4
12596.696038,12596.889038,1,voc,377900881,377906671,5790,spec2/voc/Bl122_377900881.jpg,Bl122,4
7931.995748,7932.025748,1,voc,237959872,237960772,900,spec2/voc/Bl122_237959872.jpg,Bl122,4
10911.276807,10911.380807,1,voc,327338304,327341424,3120,spec2/voc/Bl122_327338304.jpg,Bl122,4
14008.3306,14008.5426,1,voc,420249918,420256278,6360,spec2/voc/Bl122_420249918.jpg,Bl122,4
11156.32618,11156.34118,1,voc,334689785,334690235,450,spec2/voc/Bl122_334689785.jpg,Bl122,4
3844.898415,3844.904415,1,voc,115346952,115347132,180,spec2/voc/Bl122_115346952.jpg,Bl122,4
9151.590842,9151.609842,1,voc,274547725,274548295,570,spec2/voc/Bl122_274547725.jpg,Bl122,4
6113.432706,6113.441706,1,voc,183402981,183403251,270,spec2/voc/Bl122_183402981.jpg,Bl122,4
3826.855649,3826.892649,1,voc,114805669,114806779,1110,spec2/voc/Bl122_114805669.jpg,Bl122,4
10938.825807,10938.833807,1,voc,328164774,328165014,240,spec2/voc/Bl122_328164774.jpg,Bl122,4
14821.116551,14821.282551,1,voc,444633496,444638476,4980,spec2/voc/Bl122_444633496.jpg,Bl122,4
8041.081748,8041.093748,1,voc,241232452,241232812,360,spec2/voc/Bl122_241232452.jpg,Bl122,4
5946.059256,5946.090256,1,voc,178381777,178382707,930,spec2/voc/Bl122_178381777.jpg,Bl122,4
9071.855241,9071.859241,1,voc,272155657,272155777,120,spec2/voc/Bl122_272155657.jpg,Bl122,4
10909.339807,10909.379807,1,voc,327280194,327281394,1200,spec2/voc/Bl122_327280194.jpg,Bl122,4
6029.666533,6029.682533,1,voc,180889995,180890475,480,spec2/voc/Bl122_180889995.jpg,Bl122,4
5958.457256,5958.532256,1,voc,178753717,178755967,2250,spec2/voc/Bl122_178753717.jpg,Bl122,4
13988.554864,13988.562864,1,voc,419656645,419656885,240,spec2/voc/Bl122_419656645.jpg,Bl122,4
11208.252894,11208.275894,1,voc,336247586,336248276,690,spec2/voc/Bl122_336247586.jpg,Bl122,4
9062.011241,9062.018241,1,voc,271860337,271860547,210,spec2/voc/Bl122_271860337.jpg,Bl122,4
10914.963807,10914.970807,1,voc,327448914,327449124,210,spec2/voc/Bl122_327448914.jpg,Bl122,4
6013.333533,6013.338533,1,voc,180400005,180400155,150,spec2/voc/Bl122_180400005.jpg,Bl122,4
14784.200465,14784.207465,1,voc,443526013,443526223,210,spec2/voc/Bl122_443526013.jpg,Bl122,4
10940.396807,10940.400807,1,voc,328211904,328212024,120,spec2/voc/Bl122_328211904.jpg,Bl122,4
6178.865327,6178.891327,1,voc,185365959,185366739,780,spec2/voc/Bl122_185365959.jpg,Bl122,4
10940.493807,10940.538807,1,voc,328214814,328216164,1350,spec2/voc/Bl122_328214814.jpg,Bl122,4
14710.507469,14710.512469,1,voc,441315224,441315374,150,spec2/voc/Bl122_441315224.jpg,Bl122,4
3810.561649,3810.583649,1,voc,114316849,114317509,660,spec2/voc/Bl122_114316849.jpg,Bl122,4
3844.956415,3845.045415,1,voc,115348692,115351362,2670,spec2/voc/Bl122_115348692.jpg,Bl122,4
8922.211773,8922.259773,1,voc,267666353,267667793,1440,spec2/voc/Bl122_267666353.jpg,Bl122,4
6126.311706,6126.453706,1,voc,183789351,183793611,4260,spec2/voc/Bl122_183789351.jpg,Bl122,4
9050.327241,9050.338241,1,voc,271509817,271510147,330,spec2/voc/Bl122_271509817.jpg,Bl122,4
7945.437748,7945.440748,1,voc,238363132,238363222,90,spec2/voc/Bl122_238363132.jpg,Bl122,4
7927.897748,7927.907748,1,voc,237836932,237837232,300,spec2/voc/Bl122_237836932.jpg,Bl122,4
13156.063066,13156.074066,1,voc,394681891,394682221,330,spec2/voc/Bl122_394681891.jpg,Bl122,4
8304.097054,8304.159054,1,voc,249122911,249124771,1860,spec2/voc/Bl122_249122911.jpg,Bl122,4
9007.411241,9007.435241,1,voc,270222337,270223057,720,spec2/voc/Bl122_270222337.jpg,Bl122,4
10957.016807,10957.052807,1,voc,328710504,328711584,1080,spec2/voc/Bl122_328710504.jpg,Bl122,4
6200.570327,6200.572327,1,voc,186017109,186017169,60,spec2/voc/Bl122_186017109.jpg,Bl122,4
9037.615241,9037.644241,1,voc,271128457,271129327,870,spec2/voc/Bl122_271128457.jpg,Bl122,4
8916.099773,8916.139773,1,voc,267482993,267484193,1200,spec2/voc/Bl122_267482993.jpg,Bl122,4
3816.299649,3816.326649,1,voc,114488989,114489799,810,spec2/voc/Bl122_114488989.jpg,Bl122,4
10945.507807,10945.518807,1,voc,328365234,328365564,330,spec2/voc/Bl122_328365234.jpg,Bl122,4
14149.299855,14149.305855,1,voc,424478995,424479175,180,spec2/voc/Bl122_424478995.jpg,Bl122,4
13223.317389,13223.319389,1,voc,396699521,396699581,60,spec2/voc/Bl122_396699521.jpg,Bl122,4
7974.349748,7974.370748,1,voc,239230492,239231122,630,spec2/voc/Bl122_239230492.jpg,Bl122,4
7985.510748,7985.668748,1,voc,239565322,239570062,4740,spec2/voc/Bl122_239565322.jpg,Bl122,4
8319.390436,8319.541436,1,voc,249581713,249586243,4530,spec2/voc/Bl122_249581713.jpg,Bl122,4
14201.725387,14201.728387,1,voc,426051761,426051851,90,spec2/voc/Bl122_426051761.jpg,Bl122,4
11131.963005,11132.078005,1,voc,333958890,333962340,3450,spec2/voc/Bl122_333958890.jpg,Bl122,4
6109.019706,6109.105706,1,voc,183270591,183273171,2580,spec2/voc/Bl122_183270591.jpg,Bl122,4
13187.844662,13187.850662,1,voc,395635339,395635519,180,spec2/voc/Bl122_395635339.jpg,Bl122,4
6123.843706,6123.883706,1,voc,183715311,183716511,1200,spec2/voc/Bl122_183715311.jpg,Bl122,4
12626.711577,12626.933577,1,voc,378801347,378808007,6660,spec2/voc/Bl122_378801347.jpg,Bl122,4
9098.834241,9098.842241,1,voc,272965027,272965267,240,spec2/voc/Bl122_272965027.jpg,Bl122,4
13160.990891,13161.007891,1,voc,394829726,394830236,510,spec2/voc/Bl122_394829726.jpg,Bl122,4
13744.433896,13744.500896,1,voc,412333016,412335026,2010,spec2/voc/Bl122_412333016.jpg,Bl122,4
10950.323807,10950.328807,1,voc,328509714,328509864,150,spec2/voc/Bl122_328509714.jpg,Bl122,4
6153.040349,6153.092349,1,voc,184591210,184592770,1560,spec2/voc/Bl122_184591210.jpg,Bl122,4
5986.284256,5986.380256,1,voc,179588527,179591407,2880,spec2/voc/Bl122_179588527.jpg,Bl122,4
13599.195736,13599.197736,1,voc,407975872,407975932,60,spec2/voc/Bl122_407975872.jpg,Bl122,4
3889.453652,3889.477652,1,voc,116683609,116684329,720,spec2/voc/Bl122_116683609.jpg,Bl122,4
9048.965241,9048.991241,1,voc,271468957,271469737,780,spec2/voc/Bl122_271468957.jpg,Bl122,4
6138.700293,6138.725293,1,voc,184161008,184161758,750,spec2/voc/Bl122_184161008.jpg,Bl122,4
14823.369551,14823.506551,1,voc,444701086,444705196,4110,spec2/voc/Bl122_444701086.jpg,Bl122,4
6081.291511,6081.298511,1,voc,182438745,182438955,210,spec2/voc/Bl122_182438745.jpg,Bl122,4
13975.950117,13975.955117,1,voc,419278503,419278653,150,spec2/voc/Bl122_419278503.jpg,Bl122,4
13208.537389,13208.542389,1,voc,396256121,396256271,150,spec2/voc/Bl122_396256121.jpg,Bl122,4
6113.444706,6113.448706,1,voc,183403341,183403461,120,spec2/voc/Bl122_183403341.jpg,Bl122,4
9095.963241,9095.972241,1,voc,272878897,272879167,270,spec2/voc/Bl122_272878897.jpg,Bl122,4
13201.909389,13201.911389,1,voc,396057281,396057341,60,spec2/voc/Bl122_396057281.jpg,Bl122,4
13163.566891,13163.570891,1,voc,394907006,394907126,120,spec2/voc/Bl122_394907006.jpg,Bl122,4
14817.149551,14817.166551,1,voc,444514486,444514996,510,spec2/voc/Bl122_444514486.jpg,Bl122,4
7977.246748,7977.254748,1,voc,239317402,239317642,240,spec2/voc/Bl122_239317402.jpg,Bl122,4
13939.1519,13939.1559,1,voc,418174557,418174677,120,spec2/voc/Bl122_418174557.jpg,Bl122,4
6073.816705,6073.927705,1,voc,182214501,182217831,3330,spec2/voc/Bl122_182214501.jpg,Bl122,4
11211.104894,11211.135894,1,voc,336333146,336334076,930,spec2/voc/Bl122_336333146.jpg,Bl122,4
7853.325748,7853.350748,1,voc,235599772,235600522,750,spec2/voc/Bl122_235599772.jpg,Bl122,4
3877.546848,3877.655848,1,voc,116326405,116329675,3270,spec2/voc/Bl122_116326405.jpg,Bl122,4
11171.30318,11171.41218,1,voc,335139095,335142365,3270,spec2/voc/Bl122_335139095.jpg,Bl122,4
13817.719617,13817.812617,1,voc,414531588,414534378,2790,spec2/voc/Bl122_414531588.jpg,Bl122,4
7850.743748,7850.749748,1,voc,235522312,235522492,180,spec2/voc/Bl122_235522312.jpg,Bl122,4
6124.879706,6124.911706,1,voc,183746391,183747351,960,spec2/voc/Bl122_183746391.jpg,Bl122,4
6022.513533,6022.856533,1,voc,180675405,180685695,10290,spec2/voc/Bl122_180675405.jpg,Bl122,4
10932.869807,10932.882807,1,voc,327986094,327986484,390,spec2/voc/Bl122_327986094.jpg,Bl122,4
9062.755241,9062.780241,1,voc,271882657,271883407,750,spec2/voc/Bl122_271882657.jpg,Bl122,4
13829.793664,13830.008664,1,voc,414893809,414900259,6450,spec2/voc/Bl122_414893809.jpg,Bl122,4
13207.829389,13207.834389,1,voc,396234881,396235031,150,spec2/voc/Bl122_396234881.jpg,Bl122,4
10918.037807,10918.042807,1,voc,327541134,327541284,150,spec2/voc/Bl122_327541134.jpg,Bl122,4
9082.319241,9082.509241,1,voc,272469577,272475277,5700,spec2/voc/Bl122_272469577.jpg,Bl122,4
6143.250349,6143.285349,1,voc,184297510,184298560,1050,spec2/voc/Bl122_184297510.jpg,Bl122,4
14844.047682,14844.056682,1,voc,445321430,445321700,270,spec2/voc/Bl122_445321430.jpg,Bl122,4
12627.487577,12627.491577,1,voc,378824627,378824747,120,spec2/voc/Bl122_378824627.jpg,Bl122,4
13816.345617,13816.474617,1,voc,414490368,414494238,3870,spec2/voc/Bl122_414490368.jpg,Bl122,4
11197.67418,11197.68218,1,voc,335930225,335930465,240,spec2/voc/Bl122_335930225.jpg,Bl122,4
7817.836748,7817.841748,1,voc,234535102,234535252,150,spec2/voc/Bl122_234535102.jpg,Bl122,4
5938.656256,5938.663256,1,voc,178159687,178159897,210,spec2/voc/Bl122_178159687.jpg,Bl122,4
14843.212682,14843.236682,1,voc,445296380,445297100,720,spec2/voc/Bl122_445296380.jpg,Bl122,4
9031.153241,9031.174241,1,voc,270934597,270935227,630,spec2/voc/Bl122_270934597.jpg,Bl122,4
9090.024241,9090.049241,1,voc,272700727,272701477,750,spec2/voc/Bl122_272700727.jpg,Bl122,4
6183.624327,6183.781327,1,voc,185508729,185513439,4710,spec2/voc/Bl122_185508729.jpg,Bl122,4
14794.886551,14794.977551,1,voc,443846596,443849326,2730,spec2/voc/Bl122_443846596.jpg,Bl122,4
6107.912706,6107.932706,1,voc,183237381,183237981,600,spec2/voc/Bl122_183237381.jpg,Bl122,4
14822.019551,14822.045551,1,voc,444660586,444661366,780,spec2/voc/Bl122_444660586.jpg,Bl122,4
12933.03229,12933.09329,1,voc,387990968,387992798,1830,spec2/voc/Bl122_387990968.jpg,Bl122,4
9046.810241,9046.954241,1,voc,271404307,271408627,4320,spec2/voc/Bl122_271404307.jpg,Bl122,4
6135.874293,6135.969293,1,voc,184076228,184079078,2850,spec2/voc/Bl122_184076228.jpg,Bl122,4
5939.898256,5939.927256,1,voc,178196947,178197817,870,spec2/voc/Bl122_178196947.jpg,Bl122,4
3886.403062,3886.416062,1,voc,116592091,116592481,390,spec2/voc/Bl122_116592091.jpg,Bl122,4
7851.534748,7851.536748,1,voc,235546042,235546102,60,spec2/voc/Bl122_235546042.jpg,Bl122,4
7998.605748,7998.614748,1,voc,239958172,239958442,270,spec2/voc/Bl122_239958172.jpg,Bl122,4
14334.787707,14334.789707,1,voc,430043631,430043691,60,spec2/voc/Bl122_430043631.jpg,Bl122,4
9073.617241,9073.633241,1,voc,272208517,272208997,480,spec2/voc/Bl122_272208517.jpg,Bl122,4
6182.994327,6183.032327,1,voc,185489829,185490969,1140,spec2/voc/Bl122_185489829.jpg,Bl122,4
3797.325649,3797.564649,1,voc,113919769,113926939,7170,spec2/voc/Bl122_113919769.jpg,Bl122,4
7985.877748,7985.883748,1,voc,239576332,239576512,180,spec2/voc/Bl122_239576332.jpg,Bl122,4
13581.692236,13581.694236,1,voc,407450767,407450827,60,spec2/voc/Bl122_407450767.jpg,Bl122,4
3893.241652,3893.511652,1,voc,116797249,116805349,8100,spec2/voc/Bl122_116797249.jpg,Bl122,4
6132.540293,6132.573293,1,voc,183976208,183977198,990,spec2/voc/Bl122_183976208.jpg,Bl122,4
8026.019748,8026.027748,1,voc,240780592,240780832,240,spec2/voc/Bl122_240780592.jpg,Bl122,4
13962.574384,13962.581384,1,voc,418877231,418877441,210,spec2/voc/Bl122_418877231.jpg,Bl122,4
6197.781327,6197.806327,1,voc,185933439,185934189,750,spec2/voc/Bl122_185933439.jpg,Bl122,4
9067.748241,9067.760241,1,voc,272032447,272032807,360,spec2/voc/Bl122_272032447.jpg,Bl122,4
14824.558551,14824.564551,1,voc,444736756,444736936,180,spec2/voc/Bl122_444736756.jpg,Bl122,4
11915.494799,11915.560799,1,voc,357464843,357466823,1980,spec2/voc/Bl122_357464843.jpg,Bl122,4
13204.529389,13204.547389,1,voc,396135881,396136421,540,spec2/voc/Bl122_396135881.jpg,Bl122,4
11134.308005,11134.487005,1,voc,334029240,334034610,5370,spec2/voc/Bl122_334029240.jpg,Bl122,4
6226.145295,6226.356295,1,voc,186784358,186790688,6330,spec2/voc/Bl122_186784358.jpg,Bl122,4
3850.416415,3850.426415,1,voc,115512492,115512792,300,spec2/voc/Bl122_115512492.jpg,Bl122,4
11135.580005,11135.584005,1,voc,334067400,334067520,120,spec2/voc/Bl122_334067400.jpg,Bl122,4
7952.604821,7952.848821,1,voc,238578144,238585464,7320,spec2/voc/Bl122_238578144.jpg,Bl122,4
3820.301649,3820.479649,1,voc,114609049,114614389,5340,spec2/voc/Bl122_114609049.jpg,Bl122,4
13983.889943,13983.896943,1,voc,419516698,419516908,210,spec2/voc/Bl122_419516698.jpg,Bl122,4
7840.589748,7840.605748,1,voc,235217692,235218172,480,spec2/voc/Bl122_235217692.jpg,Bl122,4
6137.311293,6137.337293,1,voc,184119338,184120118,780,spec2/voc/Bl122_184119338.jpg,Bl122,4
9169.312604,9169.344604,1,voc,275079378,275080338,960,spec2/voc/Bl122_275079378.jpg,Bl122,4
7985.385748,7985.507748,1,voc,239561572,239565232,3660,spec2/voc/Bl122_239561572.jpg,Bl122,4
5935.228256,5935.253256,1,voc,178056847,178057597,750,spec2/voc/Bl122_178056847.jpg,Bl122,4
6124.082706,6124.228706,1,voc,183722481,183726861,4380,spec2/voc/Bl122_183722481.jpg,Bl122,4
5994.666256,5994.689256,1,voc,179839987,179840677,690,spec2/voc/Bl122_179839987.jpg,Bl122,4
13206.325389,13206.329389,1,voc,396189761,396189881,120,spec2/voc/Bl122_396189761.jpg,Bl122,4
14836.629682,14836.797682,1,voc,445098890,445103930,5040,spec2/voc/Bl122_445098890.jpg,Bl122,4
14841.341682,14841.368682,1,voc,445240250,445241060,810,spec2/voc/Bl122_445240250.jpg,Bl122,4
9125.162182,9125.166182,1,voc,273754865,273754985,120,spec2/voc/Bl122_273754865.jpg,Bl122,4
9096.026241,9096.032241,1,voc,272880787,272880967,180,spec2/voc/Bl122_272880787.jpg,Bl122,4
3809.078649,3809.273649,1,voc,114272359,114278209,5850,spec2/voc/Bl122_114272359.jpg,Bl122,4
5987.559256,5987.574256,1,voc,179626777,179627227,450,spec2/voc/Bl122_179626777.jpg,Bl122,4
11160.49618,11160.49918,1,voc,334814885,334814975,90,spec2/voc/Bl122_334814885.jpg,Bl122,4
7862.024748,7862.056748,1,voc,235860742,235861702,960,spec2/voc/Bl122_235860742.jpg,Bl122,4
7935.297748,7935.300748,1,voc,238058932,238059022,90,spec2/voc/Bl122_238058932.jpg,Bl122,4
8992.020241,8992.077241,1,voc,269760607,269762317,1710,spec2/voc/Bl122_269760607.jpg,Bl122,4
9081.133241,9081.136241,1,voc,272433997,272434087,90,spec2/voc/Bl122_272433997.jpg,Bl122,4
9048.696241,9048.731241,1,voc,271460887,271461937,1050,spec2/voc/Bl122_271460887.jpg,Bl122,4
11189.64818,11189.69018,1,voc,335689445,335690705,1260,spec2/voc/Bl122_335689445.jpg,Bl122,4
11141.789955,11141.807955,1,voc,334253698,334254238,540,spec2/voc/Bl122_334253698.jpg,Bl122,4
9169.474604,9169.507604,1,voc,275084238,275085228,990,spec2/voc/Bl122_275084238.jpg,Bl122,4
12672.965513,12673.006513,1,voc,380188965,380190195,1230,spec2/voc/Bl122_380188965.jpg,Bl122,4
14801.643551,14801.663551,1,voc,444049306,444049906,600,spec2/voc/Bl122_444049306.jpg,Bl122,4
6138.487293,6138.519293,1,voc,184154618,184155578,960,spec2/voc/Bl122_184154618.jpg,Bl122,4
6146.112349,6146.276349,1,voc,184383370,184388290,4920,spec2/voc/Bl122_184383370.jpg,Bl122,4
10935.971807,10935.994807,1,voc,328079154,328079844,690,spec2/voc/Bl122_328079154.jpg,Bl122,4
6171.128327,6171.153327,1,voc,185133849,185134599,750,spec2/voc/Bl122_185133849.jpg,Bl122,4
6035.097533,6035.227533,1,voc,181052925,181056825,3900,spec2/voc/Bl122_181052925.jpg,Bl122,4
10964.656807,10964.659807,1,voc,328939704,328939794,90,spec2/voc/Bl122_328939704.jpg,Bl122,4
13949.054911,13949.058911,1,voc,418471647,418471767,120,spec2/voc/Bl122_418471647.jpg,Bl122,4
8980.643025,8980.652025,1,voc,269419290,269419560,270,spec2/voc/Bl122_269419290.jpg,Bl122,4
11148.44818,11148.45318,1,voc,334453445,334453595,150,spec2/voc/Bl122_334453445.jpg,Bl122,4
6015.388533,6015.391533,1,voc,180461655,180461745,90,spec2/voc/Bl122_180461655.jpg,Bl122,4
11178.70218,11178.72118,1,voc,335361065,335361635,570,spec2/voc/Bl122_335361065.jpg,Bl122,4
8011.572748,8011.582748,1,voc,240347182,240347482,300,spec2/voc/Bl122_240347182.jpg,Bl122,4
14835.858682,14836.033682,1,voc,445075760,445081010,5250,spec2/voc/Bl122_445075760.jpg,Bl122,4
5943.353256,5943.378256,1,voc,178300597,178301347,750,spec2/voc/Bl122_178300597.jpg,Bl122,4
7984.055748,7984.061748,1,voc,239521672,239521852,180,spec2/voc/Bl122_239521672.jpg,Bl122,4
14801.824551,14801.833551,1,voc,444054736,444055006,270,spec2/voc/Bl122_444054736.jpg,Bl122,4
5945.483256,5945.491256,1,voc,178364497,178364737,240,spec2/voc/Bl122_178364497.jpg,Bl122,4
5942.633256,5942.658256,1,voc,178278997,178279747,750,spec2/voc/Bl122_178278997.jpg,Bl122,4
8019.948748,8019.952748,1,voc,240598462,240598582,120,spec2/voc/Bl122_240598462.jpg,Bl122,4
13477.166365,13477.301365,1,voc,404314990,404319040,4050,spec2/voc/Bl122_404314990.jpg,Bl122,4
3804.029649,3804.033649,1,voc,114120889,114121009,120,spec2/voc/Bl122_114120889.jpg,Bl122,4
13808.323653,13808.448653,1,voc,414249709,414253459,3750,spec2/voc/Bl122_414249709.jpg,Bl122,4
10951.036807,10951.080807,1,voc,328531104,328532424,1320,spec2/voc/Bl122_328531104.jpg,Bl122,4
7933.134748,7933.139748,1,voc,237994042,237994192,150,spec2/voc/Bl122_237994042.jpg,Bl122,4
13743.295896,13743.306896,1,voc,412298876,412299206,330,spec2/voc/Bl122_412298876.jpg,Bl122,4
11177.59918,11177.71218,1,voc,335327975,335331365,3390,spec2/voc/Bl122_335327975.jpg,Bl122,4
6037.841533,6037.982533,1,voc,181135245,181139475,4230,spec2/voc/Bl122_181135245.jpg,Bl122,4
13176.653701,13176.655701,1,voc,395299611,395299671,60,spec2/voc/Bl122_395299611.jpg,Bl122,4
13191.227662,13191.282662,1,voc,395736829,395738479,1650,spec2/voc/Bl122_395736829.jpg,Bl122,4
6090.88615,6090.90115,1,voc,182726584,182727034,450,spec2/voc/Bl122_182726584.jpg,Bl122,4
14823.276551,14823.282551,1,voc,444698296,444698476,180,spec2/voc/Bl122_444698296.jpg,Bl122,4
12645.153825,12645.401825,1,voc,379354614,379362054,7440,spec2/voc/Bl122_379354614.jpg,Bl122,4
5969.948256,5970.170256,1,voc,179098447,179105107,6660,spec2/voc/Bl122_179098447.jpg,Bl122,4
13176.690701,13176.846701,1,voc,395300721,395305401,4680,spec2/voc/Bl122_395300721.jpg,Bl122,4
8995.332241,8995.366241,1,voc,269859967,269860987,1020,spec2/voc/Bl122_269859967.jpg,Bl122,4
14821.106551,14821.109551,1,voc,444633196,444633286,90,spec2/voc/Bl122_444633196.jpg,Bl122,4
5986.105256,5986.114256,1,voc,179583157,179583427,270,spec2/voc/Bl122_179583157.jpg,Bl122,4
6038.188533,6038.191533,1,voc,181145655,181145745,90,spec2/voc/Bl122_181145655.jpg,Bl122,4
10965.116807,10965.132807,1,voc,328953504,328953984,480,spec2/voc/Bl122_328953504.jpg,Bl122,4
6020.700533,6021.026533,1,voc,180621015,180630795,9780,spec2/voc/Bl122_180621015.jpg,Bl122,4
8207.870882,8207.921882,1,voc,246236126,246237656,1530,spec2/voc/Bl122_246236126.jpg,Bl122,4
3898.179652,3898.314652,1,voc,116945389,116949439,4050,spec2/voc/Bl122_116945389.jpg,Bl122,4
9077.558241,9077.562241,1,voc,272326747,272326867,120,spec2/voc/Bl122_272326747.jpg,Bl122,4
13177.191701,13177.199701,1,voc,395315751,395315991,240,spec2/voc/Bl122_395315751.jpg,Bl122,4
7884.942748,7884.951748,1,voc,236548282,236548552,270,spec2/voc/Bl122_236548282.jpg,Bl122,4
14824.272551,14824.359551,1,voc,444728176,444730786,2610,spec2/voc/Bl122_444728176.jpg,Bl122,4
3889.679652,3889.691652,1,voc,116690389,116690749,360,spec2/voc/Bl122_116690389.jpg,Bl122,4
9022.931241,9023.192241,1,voc,270687937,270695767,7830,spec2/voc/Bl122_270687937.jpg,Bl122,4
6228.265295,6228.316295,1,voc,186847958,186849488,1530,spec2/voc/Bl122_186847958.jpg,Bl122,4
10947.272807,10947.274807,1,voc,328418184,328418244,60,spec2/voc/Bl122_328418184.jpg,Bl122,4
9034.386241,9034.410241,1,voc,271031587,271032307,720,spec2/voc/Bl122_271031587.jpg,Bl122,4
10922.751807,10922.755807,1,voc,327682554,327682674,120,spec2/voc/Bl122_327682554.jpg,Bl122,4
13988.296864,13988.487864,1,voc,419648905,419654635,5730,spec2/voc/Bl122_419648905.jpg,Bl122,4
14804.950551,14804.971551,1,voc,444148516,444149146,630,spec2/voc/Bl122_444148516.jpg,Bl122,4
8213.814724,8213.866724,1,voc,246414441,246416001,1560,spec2/voc/Bl122_246414441.jpg,Bl122,4
8999.833241,8999.857241,1,voc,269994997,269995717,720,spec2/voc/Bl122_269994997.jpg,Bl122,4
12591.503947,12591.514947,1,voc,377745118,377745448,330,spec2/voc/Bl122_377745118.jpg,Bl122,4
6042.7582,6042.7712,1,voc,181282746,181283136,390,spec2/voc/Bl122_181282746.jpg,Bl122,4
7952.533821,7952.572821,1,voc,238576014,238577184,1170,spec2/voc/Bl122_238576014.jpg,Bl122,4
8916.298773,8916.327773,1,voc,267488963,267489833,870,spec2/voc/Bl122_267488963.jpg,Bl122,4
7949.061748,7949.065748,1,voc,238471852,238471972,120,spec2/voc/Bl122_238471852.jpg,Bl122,4
7942.114748,7942.124748,1,voc,238263442,238263742,300,spec2/voc/Bl122_238263442.jpg,Bl122,4
6041.202065,6041.212065,1,voc,181236061,181236361,300,spec2/voc/Bl122_181236061.jpg,Bl122,4
10909.422807,10909.431807,1,voc,327282684,327282954,270,spec2/voc/Bl122_327282684.jpg,Bl122,4
13206.011389,13206.040389,1,voc,396180341,396181211,870,spec2/voc/Bl122_396180341.jpg,Bl122,4
6075.479705,6075.510705,1,voc,182264391,182265321,930,spec2/voc/Bl122_182264391.jpg,Bl122,4
5950.649256,5950.660256,1,voc,178519477,178519807,330,spec2/voc/Bl122_178519477.jpg,Bl122,4
6133.107293,6133.114293,1,voc,183993218,183993428,210,spec2/voc/Bl122_183993218.jpg,Bl122,4
9057.570241,9057.576241,1,voc,271727107,271727287,180,spec2/voc/Bl122_271727107.jpg,Bl122,4
11874.347708,11874.546708,1,voc,356230431,356236401,5970,spec2/voc/Bl122_356230431.jpg,Bl122,4
6204.797327,6204.822327,1,voc,186143919,186144669,750,spec2/voc/Bl122_186143919.jpg,Bl122,4
10917.122807,10917.125807,1,voc,327513684,327513774,90,spec2/voc/Bl122_327513684.jpg,Bl122,4
9024.676241,9024.707241,1,voc,270740287,270741217,930,spec2/voc/Bl122_270740287.jpg,Bl122,4
9146.970342,9146.983342,1,voc,274409110,274409500,390,spec2/voc/Bl122_274409110.jpg,Bl122,4
9095.948241,9095.952241,1,voc,272878447,272878567,120,spec2/voc/Bl122_272878447.jpg,Bl122,4
13818.702617,13818.746617,1,voc,414561078,414562398,1320,spec2/voc/Bl122_414561078.jpg,Bl122,4
5267.562487,5267.567487,1,voc,158026874,158027024,150,spec2/voc/Bl122_158026874.jpg,Bl122,4
8926.886773,8926.894773,1,voc,267806603,267806843,240,spec2/voc/Bl122_267806603.jpg,Bl122,4
9050.906241,9050.910241,1,voc,271527187,271527307,120,spec2/voc/Bl122_271527187.jpg,Bl122,4
11208.617894,11208.619894,1,voc,336258536,336258596,60,spec2/voc/Bl122_336258536.jpg,Bl122,4
11196.94418,11196.97918,1,voc,335908325,335909375,1050,spec2/voc/Bl122_335908325.jpg,Bl122,4
5943.226256,5943.258256,1,voc,178296787,178297747,960,spec2/voc/Bl122_178296787.jpg,Bl122,4
10938.675807,10938.723807,1,voc,328160274,328161714,1440,spec2/voc/Bl122_328160274.jpg,Bl122,4
7825.547748,7825.557748,1,voc,234766432,234766732,300,spec2/voc/Bl122_234766432.jpg,Bl122,4
7977.370748,7977.377748,1,voc,239321122,239321332,210,spec2/voc/Bl122_239321122.jpg,Bl122,4
13825.82022,13825.85322,1,voc,414774606,414775596,990,spec2/voc/Bl122_414774606.jpg,Bl122,4
5996.252256,5996.261256,1,voc,179887567,179887837,270,spec2/voc/Bl122_179887567.jpg,Bl122,4
11881.751992,11881.951992,1,voc,356452559,356458559,6000,spec2/voc/Bl122_356452559.jpg,Bl122,4
13828.792664,13828.857664,1,voc,414863779,414865729,1950,spec2/voc/Bl122_414863779.jpg,Bl122,4
13725.97841,13725.98741,1,voc,411779352,411779622,270,spec2/voc/Bl122_411779352.jpg,Bl122,4
7949.358748,7949.363748,1,voc,238480762,238480912,150,spec2/voc/Bl122_238480762.jpg,Bl122,4
14809.495551,14809.516551,1,voc,444284866,444285496,630,spec2/voc/Bl122_444284866.jpg,Bl122,4
6138.053293,6138.057293,1,voc,184141598,184141718,120,spec2/voc/Bl122_184141598.jpg,Bl122,4
5944.260256,5944.271256,1,voc,178327807,178328137,330,spec2/voc/Bl122_178327807.jpg,Bl122,4
6086.61115,6086.61415,1,voc,182598334,182598424,90,spec2/voc/Bl122_182598334.jpg,Bl122,4
9034.941241,9034.953241,1,voc,271048237,271048597,360,spec2/voc/Bl122_271048237.jpg,Bl122,4
13204.416389,13204.424389,1,voc,396132491,396132731,240,spec2/voc/Bl122_396132491.jpg,Bl122,4
7843.639748,7843.644748,1,voc,235309192,235309342,150,spec2/voc/Bl122_235309192.jpg,Bl122,4
5987.454256,5987.513256,1,voc,179623627,179625397,1770,spec2/voc/Bl122_179623627.jpg,Bl122,4
7949.117748,7949.133748,1,voc,238473532,238474012,480,spec2/voc/Bl122_238473532.jpg,Bl122,4
8991.266241,8991.432241,1,voc,269737987,269742967,4980,spec2/voc/Bl122_269737987.jpg,Bl122,4
5977.076256,5977.081256,1,voc,179312287,179312437,150,spec2/voc/Bl122_179312287.jpg,Bl122,4
6076.915705,6076.997705,1,voc,182307471,182309931,2460,spec2/voc/Bl122_182307471.jpg,Bl122,4
13968.050352,13968.054352,1,voc,419041510,419041630,120,spec2/voc/Bl122_419041510.jpg,Bl122,4
6125.851706,6125.874706,1,voc,183775551,183776241,690,spec2/voc/Bl122_183775551.jpg,Bl122,4
12601.491506,12601.653506,1,voc,378044745,378049605,4860,spec2/voc/Bl122_378044745.jpg,Bl122,4
10936.706807,10936.739807,1,voc,328101204,328102194,990,spec2/voc/Bl122_328101204.jpg,Bl122,4
6090.14615,6090.15115,1,voc,182704384,182704534,150,spec2/voc/Bl122_182704384.jpg,Bl122,4
9028.724241,9028.772241,1,voc,270861727,270863167,1440,spec2/voc/Bl122_270861727.jpg,Bl122,4
11170.26418,11170.38218,1,voc,335107925,335111465,3540,spec2/voc/Bl122_335107925.jpg,Bl122,4
3861.635367,3861.637367,1,voc,115849061,115849121,60,spec2/voc/Bl122_115849061.jpg,Bl122,4
8985.860025,8985.865025,1,voc,269575800,269575950,150,spec2/voc/Bl122_269575800.jpg,Bl122,4
9097.723241,9097.735241,1,voc,272931697,272932057,360,spec2/voc/Bl122_272931697.jpg,Bl122,4
11985.509611,11985.524611,1,voc,359565288,359565738,450,spec2/voc/Bl122_359565288.jpg,Bl122,4
13998.848512,13998.923512,1,voc,419965455,419967705,2250,spec2/voc/Bl122_419965455.jpg,Bl122,4
14804.760551,14804.794551,1,voc,444142816,444143836,1020,spec2/voc/Bl122_444142816.jpg,Bl122,4
6115.421706,6115.428706,1,voc,183462651,183462861,210,spec2/voc/Bl122_183462651.jpg,Bl122,4
6027.103533,6027.132533,1,voc,180813105,180813975,870,spec2/voc/Bl122_180813105.jpg,Bl122,4
6056.302705,6056.311705,1,voc,181689081,181689351,270,spec2/voc/Bl122_181689081.jpg,Bl122,4
14815.725551,14815.728551,1,voc,444471766,444471856,90,spec2/voc/Bl122_444471766.jpg,Bl122,4
5984.225256,5984.228256,1,voc,179526757,179526847,90,spec2/voc/Bl122_179526757.jpg,Bl122,4
3810.469649,3810.537649,1,voc,114314089,114316129,2040,spec2/voc/Bl122_114314089.jpg,Bl122,4
6024.446533,6024.491533,1,voc,180733395,180734745,1350,spec2/voc/Bl122_180733395.jpg,Bl122,4
8017.492748,8017.507748,1,voc,240524782,240525232,450,spec2/voc/Bl122_240524782.jpg,Bl122,4
6084.86615,6084.87015,1,voc,182545984,182546104,120,spec2/voc/Bl122_182545984.jpg,Bl122,4
6106.473706,6106.476706,1,voc,183194211,183194301,90,spec2/voc/Bl122_183194211.jpg,Bl122,4
14805.260551,14805.263551,1,voc,444157816,444157906,90,spec2/voc/Bl122_444157816.jpg,Bl122,4
13710.864399,13710.890399,1,voc,411325931,411326711,780,spec2/voc/Bl122_411325931.jpg,Bl122,4
7976.967748,7976.991748,1,voc,239309032,239309752,720,spec2/voc/Bl122_239309032.jpg,Bl122,4
7908.325748,7908.328748,1,voc,237249772,237249862,90,spec2/voc/Bl122_237249772.jpg,Bl122,4
6094.70315,6095.11415,1,voc,182841094,182853424,12330,spec2/voc/Bl122_182841094.jpg,Bl122,4
14843.091682,14843.094682,1,voc,445292750,445292840,90,spec2/voc/Bl122_445292750.jpg,Bl122,4
5940.820256,5940.825256,1,voc,178224607,178224757,150,spec2/voc/Bl122_178224607.jpg,Bl122,4
9023.478241,9023.643241,1,voc,270704347,270709297,4950,spec2/voc/Bl122_270704347.jpg,Bl122,4
3808.130649,3808.363649,1,voc,114243919,114250909,6990,spec2/voc/Bl122_114243919.jpg,Bl122,4
5959.330256,5959.369256,1,voc,178779907,178781077,1170,spec2/voc/Bl122_178779907.jpg,Bl122,4
9058.861241,9058.920241,1,voc,271765837,271767607,1770,spec2/voc/Bl122_271765837.jpg,Bl122,4
7912.131748,7912.179748,1,voc,237363952,237365392,1440,spec2/voc/Bl122_237363952.jpg,Bl122,4
9070.922241,9070.929241,1,voc,272127667,272127877,210,spec2/voc/Bl122_272127667.jpg,Bl122,4
5952.992256,5953.010256,1,voc,178589767,178590307,540,spec2/voc/Bl122_178589767.jpg,Bl122,4
12634.413885,12634.546885,1,voc,379032416,379036406,3990,spec2/voc/Bl122_379032416.jpg,Bl122,4
6111.239706,6111.372706,1,voc,183337191,183341181,3990,spec2/voc/Bl122_183337191.jpg,Bl122,4
8025.933748,8025.942748,1,voc,240778012,240778282,270,spec2/voc/Bl122_240778012.jpg,Bl122,4
14362.088031,14362.096031,1,voc,430862640,430862880,240,spec2/voc/Bl122_430862640.jpg,Bl122,4
8016.813748,8016.816748,1,voc,240504412,240504502,90,spec2/voc/Bl122_240504412.jpg,Bl122,4
6223.004295,6223.300295,1,voc,186690128,186699008,8880,spec2/voc/Bl122_186690128.jpg,Bl122,4
9101.473241,9101.481241,1,voc,273044197,273044437,240,spec2/voc/Bl122_273044197.jpg,Bl122,4
14839.967682,14840.024682,1,voc,445199030,445200740,1710,spec2/voc/Bl122_445199030.jpg,Bl122,4
11160.79818,11160.82018,1,voc,334823945,334824605,660,spec2/voc/Bl122_334823945.jpg,Bl122,4
3805.648649,3805.671649,1,voc,114169459,114170149,690,spec2/voc/Bl122_114169459.jpg,Bl122,4
9050.774241,9050.794241,1,voc,271523227,271523827,600,spec2/voc/Bl122_271523227.jpg,Bl122,4
7976.371748,7976.392748,1,voc,239291152,239291782,630,spec2/voc/Bl122_239291152.jpg,Bl122,4
6025.322533,6025.336533,1,voc,180759675,180760095,420,spec2/voc/Bl122_180759675.jpg,Bl122,4
7841.937748,7841.956748,1,voc,235258132,235258702,570,spec2/voc/Bl122_235258132.jpg,Bl122,4
7853.245748,7853.251748,1,voc,235597372,235597552,180,spec2/voc/Bl122_235597372.jpg,Bl122,4
12638.405849,12638.450849,1,voc,379152175,379153525,1350,spec2/voc/Bl122_379152175.jpg,Bl122,4
8038.905748,8038.913748,1,voc,241167172,241167412,240,spec2/voc/Bl122_241167172.jpg,Bl122,4
6124.799706,6124.806706,1,voc,183743991,183744201,210,spec2/voc/Bl122_183743991.jpg,Bl122,4
6097.90915,6097.95715,1,voc,182937274,182938714,1440,spec2/voc/Bl122_182937274.jpg,Bl122,4
6044.7812,6044.8122,1,voc,181343436,181344366,930,spec2/voc/Bl122_181343436.jpg,Bl122,4
3852.259415,3852.292415,1,voc,115567782,115568772,990,spec2/voc/Bl122_115567782.jpg,Bl122,4
9033.977241,9034.095241,1,voc,271019317,271022857,3540,spec2/voc/Bl122_271019317.jpg,Bl122,4
3864.296367,3864.303367,1,voc,115928891,115929101,210,spec2/voc/Bl122_115928891.jpg,Bl122,4
7886.789748,7886.798748,1,voc,236603692,236603962,270,spec2/voc/Bl122_236603692.jpg,Bl122,4
9095.567241,9095.584241,1,voc,272867017,272867527,510,spec2/voc/Bl122_272867017.jpg,Bl122,4
14791.625551,14791.631551,1,voc,443748766,443748946,180,spec2/voc/Bl122_443748766.jpg,Bl122,4
9029.374241,9029.377241,1,voc,270881227,270881317,90,spec2/voc/Bl122_270881227.jpg,Bl122,4
9028.492241,9028.528241,1,voc,270854767,270855847,1080,spec2/voc/Bl122_270854767.jpg,Bl122,4
7959.884748,7959.887748,1,voc,238796542,238796632,90,spec2/voc/Bl122_238796542.jpg,Bl122,4
13915.588392,13915.595392,1,voc,417467651,417467861,210,spec2/voc/Bl122_417467651.jpg,Bl122,4
5989.233256,5989.493256,1,voc,179676997,179684797,7800,spec2/voc/Bl122_179676997.jpg,Bl122,4
8952.443967,8952.537967,1,voc,268573319,268576139,2820,spec2/voc/Bl122_268573319.jpg,Bl122,4
7841.556748,7841.603748,1,voc,235246702,235248112,1410,spec2/voc/Bl122_235246702.jpg,Bl122,4
12667.505394,12667.510394,1,voc,380025161,380025311,150,spec2/voc/Bl122_380025161.jpg,Bl122,4
14803.052551,14803.068551,1,voc,444091576,444092056,480,spec2/voc/Bl122_444091576.jpg,Bl122,4
12130.437503,12130.642503,1,voc,363913125,363919275,6150,spec2/voc/Bl122_363913125.jpg,Bl122,4
7844.977748,7844.999748,1,voc,235349332,235349992,660,spec2/voc/Bl122_235349332.jpg,Bl122,4
5945.512256,5945.531256,1,voc,178365367,178365937,570,spec2/voc/Bl122_178365367.jpg,Bl122,4
3869.560367,3869.673367,1,voc,116086811,116090201,3390,spec2/voc/Bl122_116086811.jpg,Bl122,4
6120.532706,6120.551706,1,voc,183615981,183616551,570,spec2/voc/Bl122_183615981.jpg,Bl122,4
3853.882415,3854.076415,1,voc,115616472,115622292,5820,spec2/voc/Bl122_115616472.jpg,Bl122,4
12592.308947,12592.326947,1,voc,377769268,377769808,540,spec2/voc/Bl122_377769268.jpg,Bl122,4
9022.445241,9022.453241,1,voc,270673357,270673597,240,spec2/voc/Bl122_270673357.jpg,Bl122,4
11127.805005,11127.810005,1,voc,333834150,333834300,150,spec2/voc/Bl122_333834150.jpg,Bl122,4
10914.094807,10914.098807,1,voc,327422844,327422964,120,spec2/voc/Bl122_327422844.jpg,Bl122,4
10913.699807,10913.705807,1,voc,327410994,327411174,180,spec2/voc/Bl122_327410994.jpg,Bl122,4
11130.838005,11130.852005,1,voc,333925140,333925560,420,spec2/voc/Bl122_333925140.jpg,Bl122,4
3815.358649,3815.660649,1,voc,114460759,114469819,9060,spec2/voc/Bl122_114460759.jpg,Bl122,4
6222.505295,6222.509295,1,voc,186675158,186675278,120,spec2/voc/Bl122_186675158.jpg,Bl122,4
7969.227748,7969.229748,1,voc,239076832,239076892,60,spec2/voc/Bl122_239076832.jpg,Bl122,4
13603.966736,13603.970736,1,voc,408119002,408119122,120,spec2/voc/Bl122_408119002.jpg,Bl122,4
13990.056864,13990.199864,1,voc,419701705,419705995,4290,spec2/voc/Bl122_419701705.jpg,Bl122,4
12638.863849,12638.925849,1,voc,379165915,379167775,1860,spec2/voc/Bl122_379165915.jpg,Bl122,4
9009.943241,9010.017241,1,voc,270298297,270300517,2220,spec2/voc/Bl122_270298297.jpg,Bl122,4
7938.004748,7938.008748,1,voc,238140142,238140262,120,spec2/voc/Bl122_238140142.jpg,Bl122,4
7871.428748,7871.440748,1,voc,236142862,236143222,360,spec2/voc/Bl122_236142862.jpg,Bl122,4
13189.240662,13189.353662,1,voc,395677219,395680609,3390,spec2/voc/Bl122_395677219.jpg,Bl122,4
8915.917773,8915.920773,1,voc,267477533,267477623,90,spec2/voc/Bl122_267477533.jpg,Bl122,4
11130.677005,11130.680005,1,voc,333920310,333920400,90,spec2/voc/Bl122_333920310.jpg,Bl122,4
11189.46818,11189.47518,1,voc,335684045,335684255,210,spec2/voc/Bl122_335684045.jpg,Bl122,4
3820.487649,3820.491649,1,voc,114614629,114614749,120,spec2/voc/Bl122_114614629.jpg,Bl122,4
8015.856748,8015.862748,1,voc,240475702,240475882,180,spec2/voc/Bl122_240475702.jpg,Bl122,4
13946.901911,13946.904911,1,voc,418407057,418407147,90,spec2/voc/Bl122_418407057.jpg,Bl122,4
10943.449807,10943.456807,1,voc,328303494,328303704,210,spec2/voc/Bl122_328303494.jpg,Bl122,4
5971.184256,5971.188256,1,voc,179135527,179135647,120,spec2/voc/Bl122_179135527.jpg,Bl122,4
6202.067327,6202.294327,1,voc,186062019,186068829,6810,spec2/voc/Bl122_186062019.jpg,Bl122,4
6137.011293,6137.111293,1,voc,184110338,184113338,3000,spec2/voc/Bl122_184110338.jpg,Bl122,4
12667.608394,12667.612394,1,voc,380028251,380028371,120,spec2/voc/Bl122_380028251.jpg,Bl122,4
3850.329415,3850.338415,1,voc,115509882,115510152,270,spec2/voc/Bl122_115509882.jpg,Bl122,4
13586.420236,13586.422236,1,voc,407592607,407592667,60,spec2/voc/Bl122_407592607.jpg,Bl122,4
13554.901188,13554.949188,1,voc,406647035,406648475,1440,spec2/voc/Bl122_406647035.jpg,Bl122,4
14837.867682,14837.904682,1,voc,445136030,445137140,1110,spec2/voc/Bl122_445136030.jpg,Bl122,4
7940.203748,7940.207748,1,voc,238206112,238206232,120,spec2/voc/Bl122_238206112.jpg,Bl122,4
9098.098241,9098.116241,1,voc,272942947,272943487,540,spec2/voc/Bl122_272942947.jpg,Bl122,4
7920.061748,7920.084748,1,voc,237601852,237602542,690,spec2/voc/Bl122_237601852.jpg,Bl122,4
9048.216241,9048.280241,1,voc,271446487,271448407,1920,spec2/voc/Bl122_271446487.jpg,Bl122,4
10898.05056,10898.10956,1,voc,326941516,326943286,1770,spec2/voc/Bl122_326941516.jpg,Bl122,4
3826.918649,3826.978649,1,voc,114807559,114809359,1800,spec2/voc/Bl122_114807559.jpg,Bl122,4
13968.659352,13968.703352,1,voc,419059780,419061100,1320,spec2/voc/Bl122_419059780.jpg,Bl122,4
9030.132241,9030.136241,1,voc,270903967,270904087,120,spec2/voc/Bl122_270903967.jpg,Bl122,4
7843.755748,7843.807748,1,voc,235312672,235314232,1560,spec2/voc/Bl122_235312672.jpg,Bl122,4
13580.491236,13580.503236,1,voc,407414737,407415097,360,spec2/voc/Bl122_407414737.jpg,Bl122,4
9052.270241,9052.286241,1,voc,271568107,271568587,480,spec2/voc/Bl122_271568107.jpg,Bl122,4
6227.211295,6227.305295,1,voc,186816338,186819158,2820,spec2/voc/Bl122_186816338.jpg,Bl122,4
5964.749256,5964.759256,1,voc,178942477,178942777,300,spec2/voc/Bl122_178942477.jpg,Bl122,4
9057.580241,9057.587241,1,voc,271727407,271727617,210,spec2/voc/Bl122_271727407.jpg,Bl122,4
12828.501025,12828.564025,1,voc,384855030,384856920,1890,spec2/voc/Bl122_384855030.jpg,Bl122,4
5981.264256,5981.273256,1,voc,179437927,179438197,270,spec2/voc/Bl122_179437927.jpg,Bl122,4
8027.948748,8027.954748,1,voc,240838462,240838642,180,spec2/voc/Bl122_240838462.jpg,Bl122,4
7845.492748,7845.507748,1,voc,235364782,235365232,450,spec2/voc/Bl122_235364782.jpg,Bl122,4
9165.703604,9165.716604,1,voc,274971108,274971498,390,spec2/voc/Bl122_274971108.jpg,Bl122,4
7976.612748,7976.615748,1,voc,239298382,239298472,90,spec2/voc/Bl122_239298382.jpg,Bl122,4
6145.284349,6145.311349,1,voc,184358530,184359340,810,spec2/voc/Bl122_184358530.jpg,Bl122,4
5936.830256,5936.887256,1,voc,178104907,178106617,1710,spec2/voc/Bl122_178104907.jpg,Bl122,4
10954.219807,10954.412807,1,voc,328626594,328632384,5790,spec2/voc/Bl122_328626594.jpg,Bl122,4
13204.058389,13204.302389,1,voc,396121751,396129071,7320,spec2/voc/Bl122_396121751.jpg,Bl122,4
8015.573748,8015.630748,1,voc,240467212,240468922,1710,spec2/voc/Bl122_240467212.jpg,Bl122,4
11180.35118,11180.38918,1,voc,335410535,335411675,1140,spec2/voc/Bl122_335410535.jpg,Bl122,4
3846.463415,3846.491415,1,voc,115393902,115394742,840,spec2/voc/Bl122_115393902.jpg,Bl122,4
11032.104132,11032.166132,1,voc,330963123,330964983,1860,spec2/voc/Bl122_330963123.jpg,Bl122,4
12591.775947,12591.920947,1,voc,377753278,377757628,4350,spec2/voc/Bl122_377753278.jpg,Bl122,4
8924.269773,8924.313773,1,voc,267728093,267729413,1320,spec2/voc/Bl122_267728093.jpg,Bl122,4
9029.512241,9029.522241,1,voc,270885367,270885667,300,spec2/voc/Bl122_270885367.jpg,Bl122,4
14156.201825,14156.208825,1,voc,424686054,424686264,210,spec2/voc/Bl122_424686054.jpg,Bl122,4
7822.782748,7822.788748,1,voc,234683482,234683662,180,spec2/voc/Bl122_234683482.jpg,Bl122,4
7851.781748,7851.792748,1,voc,235553452,235553782,330,spec2/voc/Bl122_235553452.jpg,Bl122,4
13180.469701,13180.490701,1,voc,395414091,395414721,630,spec2/voc/Bl122_395414091.jpg,Bl122,4
10951.723807,10951.759807,1,voc,328551714,328552794,1080,spec2/voc/Bl122_328551714.jpg,Bl122,4
10953.244807,10953.246807,1,voc,328597344,328597404,60,spec2/voc/Bl122_328597344.jpg,Bl122,4
13974.288117,13974.299117,1,voc,419228643,419228973,330,spec2/voc/Bl122_419228643.jpg,Bl122,4
6036.311533,6036.320533,1,voc,181089345,181089615,270,spec2/voc/Bl122_181089345.jpg,Bl122,4
5931.930256,5931.956256,1,voc,177957907,177958687,780,spec2/voc/Bl122_177957907.jpg,Bl122,4
8915.982773,8915.991773,1,voc,267479483,267479753,270,spec2/voc/Bl122_267479483.jpg,Bl122,4
13199.556389,13199.561389,1,voc,395986691,395986841,150,spec2/voc/Bl122_395986691.jpg,Bl122,4
3841.005415,3841.122415,1,voc,115230162,115233672,3510,spec2/voc/Bl122_115230162.jpg,Bl122,4
6050.9982,6051.0062,1,voc,181529946,181530186,240,spec2/voc/Bl122_181529946.jpg,Bl122,4
8978.834025,8978.840025,1,voc,269365020,269365200,180,spec2/voc/Bl122_269365020.jpg,Bl122,4
9065.300241,9065.304241,1,voc,271959007,271959127,120,spec2/voc/Bl122_271959007.jpg,Bl122,4
13162.269891,13162.283891,1,voc,394868096,394868516,420,spec2/voc/Bl122_394868096.jpg,Bl122,4
8965.632712,8966.090712,1,voc,268968981,268982721,13740,spec2/voc/Bl122_268968981.jpg,Bl122,4
6190.156327,6190.161327,1,voc,185704689,185704839,150,spec2/voc/Bl122_185704689.jpg,Bl122,4
6009.360533,6009.373533,1,voc,180280815,180281205,390,spec2/voc/Bl122_180280815.jpg,Bl122,4
7859.643748,7859.647748,1,voc,235789312,235789432,120,spec2/voc/Bl122_235789312.jpg,Bl122,4
8929.444773,8929.478773,1,voc,267883343,267884363,1020,spec2/voc/Bl122_267883343.jpg,Bl122,4
6023.535533,6023.749533,1,voc,180706065,180712485,6420,spec2/voc/Bl122_180706065.jpg,Bl122,4
3854.688415,3854.869415,1,voc,115640652,115646082,5430,spec2/voc/Bl122_115640652.jpg,Bl122,4
13966.522352,13966.573352,1,voc,418995670,418997200,1530,spec2/voc/Bl122_418995670.jpg,Bl122,4
11154.01518,11154.04018,1,voc,334620455,334621205,750,spec2/voc/Bl122_334620455.jpg,Bl122,4
8017.748748,8017.791748,1,voc,240532462,240533752,1290,spec2/voc/Bl122_240532462.jpg,Bl122,4
6083.58815,6083.59415,1,voc,182507644,182507824,180,spec2/voc/Bl122_182507644.jpg,Bl122,4
8980.759025,8980.787025,1,voc,269422770,269423610,840,spec2/voc/Bl122_269422770.jpg,Bl122,4
9079.493241,9079.496241,1,voc,272384797,272384887,90,spec2/voc/Bl122_272384797.jpg,Bl122,4
8982.196025,8982.302025,1,voc,269465880,269469060,3180,spec2/voc/Bl122_269465880.jpg,Bl122,4
11046.304537,11046.352537,1,voc,331389136,331390576,1440,spec2/voc/Bl122_331389136.jpg,Bl122,4
3864.305367,3864.452367,1,voc,115929161,115933571,4410,spec2/voc/Bl122_115929161.jpg,Bl122,4
13808.794653,13808.796653,1,voc,414263839,414263899,60,spec2/voc/Bl122_414263839.jpg,Bl122,4
14804.394551,14804.485551,1,voc,444131836,444134566,2730,spec2/voc/Bl122_444131836.jpg,Bl122,4
3856.288415,3856.316415,1,voc,115688652,115689492,840,spec2/voc/Bl122_115688652.jpg,Bl122,4
3815.855649,3815.858649,1,voc,114475669,114475759,90,spec2/voc/Bl122_114475669.jpg,Bl122,4
3811.219649,3811.223649,1,voc,114336589,114336709,120,spec2/voc/Bl122_114336589.jpg,Bl122,4
11165.30818,11165.53818,1,voc,334959245,334966145,6900,spec2/voc/Bl122_334959245.jpg,Bl122,4
9042.708241,9042.710241,1,voc,271281247,271281307,60,spec2/voc/Bl122_271281247.jpg,Bl122,4
13169.709701,13169.738701,1,voc,395091291,395092161,870,spec2/voc/Bl122_395091291.jpg,Bl122,4
3808.749649,3808.756649,1,voc,114262489,114262699,210,spec2/voc/Bl122_114262489.jpg,Bl122,4
6030.466533,6030.478533,1,voc,180913995,180914355,360,spec2/voc/Bl122_180913995.jpg,Bl122,4
5946.906256,5946.920256,1,voc,178407187,178407607,420,spec2/voc/Bl122_178407187.jpg,Bl122,4
13207.854389,13207.859389,1,voc,396235631,396235781,150,spec2/voc/Bl122_396235631.jpg,Bl122,4
10957.060807,10957.073807,1,voc,328711824,328712214,390,spec2/voc/Bl122_328711824.jpg,Bl122,4
9073.011241,9073.066241,1,voc,272190337,272191987,1650,spec2/voc/Bl122_272190337.jpg,Bl122,4
7946.078748,7946.104748,1,voc,238382362,238383142,780,spec2/voc/Bl122_238382362.jpg,Bl122,4
11206.133894,11206.269894,1,voc,336184016,336188096,4080,spec2/voc/Bl122_336184016.jpg,Bl122,4
10881.785609,10881.845609,1,voc,326453568,326455368,1800,spec2/voc/Bl122_326453568.jpg,Bl122,4
11179.96718,11180.00618,1,voc,335399015,335400185,1170,spec2/voc/Bl122_335399015.jpg,Bl122,4
8208.864882,8209.027882,1,voc,246265946,246270836,4890,spec2/voc/Bl122_246265946.jpg,Bl122,4
10943.121807,10943.126807,1,voc,328293654,328293804,150,spec2/voc/Bl122_328293654.jpg,Bl122,4
10962.766807,10962.911807,1,voc,328883004,328887354,4350,spec2/voc/Bl122_328883004.jpg,Bl122,4
6187.864327,6187.979327,1,voc,185635929,185639379,3450,spec2/voc/Bl122_185635929.jpg,Bl122,4
6143.343349,6143.348349,1,voc,184300300,184300450,150,spec2/voc/Bl122_184300300.jpg,Bl122,4
10898.62656,10898.62856,1,voc,326958796,326958856,60,spec2/voc/Bl122_326958796.jpg,Bl122,4
14817.980551,14817.988551,1,voc,444539416,444539656,240,spec2/voc/Bl122_444539416.jpg,Bl122,4
5986.525256,5986.604256,1,voc,179595757,179598127,2370,spec2/voc/Bl122_179595757.jpg,Bl122,4
6226.426295,6226.501295,1,voc,186792788,186795038,2250,spec2/voc/Bl122_186792788.jpg,Bl122,4
7937.312748,7937.314748,1,voc,238119382,238119442,60,spec2/voc/Bl122_238119382.jpg,Bl122,4
10942.036807,10942.221807,1,voc,328261104,328266654,5550,spec2/voc/Bl122_328261104.jpg,Bl122,4
8966.925712,8967.116712,1,voc,269007771,269013501,5730,spec2/voc/Bl122_269007771.jpg,Bl122,4
10896.627557,10896.649557,1,voc,326898826,326899486,660,spec2/voc/Bl122_326898826.jpg,Bl122,4
11892.34234,11892.49134,1,voc,356770270,356774740,4470,spec2/voc/Bl122_356770270.jpg,Bl122,4
10954.015807,10954.021807,1,voc,328620474,328620654,180,spec2/voc/Bl122_328620474.jpg,Bl122,4
5953.989256,5953.999256,1,voc,178619677,178619977,300,spec2/voc/Bl122_178619677.jpg,Bl122,4
14790.860551,14790.867551,1,voc,443725816,443726026,210,spec2/voc/Bl122_443725816.jpg,Bl122,4
12672.259513,12672.262513,1,voc,380167785,380167875,90,spec2/voc/Bl122_380167785.jpg,Bl122,4
6148.674349,6148.767349,1,voc,184460230,184463020,2790,spec2/voc/Bl122_184460230.jpg,Bl122,4
6151.473349,6151.710349,1,voc,184544200,184551310,7110,spec2/voc/Bl122_184544200.jpg,Bl122,4
8015.683748,8015.693748,1,voc,240470512,240470812,300,spec2/voc/Bl122_240470512.jpg,Bl122,4
6067.784705,6067.801705,1,voc,182033541,182034051,510,spec2/voc/Bl122_182033541.jpg,Bl122,4
8206.708882,8207.236882,1,voc,246201266,246217106,15840,spec2/voc/Bl122_246201266.jpg,Bl122,4
6018.817533,6019.043533,1,voc,180564525,180571305,6780,spec2/voc/Bl122_180564525.jpg,Bl122,4
5985.542256,5985.548256,1,voc,179566267,179566447,180,spec2/voc/Bl122_179566267.jpg,Bl122,4
13967.068352,13967.070352,1,voc,419012050,419012110,60,spec2/voc/Bl122_419012050.jpg,Bl122,4
6194.349327,6194.403327,1,voc,185830479,185832099,1620,spec2/voc/Bl122_185830479.jpg,Bl122,4
11149.81018,11149.84518,1,voc,334494305,334495355,1050,spec2/voc/Bl122_334494305.jpg,Bl122,4
11203.027894,11203.031894,1,voc,336090836,336090956,120,spec2/voc/Bl122_336090836.jpg,Bl122,4
10915.175807,10915.184807,1,voc,327455274,327455544,270,spec2/voc/Bl122_327455274.jpg,Bl122,4
7844.262748,7844.286748,1,voc,235327882,235328602,720,spec2/voc/Bl122_235327882.jpg,Bl122,4
8208.393882,8208.551882,1,voc,246251816,246256556,4740,spec2/voc/Bl122_246251816.jpg,Bl122,4
3850.038415,3850.049415,1,voc,115501152,115501482,330,spec2/voc/Bl122_115501152.jpg,Bl122,4
10932.577807,10932.602807,1,voc,327977334,327978084,750,spec2/voc/Bl122_327977334.jpg,Bl122,4
14700.058324,14700.240324,1,voc,441001749,441007209,5460,spec2/voc/Bl122_441001749.jpg,Bl122,4
10952.967807,10952.970807,1,voc,328589034,328589124,90,spec2/voc/Bl122_328589034.jpg,Bl122,4
6101.990706,6102.000706,1,voc,183059721,183060021,300,spec2/voc/Bl122_183059721.jpg,Bl122,4
9096.064241,9096.069241,1,voc,272881927,272882077,150,spec2/voc/Bl122_272881927.jpg,Bl122,4
3842.299415,3842.330415,1,voc,115268982,115269912,930,spec2/voc/Bl122_115268982.jpg,Bl122,4
3859.583367,3859.590367,1,voc,115787501,115787711,210,spec2/voc/Bl122_115787501.jpg,Bl122,4
6078.219705,6078.222705,1,voc,182346591,182346681,90,spec2/voc/Bl122_182346591.jpg,Bl122,4
7972.125748,7972.130748,1,voc,239163772,239163922,150,spec2/voc/Bl122_239163772.jpg,Bl122,4
9146.635342,9146.796342,1,voc,274399060,274403890,4830,spec2/voc/Bl122_274399060.jpg,Bl122,4
5961.346256,5961.366256,1,voc,178840387,178840987,600,spec2/voc/Bl122_178840387.jpg,Bl122,4
9072.293241,9072.302241,1,voc,272168797,272169067,270,spec2/voc/Bl122_272168797.jpg,Bl122,4
13825.89922,13825.92522,1,voc,414776976,414777756,780,spec2/voc/Bl122_414776976.jpg,Bl122,4
3812.907649,3813.102649,1,voc,114387229,114393079,5850,spec2/voc/Bl122_114387229.jpg,Bl122,4
6020.665533,6020.694533,1,voc,180619965,180620835,870,spec2/voc/Bl122_180619965.jpg,Bl122,4
6206.285327,6206.499327,1,voc,186188559,186194979,6420,spec2/voc/Bl122_186188559.jpg,Bl122,4
9169.300604,9169.303604,1,voc,275079018,275079108,90,spec2/voc/Bl122_275079018.jpg,Bl122,4
11209.145894,11209.168894,1,voc,336274376,336275066,690,spec2/voc/Bl122_336274376.jpg,Bl122,4
13244.479606,13244.499606,1,voc,397334388,397334988,600,spec2/voc/Bl122_397334388.jpg,Bl122,4
3886.446062,3886.480062,1,voc,116593381,116594401,1020,spec2/voc/Bl122_116593381.jpg,Bl122,4
13213.412389,13213.453389,1,voc,396402371,396403601,1230,spec2/voc/Bl122_396402371.jpg,Bl122,4
6030.573533,6030.577533,1,voc,180917205,180917325,120,spec2/voc/Bl122_180917205.jpg,Bl122,4
13195.259662,13195.308662,1,voc,395857789,395859259,1470,spec2/voc/Bl122_395857789.jpg,Bl122,4
13554.769188,13554.777188,1,voc,406643075,406643315,240,spec2/voc/Bl122_406643075.jpg,Bl122,4
5952.748256,5952.756256,1,voc,178582447,178582687,240,spec2/voc/Bl122_178582447.jpg,Bl122,4
12670.247513,12670.303513,1,voc,380107425,380109105,1680,spec2/voc/Bl122_380107425.jpg,Bl122,4
11195.04618,11195.05118,1,voc,335851385,335851535,150,spec2/voc/Bl122_335851385.jpg,Bl122,4
5971.007256,5971.031256,1,voc,179130217,179130937,720,spec2/voc/Bl122_179130217.jpg,Bl122,4
3876.379848,3876.522848,1,voc,116291395,116295685,4290,spec2/voc/Bl122_116291395.jpg,Bl122,4
6016.700533,6016.786533,1,voc,180501015,180503595,2580,spec2/voc/Bl122_180501015.jpg,Bl122,4
7991.722748,7991.725748,1,voc,239751682,239751772,90,spec2/voc/Bl122_239751682.jpg,Bl122,4
7947.494748,7947.496748,1,voc,238424842,238424902,60,spec2/voc/Bl122_238424842.jpg,Bl122,4
10904.424825,10904.552825,1,voc,327132744,327136584,3840,spec2/voc/Bl122_327132744.jpg,Bl122,4
6082.64215,6082.70215,1,voc,182479264,182481064,1800,spec2/voc/Bl122_182479264.jpg,Bl122,4
6043.4332,6043.5052,1,voc,181302996,181305156,2160,spec2/voc/Bl122_181302996.jpg,Bl122,4
3823.682649,3823.820649,1,voc,114710479,114714619,4140,spec2/voc/Bl122_114710479.jpg,Bl122,4
10826.186452,10826.353452,1,voc,324785593,324790603,5010,spec2/voc/Bl122_324785593.jpg,Bl122,4
6124.829706,6124.860706,1,voc,183744891,183745821,930,spec2/voc/Bl122_183744891.jpg,Bl122,4
11157.26918,11157.27418,1,voc,334718075,334718225,150,spec2/voc/Bl122_334718075.jpg,Bl122,4
11139.453955,11139.530955,1,voc,334183618,334185928,2310,spec2/voc/Bl122_334183618.jpg,Bl122,4
6096.49115,6096.49315,1,voc,182894734,182894794,60,spec2/voc/Bl122_182894734.jpg,Bl122,4
11863.389519,11863.396519,1,voc,355901685,355901895,210,spec2/voc/Bl122_355901685.jpg,Bl122,4
9051.345241,9051.349241,1,voc,271540357,271540477,120,spec2/voc/Bl122_271540357.jpg,Bl122,4
10932.613807,10932.630807,1,voc,327978414,327978924,510,spec2/voc/Bl122_327978414.jpg,Bl122,4
5931.514256,5931.533256,1,voc,177945427,177945997,570,spec2/voc/Bl122_177945427.jpg,Bl122,4
11143.939955,11143.971955,1,voc,334318198,334319158,960,spec2/voc/Bl122_334318198.jpg,Bl122,4
6028.232533,6028.237533,1,voc,180846975,180847125,150,spec2/voc/Bl122_180846975.jpg,Bl122,4
6157.559349,6157.562349,1,voc,184726780,184726870,90,spec2/voc/Bl122_184726780.jpg,Bl122,4
7911.530748,7911.572748,1,voc,237345922,237347182,1260,spec2/voc/Bl122_237345922.jpg,Bl122,4
9093.710241,9093.843241,1,voc,272811307,272815297,3990,spec2/voc/Bl122_272811307.jpg,Bl122,4
5966.957256,5967.218256,1,voc,179008717,179016547,7830,spec2/voc/Bl122_179008717.jpg,Bl122,4
7842.177748,7842.184748,1,voc,235265332,235265542,210,spec2/voc/Bl122_235265332.jpg,Bl122,4
13825.60222,13825.60722,1,voc,414768066,414768216,150,spec2/voc/Bl122_414768066.jpg,Bl122,4
13156.277066,13156.284066,1,voc,394688311,394688521,210,spec2/voc/Bl122_394688311.jpg,Bl122,4
6004.624256,6004.658256,1,voc,180138727,180139747,1020,spec2/voc/Bl122_180138727.jpg,Bl122,4
5964.207256,5964.274256,1,voc,178926217,178928227,2010,spec2/voc/Bl122_178926217.jpg,Bl122,4
8003.552748,8003.563748,1,voc,240106582,240106912,330,spec2/voc/Bl122_240106582.jpg,Bl122,4
13988.629864,13988.681864,1,voc,419658895,419660455,1560,spec2/voc/Bl122_419658895.jpg,Bl122,4
13161.016891,13161.144891,1,voc,394830506,394834346,3840,spec2/voc/Bl122_394830506.jpg,Bl122,4
6099.71915,6099.72115,1,voc,182991574,182991634,60,spec2/voc/Bl122_182991574.jpg,Bl122,4
7847.901748,7847.905748,1,voc,235437052,235437172,120,spec2/voc/Bl122_235437052.jpg,Bl122,4
13818.934617,13818.953617,1,voc,414568038,414568608,570,spec2/voc/Bl122_414568038.jpg,Bl122,4
10943.188807,10943.363807,1,voc,328295664,328300914,5250,spec2/voc/Bl122_328295664.jpg,Bl122,4
6091.49915,6091.50215,1,voc,182744974,182745064,90,spec2/voc/Bl122_182744974.jpg,Bl122,4
5966.167256,5966.181256,1,voc,178985017,178985437,420,spec2/voc/Bl122_178985017.jpg,Bl122,4
3847.626415,3847.648415,1,voc,115428792,115429452,660,spec2/voc/Bl122_115428792.jpg,Bl122,4
10951.173807,10951.353807,1,voc,328535214,328540614,5400,spec2/voc/Bl122_328535214.jpg,Bl122,4
6028.760533,6028.763533,1,voc,180862815,180862905,90,spec2/voc/Bl122_180862815.jpg,Bl122,4
7934.102748,7934.117748,1,voc,238023082,238023532,450,spec2/voc/Bl122_238023082.jpg,Bl122,4
8913.181773,8913.185773,1,voc,267395453,267395573,120,spec2/voc/Bl122_267395453.jpg,Bl122,4
7774.912748,7774.927748,1,voc,233247382,233247832,450,spec2/voc/Bl122_233247382.jpg,Bl122,4
6115.543706,6115.550706,1,voc,183466311,183466521,210,spec2/voc/Bl122_183466311.jpg,Bl122,4
8037.757748,8037.761748,1,voc,241132732,241132852,120,spec2/voc/Bl122_241132732.jpg,Bl122,4
10935.297807,10935.299807,1,voc,328058934,328058994,60,spec2/voc/Bl122_328058934.jpg,Bl122,4
13162.100891,13162.119891,1,voc,394863026,394863596,570,spec2/voc/Bl122_394863026.jpg,Bl122,4
8984.990025,8985.223025,1,voc,269549700,269556690,6990,spec2/voc/Bl122_269549700.jpg,Bl122,4
5978.043256,5978.119256,1,voc,179341297,179343577,2280,spec2/voc/Bl122_179341297.jpg,Bl122,4
6081.125511,6081.142511,1,voc,182433765,182434275,510,spec2/voc/Bl122_182433765.jpg,Bl122,4
6155.774349,6155.810349,1,voc,184673230,184674310,1080,spec2/voc/Bl122_184673230.jpg,Bl122,4
7802.698748,7802.707748,1,voc,234080962,234081232,270,spec2/voc/Bl122_234080962.jpg,Bl122,4
3847.521415,3847.560415,1,voc,115425642,115426812,1170,spec2/voc/Bl122_115425642.jpg,Bl122,4
14815.613551,14815.698551,1,voc,444468406,444470956,2550,spec2/voc/Bl122_444468406.jpg,Bl122,4
3822.416649,3822.432649,1,voc,114672499,114672979,480,spec2/voc/Bl122_114672499.jpg,Bl122,4
12827.741025,12827.976025,1,voc,384832230,384839280,7050,spec2/voc/Bl122_384832230.jpg,Bl122,4
7984.623748,7984.639748,1,voc,239538712,239539192,480,spec2/voc/Bl122_239538712.jpg,Bl122,4
3816.877649,3816.961649,1,voc,114506329,114508849,2520,spec2/voc/Bl122_114506329.jpg,Bl122,4
5963.481256,5963.499256,1,voc,178904437,178904977,540,spec2/voc/Bl122_178904437.jpg,Bl122,4
13156.538066,13156.591066,1,voc,394696141,394697731,1590,spec2/voc/Bl122_394696141.jpg,Bl122,4
6047.8042,6047.8132,1,voc,181434126,181434396,270,spec2/voc/Bl122_181434126.jpg,Bl122,4
13822.45622,13822.53122,1,voc,414673686,414675936,2250,spec2/voc/Bl122_414673686.jpg,Bl122,4
10927.087807,10927.287807,1,voc,327812634,327818634,6000,spec2/voc/Bl122_327812634.jpg,Bl122,4
7853.747748,7853.754748,1,voc,235612432,235612642,210,spec2/voc/Bl122_235612432.jpg,Bl122,4
10907.868825,10907.983825,1,voc,327236064,327239514,3450,spec2/voc/Bl122_327236064.jpg,Bl122,4
3895.139652,3895.221652,1,voc,116854189,116856649,2460,spec2/voc/Bl122_116854189.jpg,Bl122,4
5936.609256,5936.644256,1,voc,178098277,178099327,1050,spec2/voc/Bl122_178098277.jpg,Bl122,4
6033.600533,6033.782533,1,voc,181008015,181013475,5460,spec2/voc/Bl122_181008015.jpg,Bl122,4
9100.342241,9100.608241,1,voc,273010267,273018247,7980,spec2/voc/Bl122_273010267.jpg,Bl122,4
10898.64356,10898.85056,1,voc,326959306,326965516,6210,spec2/voc/Bl122_326959306.jpg,Bl122,4
10913.930807,10913.966807,1,voc,327417924,327419004,1080,spec2/voc/Bl122_327417924.jpg,Bl122,4
9077.901241,9078.148241,1,voc,272337037,272344447,7410,spec2/voc/Bl122_272337037.jpg,Bl122,4
14806.159551,14806.286551,1,voc,444184786,444188596,3810,spec2/voc/Bl122_444184786.jpg,Bl122,4
13975.441117,13975.637117,1,voc,419263233,419269113,5880,spec2/voc/Bl122_419263233.jpg,Bl122,4
13163.528891,13163.532891,1,voc,394905866,394905986,120,spec2/voc/Bl122_394905866.jpg,Bl122,4
13212.694389,13212.882389,1,voc,396380831,396386471,5640,spec2/voc/Bl122_396380831.jpg,Bl122,4
9058.300241,9058.496241,1,voc,271749007,271754887,5880,spec2/voc/Bl122_271749007.jpg,Bl122,4
6200.509327,6200.566327,1,voc,186015279,186016989,1710,spec2/voc/Bl122_186015279.jpg,Bl122,4
7843.809748,7843.845748,1,voc,235314292,235315372,1080,spec2/voc/Bl122_235314292.jpg,Bl122,4
9077.728241,9077.777241,1,voc,272331847,272333317,1470,spec2/voc/Bl122_272331847.jpg,Bl122,4
11933.85457,11933.86657,1,voc,358015637,358015997,360,spec2/voc/Bl122_358015637.jpg,Bl122,4
13204.719389,13205.173389,1,voc,396141581,396155201,13620,spec2/voc/Bl122_396141581.jpg,Bl122,4
8367.584166,8367.598166,1,voc,251027524,251027944,420,spec2/voc/Bl122_251027524.jpg,Bl122,4
8998.435241,8998.447241,1,voc,269953057,269953417,360,spec2/voc/Bl122_269953057.jpg,Bl122,4
7924.293748,7924.376748,1,voc,237728812,237731302,2490,spec2/voc/Bl122_237728812.jpg,Bl122,4
6139.181293,6139.369293,1,voc,184175438,184181078,5640,spec2/voc/Bl122_184175438.jpg,Bl122,4
7932.249748,7932.262748,1,voc,237967492,237967882,390,spec2/voc/Bl122_237967492.jpg,Bl122,4
3794.196649,3794.354649,1,voc,113825899,113830639,4740,spec2/voc/Bl122_113825899.jpg,Bl122,4
10958.886807,10958.893807,1,voc,328766604,328766814,210,spec2/voc/Bl122_328766604.jpg,Bl122,4
7992.521748,7992.527748,1,voc,239775652,239775832,180,spec2/voc/Bl122_239775652.jpg,Bl122,4
7975.979748,7975.989748,1,voc,239279392,239279692,300,spec2/voc/Bl122_239279392.jpg,Bl122,4
6106.875706,6107.351706,1,voc,183206271,183220551,14280,spec2/voc/Bl122_183206271.jpg,Bl122,4
3822.341649,3822.380649,1,voc,114670249,114671419,1170,spec2/voc/Bl122_114670249.jpg,Bl122,4
8361.338263,8361.370263,1,voc,250840147,250841107,960,spec2/voc/Bl122_250840147.jpg,Bl122,4
13218.366389,13218.411389,1,voc,396550991,396552341,1350,spec2/voc/Bl122_396550991.jpg,Bl122,4
3819.665649,3819.673649,1,voc,114589969,114590209,240,spec2/voc/Bl122_114589969.jpg,Bl122,4
6205.500327,6205.510327,1,voc,186165009,186165309,300,spec2/voc/Bl122_186165009.jpg,Bl122,4
14732.732703,14732.812703,1,voc,441981981,441984381,2400,spec2/voc/Bl122_441981981.jpg,Bl122,4
10913.918807,10913.926807,1,voc,327417564,327417804,240,spec2/voc/Bl122_327417564.jpg,Bl122,4
8963.052712,8963.061712,1,voc,268891581,268891851,270,spec2/voc/Bl122_268891581.jpg,Bl122,4
14709.195469,14709.202469,1,voc,441275864,441276074,210,spec2/voc/Bl122_441275864.jpg,Bl122,4
10953.885807,10953.905807,1,voc,328616574,328617174,600,spec2/voc/Bl122_328616574.jpg,Bl122,4
5256.533475,5256.583475,1,voc,157696004,157697504,1500,spec2/voc/Bl122_157696004.jpg,Bl122,4
6021.939533,6021.953533,1,voc,180658185,180658605,420,spec2/voc/Bl122_180658185.jpg,Bl122,4
7869.389748,7869.434748,1,voc,236081692,236083042,1350,spec2/voc/Bl122_236081692.jpg,Bl122,4
9029.925241,9029.936241,1,voc,270897757,270898087,330,spec2/voc/Bl122_270897757.jpg,Bl122,4
14184.049102,14184.122102,1,voc,425521473,425523663,2190,spec2/voc/Bl122_425521473.jpg,Bl122,4
11161.20018,11161.23618,1,voc,334836005,334837085,1080,spec2/voc/Bl122_334836005.jpg,Bl122,4
7789.411748,7789.431748,1,voc,233682352,233682952,600,spec2/voc/Bl122_233682352.jpg,Bl122,4
12591.103947,12591.105947,1,voc,377733118,377733178,60,spec2/voc/Bl122_377733118.jpg,Bl122,4
6098.51115,6098.51915,1,voc,182955334,182955574,240,spec2/voc/Bl122_182955334.jpg,Bl122,4
3796.629649,3796.661649,1,voc,113898889,113899849,960,spec2/voc/Bl122_113898889.jpg,Bl122,4
9067.890241,9067.900241,1,voc,272036707,272037007,300,spec2/voc/Bl122_272036707.jpg,Bl122,4
12640.119849,12640.180849,1,voc,379203595,379205425,1830,spec2/voc/Bl122_379203595.jpg,Bl122,4
10932.894807,10932.934807,1,voc,327986844,327988044,1200,spec2/voc/Bl122_327986844.jpg,Bl122,4
6046.7732,6046.7782,1,voc,181403196,181403346,150,spec2/voc/Bl122_181403196.jpg,Bl122,4
9021.574241,9021.577241,1,voc,270647227,270647317,90,spec2/voc/Bl122_270647227.jpg,Bl122,4
3844.455415,3844.627415,1,voc,115333662,115338822,5160,spec2/voc/Bl122_115333662.jpg,Bl122,4
13817.459617,13817.624617,1,voc,414523788,414528738,4950,spec2/voc/Bl122_414523788.jpg,Bl122,4
6096.93115,6096.94815,1,voc,182907934,182908444,510,spec2/voc/Bl122_182907934.jpg,Bl122,4
8040.797748,8040.809748,1,voc,241223932,241224292,360,spec2/voc/Bl122_241223932.jpg,Bl122,4
7908.292748,7908.295748,1,voc,237248782,237248872,90,spec2/voc/Bl122_237248782.jpg,Bl122,4
7940.125748,7940.129748,1,voc,238203772,238203892,120,spec2/voc/Bl122_238203772.jpg,Bl122,4
9060.705241,9060.741241,1,voc,271821157,271822237,1080,spec2/voc/Bl122_271821157.jpg,Bl122,4
3827.921649,3827.933649,1,voc,114837649,114838009,360,spec2/voc/Bl122_114837649.jpg,Bl122,4
8026.146748,8026.151748,1,voc,240784402,240784552,150,spec2/voc/Bl122_240784402.jpg,Bl122,4
13927.778536,13927.791536,1,voc,417833356,417833746,390,spec2/voc/Bl122_417833356.jpg,Bl122,4
9047.477241,9047.484241,1,voc,271424317,271424527,210,spec2/voc/Bl122_271424317.jpg,Bl122,4
6227.993295,6228.046295,1,voc,186839798,186841388,1590,spec2/voc/Bl122_186839798.jpg,Bl122,4
5938.894256,5938.986256,1,voc,178166827,178169587,2760,spec2/voc/Bl122_178166827.jpg,Bl122,4
3890.379652,3890.386652,1,voc,116711389,116711599,210,spec2/voc/Bl122_116711389.jpg,Bl122,4
6026.248533,6026.259533,1,voc,180787455,180787785,330,spec2/voc/Bl122_180787455.jpg,Bl122,4
3040.891833,3040.897833,1,voc,91226754,91226934,180,spec2/voc/Bl122_91226754.jpg,Bl122,4
6046.0502,6046.1872,1,voc,181381506,181385616,4110,spec2/voc/Bl122_181381506.jpg,Bl122,4
11933.70157,11933.70657,1,voc,358011047,358011197,150,spec2/voc/Bl122_358011047.jpg,Bl122,4
13199.804389,13199.898389,1,voc,395994131,395996951,2820,spec2/voc/Bl122_395994131.jpg,Bl122,4
13195.181662,13195.201662,1,voc,395855449,395856049,600,spec2/voc/Bl122_395855449.jpg,Bl122,4
5946.353256,5946.392256,1,voc,178390597,178391767,1170,spec2/voc/Bl122_178390597.jpg,Bl122,4
13220.621389,13220.728389,1,voc,396618641,396621851,3210,spec2/voc/Bl122_396618641.jpg,Bl122,4
5934.014256,5934.100256,1,voc,178020427,178023007,2580,spec2/voc/Bl122_178020427.jpg,Bl122,4
9065.247241,9065.254241,1,voc,271957417,271957627,210,spec2/voc/Bl122_271957417.jpg,Bl122,4
11157.43218,11157.45518,1,voc,334722965,334723655,690,spec2/voc/Bl122_334722965.jpg,Bl122,4
3797.840649,3797.845649,1,voc,113935219,113935369,150,spec2/voc/Bl122_113935219.jpg,Bl122,4
6069.077705,6069.101705,1,voc,182072331,182073051,720,spec2/voc/Bl122_182072331.jpg,Bl122,4
13915.468392,13915.522392,1,voc,417464051,417465671,1620,spec2/voc/Bl122_417464051.jpg,Bl122,4
11167.80118,11167.80418,1,voc,335034035,335034125,90,spec2/voc/Bl122_335034035.jpg,Bl122,4
13168.185658,13168.372658,1,voc,395045569,395051179,5610,spec2/voc/Bl122_395045569.jpg,Bl122,4
7810.222748,7810.232748,1,voc,234306682,234306982,300,spec2/voc/Bl122_234306682.jpg,Bl122,4
11153.46518,11153.48518,1,voc,334603955,334604555,600,spec2/voc/Bl122_334603955.jpg,Bl122,4
9143.006757,9143.056757,1,voc,274290202,274291702,1500,spec2/voc/Bl122_274290202.jpg,Bl122,4
13956.326384,13956.333384,1,voc,418689791,418690001,210,spec2/voc/Bl122_418689791.jpg,Bl122,4
7843.925748,7843.958748,1,voc,235317772,235318762,990,spec2/voc/Bl122_235317772.jpg,Bl122,4
13818.910617,13818.918617,1,voc,414567318,414567558,240,spec2/voc/Bl122_414567318.jpg,Bl122,4
6107.713706,6107.767706,1,voc,183231411,183233031,1620,spec2/voc/Bl122_183231411.jpg,Bl122,4
13960.509384,13960.533384,1,voc,418815281,418816001,720,spec2/voc/Bl122_418815281.jpg,Bl122,4
14800.246551,14800.259551,1,voc,444007396,444007786,390,spec2/voc/Bl122_444007396.jpg,Bl122,4
9064.606241,9064.628241,1,voc,271938187,271938847,660,spec2/voc/Bl122_271938187.jpg,Bl122,4
3831.571649,3831.586649,1,voc,114947149,114947599,450,spec2/voc/Bl122_114947149.jpg,Bl122,4
14842.084682,14842.086682,1,voc,445262540,445262600,60,spec2/voc/Bl122_445262540.jpg,Bl122,4
8951.133967,8951.139967,1,voc,268534019,268534199,180,spec2/voc/Bl122_268534019.jpg,Bl122,4
7942.982748,7942.985748,1,voc,238289482,238289572,90,spec2/voc/Bl122_238289482.jpg,Bl122,4
13967.535352,13967.538352,1,voc,419026060,419026150,90,spec2/voc/Bl122_419026060.jpg,Bl122,4
10957.265807,10957.276807,1,voc,328717974,328718304,330,spec2/voc/Bl122_328717974.jpg,Bl122,4
5961.079256,5961.094256,1,voc,178832377,178832827,450,spec2/voc/Bl122_178832377.jpg,Bl122,4
13948.482911,13948.484911,1,voc,418454487,418454547,60,spec2/voc/Bl122_418454487.jpg,Bl122,4
14841.532682,14841.559682,1,voc,445245980,445246790,810,spec2/voc/Bl122_445245980.jpg,Bl122,4
6028.221533,6028.226533,1,voc,180846645,180846795,150,spec2/voc/Bl122_180846645.jpg,Bl122,4
8208.702882,8208.708882,1,voc,246261086,246261266,180,spec2/voc/Bl122_246261086.jpg,Bl122,4
7853.530748,7853.565748,1,voc,235605922,235606972,1050,spec2/voc/Bl122_235605922.jpg,Bl122,4
13218.633389,13218.642389,1,voc,396559001,396559271,270,spec2/voc/Bl122_396559001.jpg,Bl122,4
10951.392807,10951.418807,1,voc,328541784,328542564,780,spec2/voc/Bl122_328541784.jpg,Bl122,4
3799.885649,3800.088649,1,voc,113996569,114002659,6090,spec2/voc/Bl122_113996569.jpg,Bl122,4
5950.133256,5950.275256,1,voc,178503997,178508257,4260,spec2/voc/Bl122_178503997.jpg,Bl122,4
6122.047706,6122.073706,1,voc,183661431,183662211,780,spec2/voc/Bl122_183661431.jpg,Bl122,4
9088.597241,9088.624241,1,voc,272657917,272658727,810,spec2/voc/Bl122_272657917.jpg,Bl122,4
7892.238748,7892.252748,1,voc,236767162,236767582,420,spec2/voc/Bl122_236767162.jpg,Bl122,4
9059.050241,9059.058241,1,voc,271771507,271771747,240,spec2/voc/Bl122_271771507.jpg,Bl122,4
13172.928701,13173.057701,1,voc,395187861,395191731,3870,spec2/voc/Bl122_395187861.jpg,Bl122,4
9095.667241,9095.700241,1,voc,272870017,272871007,990,spec2/voc/Bl122_272870017.jpg,Bl122,4
7802.545748,7802.559748,1,voc,234076372,234076792,420,spec2/voc/Bl122_234076372.jpg,Bl122,4
13733.422497,13733.434497,1,voc,412002674,412003034,360,spec2/voc/Bl122_412002674.jpg,Bl122,4
3849.833415,3849.837415,1,voc,115495002,115495122,120,spec2/voc/Bl122_115495002.jpg,Bl122,4
3886.864062,3886.949062,1,voc,116605921,116608471,2550,spec2/voc/Bl122_116605921.jpg,Bl122,4
10924.721807,10924.725807,1,voc,327741654,327741774,120,spec2/voc/Bl122_327741654.jpg,Bl122,4
8978.142025,8978.259025,1,voc,269344260,269347770,3510,spec2/voc/Bl122_269344260.jpg,Bl122,4
5957.395256,5957.532256,1,voc,178721857,178725967,4110,spec2/voc/Bl122_178721857.jpg,Bl122,4
7785.712748,7785.714748,1,voc,233571382,233571442,60,spec2/voc/Bl122_233571382.jpg,Bl122,4
3793.063649,3793.115649,1,voc,113791909,113793469,1560,spec2/voc/Bl122_113791909.jpg,Bl122,4
9049.349241,9049.380241,1,voc,271480477,271481407,930,spec2/voc/Bl122_271480477.jpg,Bl122,4
6197.984327,6198.056327,1,voc,185939529,185941689,2160,spec2/voc/Bl122_185939529.jpg,Bl122,4
11185.36618,11185.37818,1,voc,335560985,335561345,360,spec2/voc/Bl122_335560985.jpg,Bl122,4
9091.418241,9091.421241,1,voc,272742547,272742637,90,spec2/voc/Bl122_272742547.jpg,Bl122,4
3860.290367,3860.670367,1,voc,115808711,115820111,11400,spec2/voc/Bl122_115808711.jpg,Bl122,4
14803.415551,14803.429551,1,voc,444102466,444102886,420,spec2/voc/Bl122_444102466.jpg,Bl122,4
10945.674807,10945.696807,1,voc,328370244,328370904,660,spec2/voc/Bl122_328370244.jpg,Bl122,4
9023.413241,9023.475241,1,voc,270702397,270704257,1860,spec2/voc/Bl122_270702397.jpg,Bl122,4
10880.509609,10880.537609,1,voc,326415288,326416128,840,spec2/voc/Bl122_326415288.jpg,Bl122,4
11132.081005,11132.114005,1,voc,333962430,333963420,990,spec2/voc/Bl122_333962430.jpg,Bl122,4
6083.39615,6083.41615,1,voc,182501884,182502484,600,spec2/voc/Bl122_182501884.jpg,Bl122,4
14841.336682,14841.338682,1,voc,445240100,445240160,60,spec2/voc/Bl122_445240100.jpg,Bl122,4
11175.29418,11175.30218,1,voc,335258825,335259065,240,spec2/voc/Bl122_335258825.jpg,Bl122,4
14790.225551,14790.266551,1,voc,443706766,443707996,1230,spec2/voc/Bl122_443706766.jpg,Bl122,4
14792.651551,14792.749551,1,voc,443779546,443782486,2940,spec2/voc/Bl122_443779546.jpg,Bl122,4
10923.338807,10923.363807,1,voc,327700164,327700914,750,spec2/voc/Bl122_327700164.jpg,Bl122,4
13732.198497,13732.200497,1,voc,411965954,411966014,60,spec2/voc/Bl122_411965954.jpg,Bl122,4
8924.905773,8924.915773,1,voc,267747173,267747473,300,spec2/voc/Bl122_267747173.jpg,Bl122,4
3864.994367,3865.010367,1,voc,115949831,115950311,480,spec2/voc/Bl122_115949831.jpg,Bl122,4
7954.431748,7954.434748,1,voc,238632952,238633042,90,spec2/voc/Bl122_238632952.jpg,Bl122,4
9080.961241,9080.989241,1,voc,272428837,272429677,840,spec2/voc/Bl122_272428837.jpg,Bl122,4
6069.116705,6069.167705,1,voc,182073501,182075031,1530,spec2/voc/Bl122_182073501.jpg,Bl122,4
11210.726894,11210.728894,1,voc,336321806,336321866,60,spec2/voc/Bl122_336321806.jpg,Bl122,4
13206.474389,13206.482389,1,voc,396194231,396194471,240,spec2/voc/Bl122_396194231.jpg,Bl122,4
3846.245415,3846.251415,1,voc,115387362,115387542,180,spec2/voc/Bl122_115387362.jpg,Bl122,4
7961.342748,7961.364748,1,voc,238840282,238840942,660,spec2/voc/Bl122_238840282.jpg,Bl122,4
6223.677295,6223.702295,1,voc,186710318,186711068,750,spec2/voc/Bl122_186710318.jpg,Bl122,4
7846.260748,7846.289748,1,voc,235387822,235388692,870,spec2/voc/Bl122_235387822.jpg,Bl122,4
9149.364842,9149.458842,1,voc,274480945,274483765,2820,spec2/voc/Bl122_274480945.jpg,Bl122,4
13725.99341,13726.22741,1,voc,411779802,411786822,7020,spec2/voc/Bl122_411779802.jpg,Bl122,4
5941.697256,5941.722256,1,voc,178250917,178251667,750,spec2/voc/Bl122_178250917.jpg,Bl122,4
6146.910349,6146.919349,1,voc,184407310,184407580,270,spec2/voc/Bl122_184407310.jpg,Bl122,4
13206.042389,13206.053389,1,voc,396181271,396181601,330,spec2/voc/Bl122_396181271.jpg,Bl122,4
8036.835748,8036.887748,1,voc,241105072,241106632,1560,spec2/voc/Bl122_241105072.jpg,Bl122,4
12588.878377,12588.889377,1,voc,377666351,377666681,330,spec2/voc/Bl122_377666351.jpg,Bl122,4
9122.624182,9122.685182,1,voc,273678725,273680555,1830,spec2/voc/Bl122_273678725.jpg,Bl122,4
6033.426533,6033.435533,1,voc,181002795,181003065,270,spec2/voc/Bl122_181002795.jpg,Bl122,4
9057.889241,9057.894241,1,voc,271736677,271736827,150,spec2/voc/Bl122_271736677.jpg,Bl122,4
6124.979706,6124.992706,1,voc,183749391,183749781,390,spec2/voc/Bl122_183749391.jpg,Bl122,4
3850.682415,3850.695415,1,voc,115520472,115520862,390,spec2/voc/Bl122_115520472.jpg,Bl122,4
11099.991855,11100.004855,1,voc,332999755,333000145,390,spec2/voc/Bl122_332999755.jpg,Bl122,4
8022.714748,8022.720748,1,voc,240681442,240681622,180,spec2/voc/Bl122_240681442.jpg,Bl122,4
13953.235911,13953.286911,1,voc,418597077,418598607,1530,spec2/voc/Bl122_418597077.jpg,Bl122,4
3846.630415,3846.667415,1,voc,115398912,115400022,1110,spec2/voc/Bl122_115398912.jpg,Bl122,4
9060.430241,9060.499241,1,voc,271812907,271814977,2070,spec2/voc/Bl122_271812907.jpg,Bl122,4
6091.49315,6091.49715,1,voc,182744794,182744914,120,spec2/voc/Bl122_182744794.jpg,Bl122,4
6014.070533,6014.120533,1,voc,180422115,180423615,1500,spec2/voc/Bl122_180422115.jpg,Bl122,4
7958.008748,7958.022748,1,voc,238740262,238740682,420,spec2/voc/Bl122_238740262.jpg,Bl122,4
5946.788256,5946.853256,1,voc,178403647,178405597,1950,spec2/voc/Bl122_178403647.jpg,Bl122,4
6174.571327,6174.587327,1,voc,185237139,185237619,480,spec2/voc/Bl122_185237139.jpg,Bl122,4
6124.577706,6124.686706,1,voc,183737331,183740601,3270,spec2/voc/Bl122_183737331.jpg,Bl122,4
9130.440981,9130.592981,1,voc,273913229,273917789,4560,spec2/voc/Bl122_273913229.jpg,Bl122,4
3813.413649,3813.571649,1,voc,114402409,114407149,4740,spec2/voc/Bl122_114402409.jpg,Bl122,4
5942.338256,5942.360256,1,voc,178270147,178270807,660,spec2/voc/Bl122_178270147.jpg,Bl122,4
9038.757241,9038.760241,1,voc,271162717,271162807,90,spec2/voc/Bl122_271162717.jpg,Bl122,4
6014.609533,6014.611533,1,voc,180438285,180438345,60,spec2/voc/Bl122_180438285.jpg,Bl122,4
7924.102748,7924.107748,1,voc,237723082,237723232,150,spec2/voc/Bl122_237723082.jpg,Bl122,4
11971.947625,11972.001625,1,voc,359158428,359160048,1620,spec2/voc/Bl122_359158428.jpg,Bl122,4
14812.484551,14812.587551,1,voc,444374536,444377626,3090,spec2/voc/Bl122_444374536.jpg,Bl122,4
9042.718241,9042.730241,1,voc,271281547,271281907,360,spec2/voc/Bl122_271281547.jpg,Bl122,4
3048.092903,3048.144903,1,voc,91442787,91444347,1560,spec2/voc/Bl122_91442787.jpg,Bl122,4
3886.418062,3886.427062,1,voc,116592541,116592811,270,spec2/voc/Bl122_116592541.jpg,Bl122,4
11148.81818,11149.00418,1,voc,334464545,334470125,5580,spec2/voc/Bl122_334464545.jpg,Bl122,4
9038.678241,9038.681241,1,voc,271160347,271160437,90,spec2/voc/Bl122_271160347.jpg,Bl122,4
10942.569807,10942.580807,1,voc,328277094,328277424,330,spec2/voc/Bl122_328277094.jpg,Bl122,4
6226.415295,6226.417295,1,voc,186792458,186792518,60,spec2/voc/Bl122_186792458.jpg,Bl122,4
11183.47318,11183.48718,1,voc,335504195,335504615,420,spec2/voc/Bl122_335504195.jpg,Bl122,4
9174.727287,9174.786287,1,voc,275241818,275243588,1770,spec2/voc/Bl122_275241818.jpg,Bl122,4
8921.114773,8921.151773,1,voc,267633443,267634553,1110,spec2/voc/Bl122_267633443.jpg,Bl122,4
6080.983511,6080.987511,1,voc,182429505,182429625,120,spec2/voc/Bl122_182429505.jpg,Bl122,4
10906.357825,10906.360825,1,voc,327190734,327190824,90,spec2/voc/Bl122_327190734.jpg,Bl122,4
8924.574773,8924.588773,1,voc,267737243,267737663,420,spec2/voc/Bl122_267737243.jpg,Bl122,4
7845.694748,7845.707748,1,voc,235370842,235371232,390,spec2/voc/Bl122_235370842.jpg,Bl122,4
5971.661256,5971.694256,1,voc,179149837,179150827,990,spec2/voc/Bl122_179149837.jpg,Bl122,4
9035.647241,9035.677241,1,voc,271069417,271070317,900,spec2/voc/Bl122_271069417.jpg,Bl122,4
6062.855705,6062.894705,1,voc,181885671,181886841,1170,spec2/voc/Bl122_181885671.jpg,Bl122,4
3809.277649,3809.317649,1,voc,114278329,114279529,1200,spec2/voc/Bl122_114278329.jpg,Bl122,4
14011.888941,14012.115941,1,voc,420356668,420363478,6810,spec2/voc/Bl122_420356668.jpg,Bl122,4
13208.136389,13208.161389,1,voc,396244091,396244841,750,spec2/voc/Bl122_396244091.jpg,Bl122,4
5944.750256,5944.778256,1,voc,178342507,178343347,840,spec2/voc/Bl122_178342507.jpg,Bl122,4
8985.699025,8985.705025,1,voc,269570970,269571150,180,spec2/voc/Bl122_269570970.jpg,Bl122,4
8979.733025,8979.916025,1,voc,269391990,269397480,5490,spec2/voc/Bl122_269391990.jpg,Bl122,4
6073.647705,6073.722705,1,voc,182209431,182211681,2250,spec2/voc/Bl122_182209431.jpg,Bl122,4
12587.231744,12587.395744,1,voc,377616952,377621872,4920,spec2/voc/Bl122_377616952.jpg,Bl122,4
13723.2119,13723.2239,1,voc,411696357,411696717,360,spec2/voc/Bl122_411696357.jpg,Bl122,4
13221.316389,13221.319389,1,voc,396639491,396639581,90,spec2/voc/Bl122_396639491.jpg,Bl122,4
10918.390807,10918.406807,1,voc,327551724,327552204,480,spec2/voc/Bl122_327551724.jpg,Bl122,4
5987.930256,5987.937256,1,voc,179637907,179638117,210,spec2/voc/Bl122_179637907.jpg,Bl122,4
10898.96656,10899.10256,1,voc,326968996,326973076,4080,spec2/voc/Bl122_326968996.jpg,Bl122,4
14817.851551,14817.857551,1,voc,444535546,444535726,180,spec2/voc/Bl122_444535546.jpg,Bl122,4
6051.0092,6051.0532,1,voc,181530276,181531596,1320,spec2/voc/Bl122_181530276.jpg,Bl122,4
10947.338807,10947.357807,1,voc,328420164,328420734,570,spec2/voc/Bl122_328420164.jpg,Bl122,4
7854.611748,7854.617748,1,voc,235638352,235638532,180,spec2/voc/Bl122_235638352.jpg,Bl122,4
11157.96118,11158.00418,1,voc,334738835,334740125,1290,spec2/voc/Bl122_334738835.jpg,Bl122,4
3897.185652,3897.215652,1,voc,116915569,116916469,900,spec2/voc/Bl122_116915569.jpg,Bl122,4
7798.181748,7798.196748,1,voc,233945452,233945902,450,spec2/voc/Bl122_233945452.jpg,Bl122,4
9007.089241,9007.172241,1,voc,270212677,270215167,2490,spec2/voc/Bl122_270212677.jpg,Bl122,4
14840.305682,14840.503682,1,voc,445209170,445215110,5940,spec2/voc/Bl122_445209170.jpg,Bl122,4
9024.257241,9024.306241,1,voc,270727717,270729187,1470,spec2/voc/Bl122_270727717.jpg,Bl122,4
3798.592649,3798.605649,1,voc,113957779,113958169,390,spec2/voc/Bl122_113957779.jpg,Bl122,4
13826.32522,13826.33822,1,voc,414789756,414790146,390,spec2/voc/Bl122_414789756.jpg,Bl122,4
10888.881136,10888.895136,1,voc,326666434,326666854,420,spec2/voc/Bl122_326666434.jpg,Bl122,4
7828.613748,7828.627748,1,voc,234858412,234858832,420,spec2/voc/Bl122_234858412.jpg,Bl122,4
7785.752748,7785.775748,1,voc,233572582,233573272,690,spec2/voc/Bl122_233572582.jpg,Bl122,4
8925.673773,8925.676773,1,voc,267770213,267770303,90,spec2/voc/Bl122_267770213.jpg,Bl122,4
14801.851551,14801.855551,1,voc,444055546,444055666,120,spec2/voc/Bl122_444055546.jpg,Bl122,4
11100.255855,11100.261855,1,voc,333007675,333007855,180,spec2/voc/Bl122_333007675.jpg,Bl122,4
8027.502748,8027.516748,1,voc,240825082,240825502,420,spec2/voc/Bl122_240825082.jpg,Bl122,4
9051.490241,9051.509241,1,voc,271544707,271545277,570,spec2/voc/Bl122_271544707.jpg,Bl122,4
10875.913466,10876.119466,1,voc,326277403,326283583,6180,spec2/voc/Bl122_326277403.jpg,Bl122,4
3804.685649,3804.719649,1,voc,114140569,114141589,1020,spec2/voc/Bl122_114140569.jpg,Bl122,4
6156.875349,6156.881349,1,voc,184706260,184706440,180,spec2/voc/Bl122_184706260.jpg,Bl122,4
5932.211256,5932.375256,1,voc,177966337,177971257,4920,spec2/voc/Bl122_177966337.jpg,Bl122,4
6049.5382,6049.6302,1,voc,181486146,181488906,2760,spec2/voc/Bl122_181486146.jpg,Bl122,4
9058.742241,9058.752241,1,voc,271762267,271762567,300,spec2/voc/Bl122_271762267.jpg,Bl122,4
9043.320241,9043.324241,1,voc,271299607,271299727,120,spec2/voc/Bl122_271299607.jpg,Bl122,4
10939.772807,10939.913807,1,voc,328193184,328197414,4230,spec2/voc/Bl122_328193184.jpg,Bl122,4
3818.790649,3818.862649,1,voc,114563719,114565879,2160,spec2/voc/Bl122_114563719.jpg,Bl122,4
3842.091415,3842.102415,1,voc,115262742,115263072,330,spec2/voc/Bl122_115262742.jpg,Bl122,4
14815.237551,14815.442551,1,voc,444457126,444463276,6150,spec2/voc/Bl122_444457126.jpg,Bl122,4
14154.984825,14154.992825,1,voc,424649544,424649784,240,spec2/voc/Bl122_424649544.jpg,Bl122,4
3827.698649,3827.705649,1,voc,114830959,114831169,210,spec2/voc/Bl122_114830959.jpg,Bl122,4
7974.517748,7974.521748,1,voc,239235532,239235652,120,spec2/voc/Bl122_239235532.jpg,Bl122,4
7962.117748,7962.122748,1,voc,238863532,238863682,150,spec2/voc/Bl122_238863532.jpg,Bl122,4
7857.007748,7857.009748,1,voc,235710232,235710292,60,spec2/voc/Bl122_235710232.jpg,Bl122,4
3876.347848,3876.350848,1,voc,116290435,116290525,90,spec2/voc/Bl122_116290435.jpg,Bl122,4
13156.104066,13156.122066,1,voc,394683121,394683661,540,spec2/voc/Bl122_394683121.jpg,Bl122,4
6026.527533,6026.546533,1,voc,180795825,180796395,570,spec2/voc/Bl122_180795825.jpg,Bl122,4
13191.159662,13191.164662,1,voc,395734789,395734939,150,spec2/voc/Bl122_395734789.jpg,Bl122,4
11175.68818,11175.85218,1,voc,335270645,335275565,4920,spec2/voc/Bl122_335270645.jpg,Bl122,4
7846.252748,7846.255748,1,voc,235387582,235387672,90,spec2/voc/Bl122_235387582.jpg,Bl122,4
6013.697533,6014.002533,1,voc,180410925,180420075,9150,spec2/voc/Bl122_180410925.jpg,Bl122,4
13208.494389,13208.510389,1,voc,396254831,396255311,480,spec2/voc/Bl122_396254831.jpg,Bl122,4
8928.102773,8928.121773,1,voc,267843083,267843653,570,spec2/voc/Bl122_267843083.jpg,Bl122,4
6200.713327,6200.804327,1,voc,186021399,186024129,2730,spec2/voc/Bl122_186021399.jpg,Bl122,4
14842.581682,14842.613682,1,voc,445277450,445278410,960,spec2/voc/Bl122_445277450.jpg,Bl122,4
7915.606748,7915.631748,1,voc,237468202,237468952,750,spec2/voc/Bl122_237468202.jpg,Bl122,4
13960.071384,13960.287384,1,voc,418802141,418808621,6480,spec2/voc/Bl122_418802141.jpg,Bl122,4
14791.722551,14791.728551,1,voc,443751676,443751856,180,spec2/voc/Bl122_443751676.jpg,Bl122,4
8004.635748,8004.639748,1,voc,240139072,240139192,120,spec2/voc/Bl122_240139072.jpg,Bl122,4
7927.877748,7927.884748,1,voc,237836332,237836542,210,spec2/voc/Bl122_237836332.jpg,Bl122,4
14824.586551,14824.597551,1,voc,444737596,444737926,330,spec2/voc/Bl122_444737596.jpg,Bl122,4
13178.667701,13178.705701,1,voc,395360031,395361171,1140,spec2/voc/Bl122_395360031.jpg,Bl122,4
7911.905748,7911.934748,1,voc,237357172,237358042,870,spec2/voc/Bl122_237357172.jpg,Bl122,4
3802.850649,3802.858649,1,voc,114085519,114085759,240,spec2/voc/Bl122_114085519.jpg,Bl122,4
7798.202748,7798.250748,1,voc,233946082,233947522,1440,spec2/voc/Bl122_233946082.jpg,Bl122,4
6146.761349,6146.793349,1,voc,184402840,184403800,960,spec2/voc/Bl122_184402840.jpg,Bl122,4
8924.067773,8924.085773,1,voc,267722033,267722573,540,spec2/voc/Bl122_267722033.jpg,Bl122,4
10964.663807,10964.696807,1,voc,328939914,328940904,990,spec2/voc/Bl122_328939914.jpg,Bl122,4
7970.271748,7970.343748,1,voc,239108152,239110312,2160,spec2/voc/Bl122_239108152.jpg,Bl122,4
7880.001748,7880.025748,1,voc,236400052,236400772,720,spec2/voc/Bl122_236400052.jpg,Bl122,4
3797.929649,3797.936649,1,voc,113937889,113938099,210,spec2/voc/Bl122_113937889.jpg,Bl122,4
6088.88815,6088.90215,1,voc,182666644,182667064,420,spec2/voc/Bl122_182666644.jpg,Bl122,4
6022.152533,6022.157533,1,voc,180664575,180664725,150,spec2/voc/Bl122_180664575.jpg,Bl122,4
11177.53018,11177.59618,1,voc,335325905,335327885,1980,spec2/voc/Bl122_335325905.jpg,Bl122,4
5971.042256,5971.054256,1,voc,179131267,179131627,360,spec2/voc/Bl122_179131267.jpg,Bl122,4
13946.500911,13946.611911,1,voc,418395027,418398357,3330,spec2/voc/Bl122_418395027.jpg,Bl122,4
10938.179807,10938.198807,1,voc,328145394,328145964,570,spec2/voc/Bl122_328145394.jpg,Bl122,4
3849.565415,3849.569415,1,voc,115486962,115487082,120,spec2/voc/Bl122_115486962.jpg,Bl122,4
6208.372327,6208.386327,1,voc,186251169,186251589,420,spec2/voc/Bl122_186251169.jpg,Bl122,4
7985.683748,7985.696748,1,voc,239570512,239570902,390,spec2/voc/Bl122_239570512.jpg,Bl122,4
13162.071891,13162.090891,1,voc,394862156,394862726,570,spec2/voc/Bl122_394862156.jpg,Bl122,4
13606.080736,13606.092736,1,voc,408182422,408182782,360,spec2/voc/Bl122_408182422.jpg,Bl122,4
5946.411256,5946.647256,1,voc,178392337,178399417,7080,spec2/voc/Bl122_178392337.jpg,Bl122,4
6106.482706,6106.720706,1,voc,183194481,183201621,7140,spec2/voc/Bl122_183194481.jpg,Bl122,4
5939.408256,5939.412256,1,voc,178182247,178182367,120,spec2/voc/Bl122_178182247.jpg,Bl122,4
6186.953327,6186.956327,1,voc,185608599,185608689,90,spec2/voc/Bl122_185608599.jpg,Bl122,4
7807.873748,7807.880748,1,voc,234236212,234236422,210,spec2/voc/Bl122_234236212.jpg,Bl122,4
3792.491649,3792.500649,1,voc,113774749,113775019,270,spec2/voc/Bl122_113774749.jpg,Bl122,4
6228.566295,6228.737295,1,voc,186856988,186862118,5130,spec2/voc/Bl122_186856988.jpg,Bl122,4
3814.077649,3814.083649,1,voc,114422329,114422509,180,spec2/voc/Bl122_114422329.jpg,Bl122,4
8964.931712,8964.934712,1,voc,268947951,268948041,90,spec2/voc/Bl122_268947951.jpg,Bl122,4
6222.376295,6222.396295,1,voc,186671288,186671888,600,spec2/voc/Bl122_186671288.jpg,Bl122,4
9158.284796,9158.341796,1,voc,274748543,274750253,1710,spec2/voc/Bl122_274748543.jpg,Bl122,4
6068.086705,6068.158705,1,voc,182042601,182044761,2160,spec2/voc/Bl122_182042601.jpg,Bl122,4
7886.089748,7886.101748,1,voc,236582692,236583052,360,spec2/voc/Bl122_236582692.jpg,Bl122,4
9079.135241,9079.162241,1,voc,272374057,272374867,810,spec2/voc/Bl122_272374057.jpg,Bl122,4
5982.819256,5982.822256,1,voc,179484577,179484667,90,spec2/voc/Bl122_179484577.jpg,Bl122,4
8916.560773,8916.601773,1,voc,267496823,267498053,1230,spec2/voc/Bl122_267496823.jpg,Bl122,4
7940.003748,7940.028748,1,voc,238200112,238200862,750,spec2/voc/Bl122_238200112.jpg,Bl122,4
5994.818256,5994.851256,1,voc,179844547,179845537,990,spec2/voc/Bl122_179844547.jpg,Bl122,4
3811.316649,3811.319649,1,voc,114339499,114339589,90,spec2/voc/Bl122_114339499.jpg,Bl122,4
7868.087748,7868.093748,1,voc,236042632,236042812,180,spec2/voc/Bl122_236042632.jpg,Bl122,4
13569.623052,13569.802052,1,voc,407088691,407094061,5370,spec2/voc/Bl122_407088691.jpg,Bl122,4
13163.109891,13163.126891,1,voc,394893296,394893806,510,spec2/voc/Bl122_394893296.jpg,Bl122,4
10919.999807,10920.005807,1,voc,327599994,327600174,180,spec2/voc/Bl122_327599994.jpg,Bl122,4
13999.897512,13999.905512,1,voc,419996925,419997165,240,spec2/voc/Bl122_419996925.jpg,Bl122,4
11168.02018,11168.04318,1,voc,335040605,335041295,690,spec2/voc/Bl122_335040605.jpg,Bl122,4
8986.815025,8986.879025,1,voc,269604450,269606370,1920,spec2/voc/Bl122_269604450.jpg,Bl122,4
3867.129367,3867.137367,1,voc,116013881,116014121,240,spec2/voc/Bl122_116013881.jpg,Bl122,4
6073.465705,6073.546705,1,voc,182203971,182206401,2430,spec2/voc/Bl122_182203971.jpg,Bl122,4
8920.483773,8920.507773,1,voc,267614513,267615233,720,spec2/voc/Bl122_267614513.jpg,Bl122,4
10949.691807,10950.044807,1,voc,328490754,328501344,10590,spec2/voc/Bl122_328490754.jpg,Bl122,4
6108.925706,6108.974706,1,voc,183267771,183269241,1470,spec2/voc/Bl122_183267771.jpg,Bl122,4
5978.169256,5978.174256,1,voc,179345077,179345227,150,spec2/voc/Bl122_179345077.jpg,Bl122,4
6117.740706,6117.791706,1,voc,183532221,183533751,1530,spec2/voc/Bl122_183532221.jpg,Bl122,4
5938.744256,5938.749256,1,voc,178162327,178162477,150,spec2/voc/Bl122_178162327.jpg,Bl122,4
10960.520807,10960.542807,1,voc,328815624,328816284,660,spec2/voc/Bl122_328815624.jpg,Bl122,4
10926.993807,10927.022807,1,voc,327809814,327810684,870,spec2/voc/Bl122_327809814.jpg,Bl122,4
9096.793241,9096.799241,1,voc,272903797,272903977,180,spec2/voc/Bl122_272903797.jpg,Bl122,4
6050.5372,6050.5432,1,voc,181516116,181516296,180,spec2/voc/Bl122_181516116.jpg,Bl122,4
11168.13818,11168.15718,1,voc,335044145,335044715,570,spec2/voc/Bl122_335044145.jpg,Bl122,4
7822.872748,7822.885748,1,voc,234686182,234686572,390,spec2/voc/Bl122_234686182.jpg,Bl122,4
11149.42418,11149.50418,1,voc,334482725,334485125,2400,spec2/voc/Bl122_334482725.jpg,Bl122,4
9141.186757,9141.429757,1,voc,274235602,274242892,7290,spec2/voc/Bl122_274235602.jpg,Bl122,4
6114.741706,6114.767706,1,voc,183442251,183443031,780,spec2/voc/Bl122_183442251.jpg,Bl122,4
7977.014748,7977.052748,1,voc,239310442,239311582,1140,spec2/voc/Bl122_239310442.jpg,Bl122,4
7999.610748,7999.620748,1,voc,239988322,239988622,300,spec2/voc/Bl122_239988322.jpg,Bl122,4
7785.841748,7785.858748,1,voc,233575252,233575762,510,spec2/voc/Bl122_233575252.jpg,Bl122,4
5964.368256,5964.529256,1,voc,178931047,178935877,4830,spec2/voc/Bl122_178931047.jpg,Bl122,4
14801.766551,14801.781551,1,voc,444052996,444053446,450,spec2/voc/Bl122_444052996.jpg,Bl122,4
10897.281557,10897.284557,1,voc,326918446,326918536,90,spec2/voc/Bl122_326918446.jpg,Bl122,4
14815.845551,14815.925551,1,voc,444475366,444477766,2400,spec2/voc/Bl122_444475366.jpg,Bl122,4
3801.714649,3801.751649,1,voc,114051439,114052549,1110,spec2/voc/Bl122_114051439.jpg,Bl122,4
8927.799773,8927.824773,1,voc,267833993,267834743,750,spec2/voc/Bl122_267833993.jpg,Bl122,4
5955.744256,5955.749256,1,voc,178672327,178672477,150,spec2/voc/Bl122_178672327.jpg,Bl122,4
3803.327649,3803.666649,1,voc,114099829,114109999,10170,spec2/voc/Bl122_114099829.jpg,Bl122,4
11166.58318,11166.59218,1,voc,334997495,334997765,270,spec2/voc/Bl122_334997495.jpg,Bl122,4
10936.995807,10937.014807,1,voc,328109874,328110444,570,spec2/voc/Bl122_328109874.jpg,Bl122,4
7844.604748,7844.621748,1,voc,235338142,235338652,510,spec2/voc/Bl122_235338142.jpg,Bl122,4
12589.037377,12589.041377,1,voc,377671121,377671241,120,spec2/voc/Bl122_377671121.jpg,Bl122,4
14810.511551,14810.513551,1,voc,444315346,444315406,60,spec2/voc/Bl122_444315346.jpg,Bl122,4
13200.795389,13200.822389,1,voc,396023861,396024671,810,spec2/voc/Bl122_396023861.jpg,Bl122,4
5967.383256,5967.443256,1,voc,179021497,179023297,1800,spec2/voc/Bl122_179021497.jpg,Bl122,4
6112.640706,6112.646706,1,voc,183379221,183379401,180,spec2/voc/Bl122_183379221.jpg,Bl122,4
11196.81618,11196.85518,1,voc,335904485,335905655,1170,spec2/voc/Bl122_335904485.jpg,Bl122,4
6120.557706,6120.560706,1,voc,183616731,183616821,90,spec2/voc/Bl122_183616731.jpg,Bl122,4
8026.032748,8026.037748,1,voc,240780982,240781132,150,spec2/voc/Bl122_240780982.jpg,Bl122,4
6138.544293,6138.554293,1,voc,184156328,184156628,300,spec2/voc/Bl122_184156328.jpg,Bl122,4
8938.272967,8938.277967,1,voc,268148189,268148339,150,spec2/voc/Bl122_268148189.jpg,Bl122,4
6138.129293,6138.148293,1,voc,184143878,184144448,570,spec2/voc/Bl122_184143878.jpg,Bl122,4
14183.587102,14183.818102,1,voc,425507613,425514543,6930,spec2/voc/Bl122_425507613.jpg,Bl122,4
5988.712256,5988.720256,1,voc,179661367,179661607,240,spec2/voc/Bl122_179661367.jpg,Bl122,4
6071.115705,6071.119705,1,voc,182133471,182133591,120,spec2/voc/Bl122_182133471.jpg,Bl122,4
3869.930367,3870.087367,1,voc,116097911,116102621,4710,spec2/voc/Bl122_116097911.jpg,Bl122,4
10964.729807,10964.734807,1,voc,328941894,328942044,150,spec2/voc/Bl122_328941894.jpg,Bl122,4
7785.794748,7785.814748,1,voc,233573842,233574442,600,spec2/voc/Bl122_233573842.jpg,Bl122,4
13221.017389,13221.023389,1,voc,396630521,396630701,180,spec2/voc/Bl122_396630521.jpg,Bl122,4
7995.455748,7995.542748,1,voc,239863672,239866282,2610,spec2/voc/Bl122_239863672.jpg,Bl122,4
5935.255256,5935.260256,1,voc,178057657,178057807,150,spec2/voc/Bl122_178057657.jpg,Bl122,4
3796.446649,3796.449649,1,voc,113893399,113893489,90,spec2/voc/Bl122_113893399.jpg,Bl122,4
6044.0702,6044.0802,1,voc,181322106,181322406,300,spec2/voc/Bl122_181322106.jpg,Bl122,4
8196.39775,8196.46475,1,voc,245891932,245893942,2010,spec2/voc/Bl122_245891932.jpg,Bl122,4
13599.096736,13599.137736,1,voc,407972902,407974132,1230,spec2/voc/Bl122_407972902.jpg,Bl122,4
14142.910775,14143.172775,1,voc,424287323,424295183,7860,spec2/voc/Bl122_424287323.jpg,Bl122,4
13999.977512,14000.159512,1,voc,419999325,420004785,5460,spec2/voc/Bl122_419999325.jpg,Bl122,4
7919.392748,7919.407748,1,voc,237581782,237582232,450,spec2/voc/Bl122_237581782.jpg,Bl122,4
13160.258891,13160.432891,1,voc,394807766,394812986,5220,spec2/voc/Bl122_394807766.jpg,Bl122,4
3863.828367,3863.835367,1,voc,115914851,115915061,210,spec2/voc/Bl122_115914851.jpg,Bl122,4
7906.706748,7906.729748,1,voc,237201202,237201892,690,spec2/voc/Bl122_237201202.jpg,Bl122,4
7802.629748,7802.631748,1,voc,234078892,234078952,60,spec2/voc/Bl122_234078892.jpg,Bl122,4
9069.877241,9069.881241,1,voc,272096317,272096437,120,spec2/voc/Bl122_272096317.jpg,Bl122,4
6009.984533,6010.184533,1,voc,180299535,180305535,6000,spec2/voc/Bl122_180299535.jpg,Bl122,4
5992.359256,5992.384256,1,voc,179770777,179771527,750,spec2/voc/Bl122_179770777.jpg,Bl122,4
8992.621241,8992.759241,1,voc,269778637,269782777,4140,spec2/voc/Bl122_269778637.jpg,Bl122,4
7995.129748,7995.138748,1,voc,239853892,239854162,270,spec2/voc/Bl122_239853892.jpg,Bl122,4
7982.697748,7982.701748,1,voc,239480932,239481052,120,spec2/voc/Bl122_239480932.jpg,Bl122,4
5959.791256,5959.795256,1,voc,178793737,178793857,120,spec2/voc/Bl122_178793737.jpg,Bl122,4
11182.44318,11182.45218,1,voc,335473295,335473565,270,spec2/voc/Bl122_335473295.jpg,Bl122,4
8334.782758,8334.843758,1,voc,250043482,250045312,1830,spec2/voc/Bl122_250043482.jpg,Bl122,4
5981.029256,5981.203256,1,voc,179430877,179436097,5220,spec2/voc/Bl122_179430877.jpg,Bl122,4
7961.616748,7961.638748,1,voc,238848502,238849162,660,spec2/voc/Bl122_238848502.jpg,Bl122,4
6003.042256,6003.085256,1,voc,180091267,180092557,1290,spec2/voc/Bl122_180091267.jpg,Bl122,4
13949.142911,13949.225911,1,voc,418474287,418476777,2490,spec2/voc/Bl122_418474287.jpg,Bl122,4
10955.077807,10955.153807,1,voc,328652334,328654614,2280,spec2/voc/Bl122_328652334.jpg,Bl122,4
10937.506807,10937.517807,1,voc,328125204,328125534,330,spec2/voc/Bl122_328125204.jpg,Bl122,4
10935.643807,10935.666807,1,voc,328069314,328070004,690,spec2/voc/Bl122_328069314.jpg,Bl122,4
3862.251367,3862.483367,1,voc,115867541,115874501,6960,spec2/voc/Bl122_115867541.jpg,Bl122,4
7961.441748,7961.553748,1,voc,238843252,238846612,3360,spec2/voc/Bl122_238843252.jpg,Bl122,4
6104.741706,6104.767706,1,voc,183142251,183143031,780,spec2/voc/Bl122_183142251.jpg,Bl122,4
14795.255551,14795.258551,1,voc,443857666,443857756,90,spec2/voc/Bl122_443857666.jpg,Bl122,4
8969.659712,8969.829712,1,voc,269089791,269094891,5100,spec2/voc/Bl122_269089791.jpg,Bl122,4
10888.715136,10888.876136,1,voc,326661454,326666284,4830,spec2/voc/Bl122_326661454.jpg,Bl122,4
11167.00718,11167.01318,1,voc,335010215,335010395,180,spec2/voc/Bl122_335010215.jpg,Bl122,4
11190.62518,11190.67518,1,voc,335718755,335720255,1500,spec2/voc/Bl122_335718755.jpg,Bl122,4
5951.778256,5951.796256,1,voc,178553347,178553887,540,spec2/voc/Bl122_178553347.jpg,Bl122,4
3895.791652,3895.913652,1,voc,116873749,116877409,3660,spec2/voc/Bl122_116873749.jpg,Bl122,4
8986.907025,8986.915025,1,voc,269607210,269607450,240,spec2/voc/Bl122_269607210.jpg,Bl122,4
9065.001241,9065.034241,1,voc,271950037,271951027,990,spec2/voc/Bl122_271950037.jpg,Bl122,4
5988.308256,5988.315256,1,voc,179649247,179649457,210,spec2/voc/Bl122_179649247.jpg,Bl122,4
5933.079256,5933.085256,1,voc,177992377,177992557,180,spec2/voc/Bl122_177992377.jpg,Bl122,4
8916.206773,8916.216773,1,voc,267486203,267486503,300,spec2/voc/Bl122_267486203.jpg,Bl122,4
10862.751845,10862.848845,1,voc,325882555,325885465,2910,spec2/voc/Bl122_325882555.jpg,Bl122,4
14797.317551,14797.324551,1,voc,443919526,443919736,210,spec2/voc/Bl122_443919526.jpg,Bl122,4
12672.662513,12672.667513,1,voc,380179875,380180025,150,spec2/voc/Bl122_380179875.jpg,Bl122,4
10938.242807,10938.245807,1,voc,328147284,328147374,90,spec2/voc/Bl122_328147284.jpg,Bl122,4
9174.463287,9174.467287,1,voc,275233898,275234018,120,spec2/voc/Bl122_275233898.jpg,Bl122,4
8937.116967,8937.340967,1,voc,268113509,268120229,6720,spec2/voc/Bl122_268113509.jpg,Bl122,4
6003.106256,6003.351256,1,voc,180093187,180100537,7350,spec2/voc/Bl122_180093187.jpg,Bl122,4
14183.459102,14183.559102,1,voc,425503773,425506773,3000,spec2/voc/Bl122_425503773.jpg,Bl122,4
7985.175748,7985.178748,1,voc,239555272,239555362,90,spec2/voc/Bl122_239555272.jpg,Bl122,4
8939.650967,8939.665967,1,voc,268189529,268189979,450,spec2/voc/Bl122_268189529.jpg,Bl122,4
14804.982551,14804.999551,1,voc,444149476,444149986,510,spec2/voc/Bl122_444149476.jpg,Bl122,4
3826.692649,3826.809649,1,voc,114800779,114804289,3510,spec2/voc/Bl122_114800779.jpg,Bl122,4
9038.684241,9038.720241,1,voc,271160527,271161607,1080,spec2/voc/Bl122_271160527.jpg,Bl122,4
6091.51315,6091.55515,1,voc,182745394,182746654,1260,spec2/voc/Bl122_182745394.jpg,Bl122,4
6090.08715,6090.09315,1,voc,182702614,182702794,180,spec2/voc/Bl122_182702614.jpg,Bl122,4
3824.672649,3824.677649,1,voc,114740179,114740329,150,spec2/voc/Bl122_114740179.jpg,Bl122,4
6064.126705,6064.128705,1,voc,181923801,181923861,60,spec2/voc/Bl122_181923801.jpg,Bl122,4
13219.793389,13219.876389,1,voc,396593801,396596291,2490,spec2/voc/Bl122_396593801.jpg,Bl122,4
8962.446712,8962.451712,1,voc,268873401,268873551,150,spec2/voc/Bl122_268873401.jpg,Bl122,4
11148.66818,11148.71718,1,voc,334460045,334461515,1470,spec2/voc/Bl122_334460045.jpg,Bl122,4
3814.102649,3814.106649,1,voc,114423079,114423199,120,spec2/voc/Bl122_114423079.jpg,Bl122,4
13988.598864,13988.607864,1,voc,419657965,419658235,270,spec2/voc/Bl122_419657965.jpg,Bl122,4
11165.00818,11165.03118,1,voc,334950245,334950935,690,spec2/voc/Bl122_334950245.jpg,Bl122,4
11876.56889,11876.60289,1,voc,356297066,356298086,1020,spec2/voc/Bl122_356297066.jpg,Bl122,4
5989.135256,5989.144256,1,voc,179674057,179674327,270,spec2/voc/Bl122_179674057.jpg,Bl122,4
6222.447295,6222.500295,1,voc,186673418,186675008,1590,spec2/voc/Bl122_186673418.jpg,Bl122,4
13603.690736,13603.717736,1,voc,408110722,408111532,810,spec2/voc/Bl122_408110722.jpg,Bl122,4
5947.035256,5947.052256,1,voc,178411057,178411567,510,spec2/voc/Bl122_178411057.jpg,Bl122,4
10951.554807,10951.721807,1,voc,328546644,328551654,5010,spec2/voc/Bl122_328546644.jpg,Bl122,4
13583.859236,13583.870236,1,voc,407515777,407516107,330,spec2/voc/Bl122_407515777.jpg,Bl122,4
5996.306256,5996.323256,1,voc,179889187,179889697,510,spec2/voc/Bl122_179889187.jpg,Bl122,4
3812.525649,3812.625649,1,voc,114375769,114378769,3000,spec2/voc/Bl122_114375769.jpg,Bl122,4
11192.14818,11192.53318,1,voc,335764445,335775995,11550,spec2/voc/Bl122_335764445.jpg,Bl122,4
3806.546649,3806.571649,1,voc,114196399,114197149,750,spec2/voc/Bl122_114196399.jpg,Bl122,4
6000.283256,6000.323256,1,voc,180008497,180009697,1200,spec2/voc/Bl122_180008497.jpg,Bl122,4
5937.553256,5937.608256,1,voc,178126597,178128247,1650,spec2/voc/Bl122_178126597.jpg,Bl122,4
13218.220389,13218.241389,1,voc,396546611,396547241,630,spec2/voc/Bl122_396546611.jpg,Bl122,4
3847.400415,3847.405415,1,voc,115422012,115422162,150,spec2/voc/Bl122_115422012.jpg,Bl122,4
6186.508327,6186.652327,1,voc,185595249,185599569,4320,spec2/voc/Bl122_185595249.jpg,Bl122,4
6035.518533,6035.542533,1,voc,181065555,181066275,720,spec2/voc/Bl122_181065555.jpg,Bl122,4
8013.922748,8013.943748,1,voc,240417682,240418312,630,spec2/voc/Bl122_240417682.jpg,Bl122,4
3814.876649,3814.910649,1,voc,114446299,114447319,1020,spec2/voc/Bl122_114446299.jpg,Bl122,4
6036.203533,6036.208533,1,voc,181086105,181086255,150,spec2/voc/Bl122_181086105.jpg,Bl122,4
7777.261748,7777.268748,1,voc,233317852,233318062,210,spec2/voc/Bl122_233317852.jpg,Bl122,4
5990.785256,5990.789256,1,voc,179723557,179723677,120,spec2/voc/Bl122_179723557.jpg,Bl122,4
14781.562844,14781.783844,1,voc,443446885,443453515,6630,spec2/voc/Bl122_443446885.jpg,Bl122,4
6224.036295,6224.134295,1,voc,186721088,186724028,2940,spec2/voc/Bl122_186721088.jpg,Bl122,4
10881.237609,10881.267609,1,voc,326437128,326438028,900,spec2/voc/Bl122_326437128.jpg,Bl122,4
12672.764513,12672.793513,1,voc,380182935,380183805,870,spec2/voc/Bl122_380182935.jpg,Bl122,4
10944.639807,10944.856807,1,voc,328339194,328345704,6510,spec2/voc/Bl122_328339194.jpg,Bl122,4
10925.903807,10925.952807,1,voc,327777114,327778584,1470,spec2/voc/Bl122_327777114.jpg,Bl122,4
8939.673967,8940.012967,1,voc,268190219,268200389,10170,spec2/voc/Bl122_268190219.jpg,Bl122,4
9113.786184,9113.792184,1,voc,273413585,273413765,180,spec2/voc/Bl122_273413585.jpg,Bl122,4
6169.171327,6169.309327,1,voc,185075139,185079279,4140,spec2/voc/Bl122_185075139.jpg,Bl122,4
8360.683263,8360.705263,1,voc,250820497,250821157,660,spec2/voc/Bl122_250820497.jpg,Bl122,4
13179.094701,13179.097701,1,voc,395372841,395372931,90,spec2/voc/Bl122_395372841.jpg,Bl122,4
6011.416533,6011.423533,1,voc,180342495,180342705,210,spec2/voc/Bl122_180342495.jpg,Bl122,4
9079.006241,9079.098241,1,voc,272370187,272372947,2760,spec2/voc/Bl122_272370187.jpg,Bl122,4
5973.969256,5973.982256,1,voc,179219077,179219467,390,spec2/voc/Bl122_179219077.jpg,Bl122,4
6169.333327,6169.347327,1,voc,185079999,185080419,420,spec2/voc/Bl122_185079999.jpg,Bl122,4
9079.982241,9079.992241,1,voc,272399467,272399767,300,spec2/voc/Bl122_272399467.jpg,Bl122,4
14823.805551,14823.851551,1,voc,444714166,444715546,1380,spec2/voc/Bl122_444714166.jpg,Bl122,4
3867.400367,3867.409367,1,voc,116022011,116022281,270,spec2/voc/Bl122_116022011.jpg,Bl122,4
13961.108384,13961.141384,1,voc,418833251,418834241,990,spec2/voc/Bl122_418833251.jpg,Bl122,4
5938.515256,5938.599256,1,voc,178155457,178157977,2520,spec2/voc/Bl122_178155457.jpg,Bl122,4
14801.365551,14801.549551,1,voc,444040966,444046486,5520,spec2/voc/Bl122_444040966.jpg,Bl122,4
5969.118256,5969.122256,1,voc,179073547,179073667,120,spec2/voc/Bl122_179073547.jpg,Bl122,4
10887.889136,10887.902136,1,voc,326636674,326637064,390,spec2/voc/Bl122_326636674.jpg,Bl122,4
13199.129389,13199.133389,1,voc,395973881,395974001,120,spec2/voc/Bl122_395973881.jpg,Bl122,4
11191.06418,11191.08318,1,voc,335731925,335732495,570,spec2/voc/Bl122_335731925.jpg,Bl122,4
9040.558241,9040.684241,1,voc,271216747,271220527,3780,spec2/voc/Bl122_271216747.jpg,Bl122,4
6132.306293,6132.317293,1,voc,183969188,183969518,330,spec2/voc/Bl122_183969188.jpg,Bl122,4
7962.806748,7962.812748,1,voc,238884202,238884382,180,spec2/voc/Bl122_238884202.jpg,Bl122,4
7940.894748,7940.897748,1,voc,238226842,238226932,90,spec2/voc/Bl122_238226842.jpg,Bl122,4
7884.654748,7884.659748,1,voc,236539642,236539792,150,spec2/voc/Bl122_236539642.jpg,Bl122,4
3895.326652,3895.441652,1,voc,116859799,116863249,3450,spec2/voc/Bl122_116859799.jpg,Bl122,4
6092.20315,6092.20915,1,voc,182766094,182766274,180,spec2/voc/Bl122_182766094.jpg,Bl122,4
6108.700706,6108.710706,1,voc,183261021,183261321,300,spec2/voc/Bl122_183261021.jpg,Bl122,4
7813.599748,7813.608748,1,voc,234407992,234408262,270,spec2/voc/Bl122_234407992.jpg,Bl122,4
10951.812807,10951.837807,1,voc,328554384,328555134,750,spec2/voc/Bl122_328554384.jpg,Bl122,4
10940.765807,10940.778807,1,voc,328222974,328223364,390,spec2/voc/Bl122_328222974.jpg,Bl122,4
8929.285773,8929.367773,1,voc,267878573,267881033,2460,spec2/voc/Bl122_267878573.jpg,Bl122,4
9044.834241,9044.837241,1,voc,271345027,271345117,90,spec2/voc/Bl122_271345027.jpg,Bl122,4
5938.091256,5938.318256,1,voc,178142737,178149547,6810,spec2/voc/Bl122_178142737.jpg,Bl122,4
5941.487256,5941.490256,1,voc,178244617,178244707,90,spec2/voc/Bl122_178244617.jpg,Bl122,4
9099.158241,9099.167241,1,voc,272974747,272975017,270,spec2/voc/Bl122_272974747.jpg,Bl122,4
3836.459415,3836.539415,1,voc,115093782,115096182,2400,spec2/voc/Bl122_115093782.jpg,Bl122,4
9010.780241,9010.813241,1,voc,270323407,270324397,990,spec2/voc/Bl122_270323407.jpg,Bl122,4
6072.123705,6072.190705,1,voc,182163711,182165721,2010,spec2/voc/Bl122_182163711.jpg,Bl122,4
7922.535748,7922.556748,1,voc,237676072,237676702,630,spec2/voc/Bl122_237676072.jpg,Bl122,4
14843.552682,14843.554682,1,voc,445306580,445306640,60,spec2/voc/Bl122_445306580.jpg,Bl122,4
6035.963533,6036.082533,1,voc,181078905,181082475,3570,spec2/voc/Bl122_181078905.jpg,Bl122,4
5988.417256,5988.490256,1,voc,179652517,179654707,2190,spec2/voc/Bl122_179652517.jpg,Bl122,4
10906.721825,10906.737825,1,voc,327201654,327202134,480,spec2/voc/Bl122_327201654.jpg,Bl122,4
3817.364649,3817.394649,1,voc,114520939,114521839,900,spec2/voc/Bl122_114520939.jpg,Bl122,4
8361.579263,8361.638263,1,voc,250847377,250849147,1770,spec2/voc/Bl122_250847377.jpg,Bl122,4
8955.532967,8955.536967,1,voc,268665989,268666109,120,spec2/voc/Bl122_268665989.jpg,Bl122,4
7937.288748,7937.303748,1,voc,238118662,238119112,450,spec2/voc/Bl122_238118662.jpg,Bl122,4
10880.925609,10881.120609,1,voc,326427768,326433618,5850,spec2/voc/Bl122_326427768.jpg,Bl122,4
5960.188256,5960.229256,1,voc,178805647,178806877,1230,spec2/voc/Bl122_178805647.jpg,Bl122,4
3843.113415,3843.137415,1,voc,115293402,115294122,720,spec2/voc/Bl122_115293402.jpg,Bl122,4
3176.861448,3176.864448,1,voc,95305843,95305933,90,spec2/voc/Bl122_95305843.jpg,Bl122,4
9071.344241,9071.369241,1,voc,272140327,272141077,750,spec2/voc/Bl122_272140327.jpg,Bl122,4
9097.631241,9097.637241,1,voc,272928937,272929117,180,spec2/voc/Bl122_272928937.jpg,Bl122,4
8209.030882,8209.062882,1,voc,246270926,246271886,960,spec2/voc/Bl122_246270926.jpg,Bl122,4
13817.929617,13817.933617,1,voc,414537888,414538008,120,spec2/voc/Bl122_414537888.jpg,Bl122,4
13744.280896,13744.344896,1,voc,412328426,412330346,1920,spec2/voc/Bl122_412328426.jpg,Bl122,4
6067.958705,6068.027705,1,voc,182038761,182040831,2070,spec2/voc/Bl122_182038761.jpg,Bl122,4
12939.350352,12939.357352,1,voc,388180510,388180720,210,spec2/voc/Bl122_388180510.jpg,Bl122,4
11203.929894,11203.931894,1,voc,336117896,336117956,60,spec2/voc/Bl122_336117896.jpg,Bl122,4
6182.211327,6182.268327,1,voc,185466339,185468049,1710,spec2/voc/Bl122_185466339.jpg,Bl122,4
13938.7789,13938.7849,1,voc,418163367,418163547,180,spec2/voc/Bl122_418163367.jpg,Bl122,4
6189.943327,6190.000327,1,voc,185698299,185700009,1710,spec2/voc/Bl122_185698299.jpg,Bl122,4
7866.946748,7866.949748,1,voc,236008402,236008492,90,spec2/voc/Bl122_236008402.jpg,Bl122,4
11100.008855,11100.035855,1,voc,333000265,333001075,810,spec2/voc/Bl122_333000265.jpg,Bl122,4
8013.457748,8013.569748,1,voc,240403732,240407092,3360,spec2/voc/Bl122_240403732.jpg,Bl122,4
9161.266057,9161.306057,1,voc,274837981,274839181,1200,spec2/voc/Bl122_274837981.jpg,Bl122,4
6181.317327,6181.612327,1,voc,185439519,185448369,8850,spec2/voc/Bl122_185439519.jpg,Bl122,4
6083.34015,6083.35515,1,voc,182500204,182500654,450,spec2/voc/Bl122_182500204.jpg,Bl122,4
11203.874894,11203.923894,1,voc,336116246,336117716,1470,spec2/voc/Bl122_336116246.jpg,Bl122,4
6091.71615,6091.77415,1,voc,182751484,182753224,1740,spec2/voc/Bl122_182751484.jpg,Bl122,4
12661.524535,12661.529535,1,voc,379845736,379845886,150,spec2/voc/Bl122_379845736.jpg,Bl122,4
6170.986327,6170.999327,1,voc,185129589,185129979,390,spec2/voc/Bl122_185129589.jpg,Bl122,4
8928.260773,8928.271773,1,voc,267847823,267848153,330,spec2/voc/Bl122_267847823.jpg,Bl122,4
6027.805533,6027.817533,1,voc,180834165,180834525,360,spec2/voc/Bl122_180834165.jpg,Bl122,4
14154.728825,14154.731825,1,voc,424641864,424641954,90,spec2/voc/Bl122_424641864.jpg,Bl122,4
11863.141519,11863.238519,1,voc,355894245,355897155,2910,spec2/voc/Bl122_355894245.jpg,Bl122,4
13217.742389,13217.791389,1,voc,396532271,396533741,1470,spec2/voc/Bl122_396532271.jpg,Bl122,4
13826.06422,13826.07022,1,voc,414781926,414782106,180,spec2/voc/Bl122_414781926.jpg,Bl122,4
13218.851389,13218.878389,1,voc,396565541,396566351,810,spec2/voc/Bl122_396565541.jpg,Bl122,4
13163.361891,13163.382891,1,voc,394900856,394901486,630,spec2/voc/Bl122_394900856.jpg,Bl122,4
12640.294849,12640.318849,1,voc,379208845,379209565,720,spec2/voc/Bl122_379208845.jpg,Bl122,4
9060.641241,9060.644241,1,voc,271819237,271819327,90,spec2/voc/Bl122_271819237.jpg,Bl122,4
10930.147807,10930.329807,1,voc,327904434,327909894,5460,spec2/voc/Bl122_327904434.jpg,Bl122,4
7961.107748,7961.194748,1,voc,238833232,238835842,2610,spec2/voc/Bl122_238833232.jpg,Bl122,4
14825.363551,14825.367551,1,voc,444760906,444761026,120,spec2/voc/Bl122_444760906.jpg,Bl122,4
8996.330241,8996.479241,1,voc,269889907,269894377,4470,spec2/voc/Bl122_269889907.jpg,Bl122,4
7962.124748,7962.134748,1,voc,238863742,238864042,300,spec2/voc/Bl122_238863742.jpg,Bl122,4
12589.125377,12589.286377,1,voc,377673761,377678591,4830,spec2/voc/Bl122_377673761.jpg,Bl122,4
5990.522256,5990.526256,1,voc,179715667,179715787,120,spec2/voc/Bl122_179715667.jpg,Bl122,4
11162.61418,11162.62618,1,voc,334878425,334878785,360,spec2/voc/Bl122_334878425.jpg,Bl122,4
9158.713796,9158.900796,1,voc,274761413,274767023,5610,spec2/voc/Bl122_274761413.jpg,Bl122,4
9069.586241,9069.594241,1,voc,272087587,272087827,240,spec2/voc/Bl122_272087587.jpg,Bl122,4
3794.880649,3794.982649,1,voc,113846419,113849479,3060,spec2/voc/Bl122_113846419.jpg,Bl122,4
6143.433349,6143.439349,1,voc,184303000,184303180,180,spec2/voc/Bl122_184303000.jpg,Bl122,4
7813.525748,7813.531748,1,voc,234405772,234405952,180,spec2/voc/Bl122_234405772.jpg,Bl122,4
6108.735706,6108.764706,1,voc,183262071,183262941,870,spec2/voc/Bl122_183262071.jpg,Bl122,4
6009.600533,6009.715533,1,voc,180288015,180291465,3450,spec2/voc/Bl122_180288015.jpg,Bl122,4
9062.973241,9062.977241,1,voc,271889197,271889317,120,spec2/voc/Bl122_271889197.jpg,Bl122,4
13988.505864,13988.522864,1,voc,419655175,419655685,510,spec2/voc/Bl122_419655175.jpg,Bl122,4
8036.075748,8036.078748,1,voc,241082272,241082362,90,spec2/voc/Bl122_241082272.jpg,Bl122,4
8962.462712,8962.722712,1,voc,268873881,268881681,7800,spec2/voc/Bl122_268873881.jpg,Bl122,4
6225.252295,6225.260295,1,voc,186757568,186757808,240,spec2/voc/Bl122_186757568.jpg,Bl122,4
7855.059748,7855.064748,1,voc,235651792,235651942,150,spec2/voc/Bl122_235651792.jpg,Bl122,4
14000.171512,14000.177512,1,voc,420005145,420005325,180,spec2/voc/Bl122_420005145.jpg,Bl122,4
9049.080241,9049.086241,1,voc,271472407,271472587,180,spec2/voc/Bl122_271472407.jpg,Bl122,4
6208.028327,6208.035327,1,voc,186240849,186241059,210,spec2/voc/Bl122_186240849.jpg,Bl122,4
13827.45522,13827.47422,1,voc,414823656,414824226,570,spec2/voc/Bl122_414823656.jpg,Bl122,4
6154.539349,6154.541349,1,voc,184636180,184636240,60,spec2/voc/Bl122_184636180.jpg,Bl122,4
6068.227705,6068.283705,1,voc,182046831,182048511,1680,spec2/voc/Bl122_182046831.jpg,Bl122,4
6154.867349,6154.875349,1,voc,184646020,184646260,240,spec2/voc/Bl122_184646020.jpg,Bl122,4
14149.067855,14149.071855,1,voc,424472035,424472155,120,spec2/voc/Bl122_424472035.jpg,Bl122,4
14838.994682,14838.998682,1,voc,445169840,445169960,120,spec2/voc/Bl122_445169840.jpg,Bl122,4
11130.689005,11130.714005,1,voc,333920670,333921420,750,spec2/voc/Bl122_333920670.jpg,Bl122,4
9090.066241,9090.079241,1,voc,272701987,272702377,390,spec2/voc/Bl122_272701987.jpg,Bl122,4
6106.732706,6106.738706,1,voc,183201981,183202161,180,spec2/voc/Bl122_183201981.jpg,Bl122,4
5936.086256,5936.313256,1,voc,178082587,178089397,6810,spec2/voc/Bl122_178082587.jpg,Bl122,4
9149.356842,9149.359842,1,voc,274480705,274480795,90,spec2/voc/Bl122_274480705.jpg,Bl122,4
7961.714748,7961.728748,1,voc,238851442,238851862,420,spec2/voc/Bl122_238851442.jpg,Bl122,4
3808.365649,3808.397649,1,voc,114250969,114251929,960,spec2/voc/Bl122_114250969.jpg,Bl122,4
8993.717241,8993.722241,1,voc,269811517,269811667,150,spec2/voc/Bl122_269811517.jpg,Bl122,4
5938.670256,5938.687256,1,voc,178160107,178160617,510,spec2/voc/Bl122_178160107.jpg,Bl122,4
7976.899748,7976.933748,1,voc,239306992,239308012,1020,spec2/voc/Bl122_239306992.jpg,Bl122,4
9021.052241,9021.199241,1,voc,270631567,270635977,4410,spec2/voc/Bl122_270631567.jpg,Bl122,4
8014.865748,8014.914748,1,voc,240445972,240447442,1470,spec2/voc/Bl122_240445972.jpg,Bl122,4
10935.870807,10935.893807,1,voc,328076124,328076814,690,spec2/voc/Bl122_328076124.jpg,Bl122,4
11203.504894,11203.518894,1,voc,336105146,336105566,420,spec2/voc/Bl122_336105146.jpg,Bl122,4
12591.551947,12591.561947,1,voc,377746558,377746858,300,spec2/voc/Bl122_377746558.jpg,Bl122,4
7813.306748,7813.308748,1,voc,234399202,234399262,60,spec2/voc/Bl122_234399202.jpg,Bl122,4
8365.002015,8365.124015,1,voc,250950060,250953720,3660,spec2/voc/Bl122_250950060.jpg,Bl122,4
14709.296469,14709.409469,1,voc,441278894,441282284,3390,spec2/voc/Bl122_441278894.jpg,Bl122,4
13960.593384,13960.645384,1,voc,418817801,418819361,1560,spec2/voc/Bl122_418817801.jpg,Bl122,4
12619.64299,12619.70699,1,voc,378589289,378591209,1920,spec2/voc/Bl122_378589289.jpg,Bl122,4
14700.051324,14700.053324,1,voc,441001539,441001599,60,spec2/voc/Bl122_441001539.jpg,Bl122,4
6045.9232,6046.0392,1,voc,181377696,181381176,3480,spec2/voc/Bl122_181377696.jpg,Bl122,4
9124.592182,9124.595182,1,voc,273737765,273737855,90,spec2/voc/Bl122_273737765.jpg,Bl122,4
7970.138748,7970.143748,1,voc,239104162,239104312,150,spec2/voc/Bl122_239104162.jpg,Bl122,4
6154.477349,6154.506349,1,voc,184634320,184635190,870,spec2/voc/Bl122_184634320.jpg,Bl122,4
3843.199415,3843.221415,1,voc,115295982,115296642,660,spec2/voc/Bl122_115295982.jpg,Bl122,4
6197.063327,6197.156327,1,voc,185911899,185914689,2790,spec2/voc/Bl122_185911899.jpg,Bl122,4
7983.658748,7983.666748,1,voc,239509762,239510002,240,spec2/voc/Bl122_239509762.jpg,Bl122,4
9003.469241,9003.494241,1,voc,270104077,270104827,750,spec2/voc/Bl122_270104077.jpg,Bl122,4
11211.935894,11211.957894,1,voc,336358076,336358736,660,spec2/voc/Bl122_336358076.jpg,Bl122,4
11142.798955,11142.836955,1,voc,334283968,334285108,1140,spec2/voc/Bl122_334283968.jpg,Bl122,4
6029.936533,6030.109533,1,voc,180898095,180903285,5190,spec2/voc/Bl122_180898095.jpg,Bl122,4
5979.185256,5979.190256,1,voc,179375557,179375707,150,spec2/voc/Bl122_179375557.jpg,Bl122,4
3824.682649,3824.687649,1,voc,114740479,114740629,150,spec2/voc/Bl122_114740479.jpg,Bl122,4
5945.199256,5945.203256,1,voc,178355977,178356097,120,spec2/voc/Bl122_178355977.jpg,Bl122,4
6066.996705,6067.003705,1,voc,182009901,182010111,210,spec2/voc/Bl122_182009901.jpg,Bl122,4
7964.440748,7964.447748,1,voc,238933222,238933432,210,spec2/voc/Bl122_238933222.jpg,Bl122,4
10915.038807,10915.056807,1,voc,327451164,327451704,540,spec2/voc/Bl122_327451164.jpg,Bl122,4
14362.041031,14362.085031,1,voc,430861230,430862550,1320,spec2/voc/Bl122_430861230.jpg,Bl122,4
8929.769773,8929.783773,1,voc,267893093,267893513,420,spec2/voc/Bl122_267893093.jpg,Bl122,4
6034.827533,6035.095533,1,voc,181044825,181052865,8040,spec2/voc/Bl122_181044825.jpg,Bl122,4
6024.975533,6025.166533,1,voc,180749265,180754995,5730,spec2/voc/Bl122_180749265.jpg,Bl122,4
7961.206748,7961.209748,1,voc,238836202,238836292,90,spec2/voc/Bl122_238836202.jpg,Bl122,4
5939.048256,5939.295256,1,voc,178171447,178178857,7410,spec2/voc/Bl122_178171447.jpg,Bl122,4
7941.204748,7941.206748,1,voc,238236142,238236202,60,spec2/voc/Bl122_238236142.jpg,Bl122,4
6173.831327,6173.919327,1,voc,185214939,185217579,2640,spec2/voc/Bl122_185214939.jpg,Bl122,4
6181.251327,6181.254327,1,voc,185437539,185437629,90,spec2/voc/Bl122_185437539.jpg,Bl122,4
13564.163867,13564.201867,1,voc,406924916,406926056,1140,spec2/voc/Bl122_406924916.jpg,Bl122,4
13999.219512,13999.222512,1,voc,419976585,419976675,90,spec2/voc/Bl122_419976585.jpg,Bl122,4
12939.469352,12939.475352,1,voc,388184080,388184260,180,spec2/voc/Bl122_388184080.jpg,Bl122,4
9071.669241,9071.672241,1,voc,272150077,272150167,90,spec2/voc/Bl122_272150077.jpg,Bl122,4
8983.190025,8983.470025,1,voc,269495700,269504100,8400,spec2/voc/Bl122_269495700.jpg,Bl122,4
8992.501241,8992.531241,1,voc,269775037,269775937,900,spec2/voc/Bl122_269775037.jpg,Bl122,4
3870.555367,3870.569367,1,voc,116116661,116117081,420,spec2/voc/Bl122_116116661.jpg,Bl122,4
9100.940241,9100.952241,1,voc,273028207,273028567,360,spec2/voc/Bl122_273028207.jpg,Bl122,4
5983.048256,5983.054256,1,voc,179491447,179491627,180,spec2/voc/Bl122_179491447.jpg,Bl122,4
5963.852256,5963.859256,1,voc,178915567,178915777,210,spec2/voc/Bl122_178915567.jpg,Bl122,4
6108.558706,6108.574706,1,voc,183256761,183257241,480,spec2/voc/Bl122_183256761.jpg,Bl122,4
6191.495327,6191.525327,1,voc,185744859,185745759,900,spec2/voc/Bl122_185744859.jpg,Bl122,4
6140.593349,6140.659349,1,voc,184217800,184219780,1980,spec2/voc/Bl122_184217800.jpg,Bl122,10
6056.899705,6056.951705,1,voc,181706991,181708551,1560,spec2/voc/Bl122_181706991.jpg,Bl122,10
7959.295748,7959.299748,1,voc,238778872,238778992,120,spec2/voc/Bl122_238778872.jpg,Bl122,10
10923.322807,10923.324807,1,voc,327699684,327699744,60,spec2/voc/Bl122_327699684.jpg,Bl122,10
5939.310256,5939.317256,1,voc,178179307,178179517,210,spec2/voc/Bl122_178179307.jpg,Bl122,10
9040.313241,9040.330241,1,voc,271209397,271209907,510,spec2/voc/Bl122_271209397.jpg,Bl122,10
5948.255256,5948.263256,1,voc,178447657,178447897,240,spec2/voc/Bl122_178447657.jpg,Bl122,10
5991.882256,5991.911256,1,voc,179756467,179757337,870,spec2/voc/Bl122_179756467.jpg,Bl122,10
6110.808706,6110.814706,1,voc,183324261,183324441,180,spec2/voc/Bl122_183324261.jpg,Bl122,10
14817.993551,14818.078551,1,voc,444539806,444542356,2550,spec2/voc/Bl122_444539806.jpg,Bl122,10
9078.960241,9078.973241,1,voc,272368807,272369197,390,spec2/voc/Bl122_272368807.jpg,Bl122,10
13733.663497,13733.795497,1,voc,412009904,412013864,3960,spec2/voc/Bl122_412009904.jpg,Bl122,10
13161.947891,13161.959891,1,voc,394858436,394858796,360,spec2/voc/Bl122_394858436.jpg,Bl122,10
6200.582327,6200.585327,1,voc,186017469,186017559,90,spec2/voc/Bl122_186017469.jpg,Bl122,10
13199.590389,13199.593389,1,voc,395987711,395987801,90,spec2/voc/Bl122_395987711.jpg,Bl122,10
6057.919705,6057.921705,1,voc,181737591,181737651,60,spec2/voc/Bl122_181737591.jpg,Bl122,10
9033.772241,9033.967241,1,voc,271013167,271019017,5850,spec2/voc/Bl122_271013167.jpg,Bl122,10
13583.530236,13583.545236,1,voc,407505907,407506357,450,spec2/voc/Bl122_407505907.jpg,Bl122,10
12627.525577,12627.533577,1,voc,378825767,378826007,240,spec2/voc/Bl122_378825767.jpg,Bl122,10
9071.694241,9071.726241,1,voc,272150827,272151787,960,spec2/voc/Bl122_272150827.jpg,Bl122,10
13170.292701,13170.310701,1,voc,395108781,395109321,540,spec2/voc/Bl122_395108781.jpg,Bl122,10
6069.174705,6069.218705,1,voc,182075241,182076561,1320,spec2/voc/Bl122_182075241.jpg,Bl122,10
7781.462748,7781.467748,1,voc,233443882,233444032,150,spec2/voc/Bl122_233443882.jpg,Bl122,10
6050.2592,6050.2702,1,voc,181507776,181508106,330,spec2/voc/Bl122_181507776.jpg,Bl122,10
11142.883955,11142.899955,1,voc,334286518,334286998,480,spec2/voc/Bl122_334286518.jpg,Bl122,10
10958.509807,10958.737807,1,voc,328755294,328762134,6840,spec2/voc/Bl122_328755294.jpg,Bl122,10
13217.917389,13218.038389,1,voc,396537521,396541151,3630,spec2/voc/Bl122_396537521.jpg,Bl122,10
6041.215065,6041.221065,1,voc,181236451,181236631,180,spec2/voc/Bl122_181236451.jpg,Bl122,10
8918.566773,8918.616773,1,voc,267557003,267558503,1500,spec2/voc/Bl122_267557003.jpg,Bl122,10
8025.469748,8025.472748,1,voc,240764092,240764182,90,spec2/voc/Bl122_240764092.jpg,Bl122,10
9151.621842,9151.630842,1,voc,274548655,274548925,270,spec2/voc/Bl122_274548655.jpg,Bl122,10
10888.003136,10888.023136,1,voc,326640094,326640694,600,spec2/voc/Bl122_326640094.jpg,Bl122,10
10884.981162,10885.078162,1,voc,326549434,326552344,2910,spec2/voc/Bl122_326549434.jpg,Bl122,10
5934.295256,5934.403256,1,voc,178028857,178032097,3240,spec2/voc/Bl122_178028857.jpg,Bl122,10
9090.793241,9090.815241,1,voc,272723797,272724457,660,spec2/voc/Bl122_272723797.jpg,Bl122,10
7968.527748,7968.536748,1,voc,239055832,239056102,270,spec2/voc/Bl122_239055832.jpg,Bl122,10
14156.705825,14156.725825,1,voc,424701174,424701774,600,spec2/voc/Bl122_424701174.jpg,Bl122,10
9029.276241,9029.296241,1,voc,270878287,270878887,600,spec2/voc/Bl122_270878287.jpg,Bl122,10
13584.263236,13584.456236,1,voc,407527897,407533687,5790,spec2/voc/Bl122_407527897.jpg,Bl122,10
13604.097736,13604.161736,1,voc,408122932,408124852,1920,spec2/voc/Bl122_408122932.jpg,Bl122,10
7954.008748,7954.013748,1,voc,238620262,238620412,150,spec2/voc/Bl122_238620262.jpg,Bl122,10
14732.407703,14732.567703,1,voc,441972231,441977031,4800,spec2/voc/Bl122_441972231.jpg,Bl122,10
12939.604352,12939.613352,1,voc,388188130,388188400,270,spec2/voc/Bl122_388188130.jpg,Bl122,10
13966.292352,13966.296352,1,voc,418988770,418988890,120,spec2/voc/Bl122_418988770.jpg,Bl122,10
8980.876025,8980.879025,1,voc,269426280,269426370,90,spec2/voc/Bl122_269426280.jpg,Bl122,10
9178.275321,9178.444321,1,voc,275348259,275353329,5070,spec2/voc/Bl122_275348259.jpg,Bl122,10
10886.082162,10886.181162,1,voc,326582464,326585434,2970,spec2/voc/Bl122_326582464.jpg,Bl122,10
3821.889649,3821.990649,1,voc,114656689,114659719,3030,spec2/voc/Bl122_114656689.jpg,Bl122,10
14792.997551,14793.055551,1,voc,443789926,443791666,1740,spec2/voc/Bl122_443789926.jpg,Bl122,10
5988.359256,5988.362256,1,voc,179650777,179650867,90,spec2/voc/Bl122_179650777.jpg,Bl122,10
3806.039649,3806.046649,1,voc,114181189,114181399,210,spec2/voc/Bl122_114181189.jpg,Bl122,10
5996.743256,5996.791256,1,voc,179902297,179903737,1440,spec2/voc/Bl122_179902297.jpg,Bl122,10
6138.597293,6138.607293,1,voc,184157918,184158218,300,spec2/voc/Bl122_184157918.jpg,Bl122,10
8926.708773,8926.804773,1,voc,267801263,267804143,2880,spec2/voc/Bl122_267801263.jpg,Bl122,10
6145.707349,6145.731349,1,voc,184371220,184371940,720,spec2/voc/Bl122_184371220.jpg,Bl122,10
6032.198533,6032.208533,1,voc,180965955,180966255,300,spec2/voc/Bl122_180965955.jpg,Bl122,10
8031.743748,8031.754748,1,voc,240952312,240952642,330,spec2/voc/Bl122_240952312.jpg,Bl122,10
6109.721706,6109.734706,1,voc,183291651,183292041,390,spec2/voc/Bl122_183291651.jpg,Bl122,10
6160.972349,6161.388349,1,voc,184829170,184841650,12480,spec2/voc/Bl122_184829170.jpg,Bl122,10
13177.215701,13177.235701,1,voc,395316471,395317071,600,spec2/voc/Bl122_395316471.jpg,Bl122,10
10931.130807,10931.322807,1,voc,327933924,327939684,5760,spec2/voc/Bl122_327933924.jpg,Bl122,10
10940.415807,10940.476807,1,voc,328212474,328214304,1830,spec2/voc/Bl122_328212474.jpg,Bl122,10
14819.518551,14819.782551,1,voc,444585556,444593476,7920,spec2/voc/Bl122_444585556.jpg,Bl122,10
7906.787748,7906.797748,1,voc,237203632,237203932,300,spec2/voc/Bl122_237203632.jpg,Bl122,10
6119.236706,6119.260706,1,voc,183577101,183577821,720,spec2/voc/Bl122_183577101.jpg,Bl122,10
9008.730241,9008.976241,1,voc,270261907,270269287,7380,spec2/voc/Bl122_270261907.jpg,Bl122,10
13565.995867,13566.063867,1,voc,406979876,406981916,2040,spec2/voc/Bl122_406979876.jpg,Bl122,10
12939.063352,12939.085352,1,voc,388171900,388172560,660,spec2/voc/Bl122_388171900.jpg,Bl122,10
7994.311748,7994.317748,1,voc,239829352,239829532,180,spec2/voc/Bl122_239829352.jpg,Bl122,10
13967.027352,13967.037352,1,voc,419010820,419011120,300,spec2/voc/Bl122_419010820.jpg,Bl122,10
9098.396241,9098.419241,1,voc,272951887,272952577,690,spec2/voc/Bl122_272951887.jpg,Bl122,10
10897.86256,10897.94656,1,voc,326935876,326938396,2520,spec2/voc/Bl122_326935876.jpg,Bl122,10
6029.265533,6029.267533,1,voc,180877965,180878025,60,spec2/voc/Bl122_180877965.jpg,Bl122,10
8949.949967,8949.975967,1,voc,268498499,268499279,780,spec2/voc/Bl122_268498499.jpg,Bl122,10
11191.08618,11191.09418,1,voc,335732585,335732825,240,spec2/voc/Bl122_335732585.jpg,Bl122,10
7962.628748,7962.631748,1,voc,238878862,238878952,90,spec2/voc/Bl122_238878862.jpg,Bl122,10
8922.176773,8922.205773,1,voc,267665303,267666173,870,spec2/voc/Bl122_267665303.jpg,Bl122,10
9072.957241,9072.978241,1,voc,272188717,272189347,630,spec2/voc/Bl122_272188717.jpg,Bl122,10
10947.244807,10947.266807,1,voc,328417344,328418004,660,spec2/voc/Bl122_328417344.jpg,Bl122,10
9042.867241,9042.879241,1,voc,271286017,271286377,360,spec2/voc/Bl122_271286017.jpg,Bl122,10
12604.25476,12604.41776,1,voc,378127642,378132532,4890,spec2/voc/Bl122_378127642.jpg,Bl122,10
13160.155891,13160.166891,1,voc,394804676,394805006,330,spec2/voc/Bl122_394804676.jpg,Bl122,10
9084.870241,9084.874241,1,voc,272546107,272546227,120,spec2/voc/Bl122_272546107.jpg,Bl122,10
7853.621748,7853.637748,1,voc,235608652,235609132,480,spec2/voc/Bl122_235608652.jpg,Bl122,10
9086.968241,9086.973241,1,voc,272609047,272609197,150,spec2/voc/Bl122_272609047.jpg,Bl122,10
5941.636256,5941.688256,1,voc,178249087,178250647,1560,spec2/voc/Bl122_178249087.jpg,Bl122,10
3798.514649,3798.521649,1,voc,113955439,113955649,210,spec2/voc/Bl122_113955439.jpg,Bl122,10
13824.00722,13824.01122,1,voc,414720216,414720336,120,spec2/voc/Bl122_414720216.jpg,Bl122,10
8031.515748,8031.520748,1,voc,240945472,240945622,150,spec2/voc/Bl122_240945472.jpg,Bl122,10
6114.439706,6114.454706,1,voc,183433191,183433641,450,spec2/voc/Bl122_183433191.jpg,Bl122,10
11189.56718,11189.59318,1,voc,335687015,335687795,780,spec2/voc/Bl122_335687015.jpg,Bl122,10
14811.652551,14811.657551,1,voc,444349576,444349726,150,spec2/voc/Bl122_444349576.jpg,Bl122,10
6005.014256,6005.023256,1,voc,180150427,180150697,270,spec2/voc/Bl122_180150427.jpg,Bl122,10
11184.23318,11184.23518,1,voc,335526995,335527055,60,spec2/voc/Bl122_335526995.jpg,Bl122,10
3813.733649,3813.766649,1,voc,114412009,114412999,990,spec2/voc/Bl122_114412009.jpg,Bl122,10
12645.554825,12645.702825,1,voc,379366644,379371084,4440,spec2/voc/Bl122_379366644.jpg,Bl122,10
8367.376166,8367.423166,1,voc,251021284,251022694,1410,spec2/voc/Bl122_251021284.jpg,Bl122,10
3819.561649,3819.566649,1,voc,114586849,114586999,150,spec2/voc/Bl122_114586849.jpg,Bl122,10
6144.370349,6144.392349,1,voc,184331110,184331770,660,spec2/voc/Bl122_184331110.jpg,Bl122,10
7807.176748,7807.182748,1,voc,234215302,234215482,180,spec2/voc/Bl122_234215302.jpg,Bl122,10
3844.833415,3844.857415,1,voc,115345002,115345722,720,spec2/voc/Bl122_115345002.jpg,Bl122,10
5937.322256,5937.331256,1,voc,178119667,178119937,270,spec2/voc/Bl122_178119667.jpg,Bl122,10
6170.320327,6170.327327,1,voc,185109609,185109819,210,spec2/voc/Bl122_185109609.jpg,Bl122,10
10921.408807,10921.465807,1,voc,327642264,327643974,1710,spec2/voc/Bl122_327642264.jpg,Bl122,10
9095.717241,9095.936241,1,voc,272871517,272878087,6570,spec2/voc/Bl122_272871517.jpg,Bl122,10
6228.363295,6228.390295,1,voc,186850898,186851708,810,spec2/voc/Bl122_186850898.jpg,Bl122,10
7911.638748,7911.695748,1,voc,237349162,237350872,1710,spec2/voc/Bl122_237349162.jpg,Bl122,10
10953.143807,10953.242807,1,voc,328594314,328597284,2970,spec2/voc/Bl122_328594314.jpg,Bl122,10
12671.329513,12671.442513,1,voc,380139885,380143275,3390,spec2/voc/Bl122_380139885.jpg,Bl122,10
14825.828551,14825.845551,1,voc,444774856,444775366,510,spec2/voc/Bl122_444774856.jpg,Bl122,10
5946.883256,5946.885256,1,voc,178406497,178406557,60,spec2/voc/Bl122_178406497.jpg,Bl122,10
8992.765241,8992.793241,1,voc,269782957,269783797,840,spec2/voc/Bl122_269782957.jpg,Bl122,10
7857.012748,7857.046748,1,voc,235710382,235711402,1020,spec2/voc/Bl122_235710382.jpg,Bl122,10
7948.117748,7948.121748,1,voc,238443532,238443652,120,spec2/voc/Bl122_238443532.jpg,Bl122,10
13949.070911,13949.079911,1,voc,418472127,418472397,270,spec2/voc/Bl122_418472127.jpg,Bl122,10
7937.659748,7937.661748,1,voc,238129792,238129852,60,spec2/voc/Bl122_238129792.jpg,Bl122,10
6182.271327,6182.276327,1,voc,185468139,185468289,150,spec2/voc/Bl122_185468139.jpg,Bl122,10
5974.053256,5974.055256,1,voc,179221597,179221657,60,spec2/voc/Bl122_179221597.jpg,Bl122,10
9013.058241,9013.171241,1,voc,270391747,270395137,3390,spec2/voc/Bl122_270391747.jpg,Bl122,10
11150.24618,11150.28918,1,voc,334507385,334508675,1290,spec2/voc/Bl122_334507385.jpg,Bl122,10
6005.044256,6005.206256,1,voc,180151327,180156187,4860,spec2/voc/Bl122_180151327.jpg,Bl122,10
9052.405241,9052.727241,1,voc,271572157,271581817,9660,spec2/voc/Bl122_271572157.jpg,Bl122,10
10923.243807,10923.289807,1,voc,327697314,327698694,1380,spec2/voc/Bl122_327697314.jpg,Bl122,10
7961.324748,7961.331748,1,voc,238839742,238839952,210,spec2/voc/Bl122_238839742.jpg,Bl122,10
12588.894377,12589.033377,1,voc,377666831,377671001,4170,spec2/voc/Bl122_377666831.jpg,Bl122,10
9068.900241,9068.911241,1,voc,272067007,272067337,330,spec2/voc/Bl122_272067007.jpg,Bl122,10
7937.322748,7937.332748,1,voc,238119682,238119982,300,spec2/voc/Bl122_238119682.jpg,Bl122,10
11185.86518,11185.87018,1,voc,335575955,335576105,150,spec2/voc/Bl122_335575955.jpg,Bl122,10
6010.186533,6010.211533,1,voc,180305595,180306345,750,spec2/voc/Bl122_180305595.jpg,Bl122,10
13818.412617,13818.424617,1,voc,414552378,414552738,360,spec2/voc/Bl122_414552378.jpg,Bl122,10
14817.506551,14817.513551,1,voc,444525196,444525406,210,spec2/voc/Bl122_444525196.jpg,Bl122,10
7860.652748,7860.697748,1,voc,235819582,235820932,1350,spec2/voc/Bl122_235819582.jpg,Bl122,10
6030.727533,6030.730533,1,voc,180921825,180921915,90,spec2/voc/Bl122_180921825.jpg,Bl122,10
11126.850005,11126.857005,1,voc,333805500,333805710,210,spec2/voc/Bl122_333805500.jpg,Bl122,10
5963.375256,5963.417256,1,voc,178901257,178902517,1260,spec2/voc/Bl122_178901257.jpg,Bl122,10
7901.717748,7901.783748,1,voc,237051532,237053512,1980,spec2/voc/Bl122_237051532.jpg,Bl122,10
13554.599188,13554.746188,1,voc,406637975,406642385,4410,spec2/voc/Bl122_406637975.jpg,Bl122,10
13984.481943,13984.485943,1,voc,419534458,419534578,120,spec2/voc/Bl122_419534458.jpg,Bl122,10
6051.7542,6051.7862,1,voc,181552626,181553586,960,spec2/voc/Bl122_181552626.jpg,Bl122,10
3805.718649,3805.827649,1,voc,114171559,114174829,3270,spec2/voc/Bl122_114171559.jpg,Bl122,10
9077.884241,9077.889241,1,voc,272336527,272336677,150,spec2/voc/Bl122_272336527.jpg,Bl122,10
6065.425705,6065.725705,1,voc,181962771,181971771,9000,spec2/voc/Bl122_181962771.jpg,Bl122,10
5953.501256,5953.564256,1,voc,178605037,178606927,1890,spec2/voc/Bl122_178605037.jpg,Bl122,10
9098.748241,9098.756241,1,voc,272962447,272962687,240,spec2/voc/Bl122_272962447.jpg,Bl122,10
9148.897842,9148.972842,1,voc,274466935,274469185,2250,spec2/voc/Bl122_274466935.jpg,Bl122,10
6076.208705,6076.211705,1,voc,182286261,182286351,90,spec2/voc/Bl122_182286261.jpg,Bl122,10
9096.119241,9096.122241,1,voc,272883577,272883667,90,spec2/voc/Bl122_272883577.jpg,Bl122,10
14183.821102,14183.823102,1,voc,425514633,425514693,60,spec2/voc/Bl122_425514633.jpg,Bl122,10
10896.576557,10896.586557,1,voc,326897296,326897596,300,spec2/voc/Bl122_326897296.jpg,Bl122,10
3894.800652,3894.809652,1,voc,116844019,116844289,270,spec2/voc/Bl122_116844019.jpg,Bl122,10
14142.055259,14142.209259,1,voc,424261657,424266277,4620,spec2/voc/Bl122_424261657.jpg,Bl122,10
9125.651182,9125.893182,1,voc,273769535,273776795,7260,spec2/voc/Bl122_273769535.jpg,Bl122,10
7990.231748,7990.244748,1,voc,239706952,239707342,390,spec2/voc/Bl122_239706952.jpg,Bl122,10
5958.171256,5958.202256,1,voc,178745137,178746067,930,spec2/voc/Bl122_178745137.jpg,Bl122,10
9049.108241,9049.115241,1,voc,271473247,271473457,210,spec2/voc/Bl122_271473247.jpg,Bl122,10
9097.612241,9097.629241,1,voc,272928367,272928877,510,spec2/voc/Bl122_272928367.jpg,Bl122,10
9065.874241,9065.881241,1,voc,271976227,271976437,210,spec2/voc/Bl122_271976227.jpg,Bl122,10
9193.09098,9193.09898,1,voc,275792729,275792969,240,spec2/voc/Bl122_275792729.jpg,Bl122,10
13921.752981,13921.758981,1,voc,417652589,417652769,180,spec2/voc/Bl122_417652589.jpg,Bl122,10
13201.846389,13201.856389,1,voc,396055391,396055691,300,spec2/voc/Bl122_396055391.jpg,Bl122,10
5950.083256,5950.128256,1,voc,178502497,178503847,1350,spec2/voc/Bl122_178502497.jpg,Bl122,10
9039.640241,9039.669241,1,voc,271189207,271190077,870,spec2/voc/Bl122_271189207.jpg,Bl122,10
7846.291748,7846.320748,1,voc,235388752,235389622,870,spec2/voc/Bl122_235388752.jpg,Bl122,10
5949.111256,5949.281256,1,voc,178473337,178478437,5100,spec2/voc/Bl122_178473337.jpg,Bl122,10
8346.912566,8347.037566,1,voc,250407376,250411126,3750,spec2/voc/Bl122_250407376.jpg,Bl122,10
11186.70018,11186.70418,1,voc,335601005,335601125,120,spec2/voc/Bl122_335601005.jpg,Bl122,10
13976.617117,13976.621117,1,voc,419298513,419298633,120,spec2/voc/Bl122_419298513.jpg,Bl122,10
13582.218236,13582.241236,1,voc,407466547,407467237,690,spec2/voc/Bl122_407466547.jpg,Bl122,10
3819.751649,3819.758649,1,voc,114592549,114592759,210,spec2/voc/Bl122_114592549.jpg,Bl122,10
3807.923649,3807.944649,1,voc,114237709,114238339,630,spec2/voc/Bl122_114237709.jpg,Bl122,10
6105.586706,6105.692706,1,voc,183167601,183170781,3180,spec2/voc/Bl122_183167601.jpg,Bl122,10
6155.671349,6155.685349,1,voc,184670140,184670560,420,spec2/voc/Bl122_184670140.jpg,Bl122,10
9010.995241,9011.004241,1,voc,270329857,270330127,270,spec2/voc/Bl122_270329857.jpg,Bl122,10
9055.600241,9055.614241,1,voc,271668007,271668427,420,spec2/voc/Bl122_271668007.jpg,Bl122,10
8968.928712,8968.932712,1,voc,269067861,269067981,120,spec2/voc/Bl122_269067861.jpg,Bl122,10
3884.981062,3885.107062,1,voc,116549431,116553211,3780,spec2/voc/Bl122_116549431.jpg,Bl122,10
6029.490533,6029.493533,1,voc,180884715,180884805,90,spec2/voc/Bl122_180884715.jpg,Bl122,10
14155.834825,14155.851825,1,voc,424675044,424675554,510,spec2/voc/Bl122_424675044.jpg,Bl122,10
6071.421705,6071.434705,1,voc,182142651,182143041,390,spec2/voc/Bl122_182142651.jpg,Bl122,10
3883.959062,3883.982062,1,voc,116518771,116519461,690,spec2/voc/Bl122_116518771.jpg,Bl122,10
9067.092241,9067.292241,1,voc,272012767,272018767,6000,spec2/voc/Bl122_272012767.jpg,Bl122,10
3876.146848,3876.151848,1,voc,116284405,116284555,150,spec2/voc/Bl122_116284405.jpg,Bl122,10
6038.514533,6038.694533,1,voc,181155435,181160835,5400,spec2/voc/Bl122_181155435.jpg,Bl122,10
7775.714748,7775.720748,1,voc,233271442,233271622,180,spec2/voc/Bl122_233271442.jpg,Bl122,10
14795.303551,14795.418551,1,voc,443859106,443862556,3450,spec2/voc/Bl122_443859106.jpg,Bl122,10
6115.334706,6115.341706,1,voc,183460041,183460251,210,spec2/voc/Bl122_183460041.jpg,Bl122,10
3818.511649,3818.686649,1,voc,114555349,114560599,5250,spec2/voc/Bl122_114555349.jpg,Bl122,10
10931.103807,10931.121807,1,voc,327933114,327933654,540,spec2/voc/Bl122_327933114.jpg,Bl122,10
13647.887941,13647.954941,1,voc,409436638,409438648,2010,spec2/voc/Bl122_409436638.jpg,Bl122,10
3894.279652,3894.285652,1,voc,116828389,116828569,180,spec2/voc/Bl122_116828389.jpg,Bl122,10
7881.298748,7881.302748,1,voc,236438962,236439082,120,spec2/voc/Bl122_236438962.jpg,Bl122,10
9097.160241,9097.271241,1,voc,272914807,272918137,3330,spec2/voc/Bl122_272914807.jpg,Bl122,10
6014.009533,6014.060533,1,voc,180420285,180421815,1530,spec2/voc/Bl122_180420285.jpg,Bl122,10
14815.570551,14815.583551,1,voc,444467116,444467506,390,spec2/voc/Bl122_444467116.jpg,Bl122,10
10919.305807,10919.310807,1,voc,327579174,327579324,150,spec2/voc/Bl122_327579174.jpg,Bl122,10
5956.623256,5956.626256,1,voc,178698697,178698787,90,spec2/voc/Bl122_178698697.jpg,Bl122,10
9169.566604,9169.591604,1,voc,275086998,275087748,750,spec2/voc/Bl122_275086998.jpg,Bl122,10
6085.51715,6085.59315,1,voc,182565514,182567794,2280,spec2/voc/Bl122_182565514.jpg,Bl122,10
6158.107349,6158.113349,1,voc,184743220,184743400,180,spec2/voc/Bl122_184743220.jpg,Bl122,10
9125.636182,9125.641182,1,voc,273769085,273769235,150,spec2/voc/Bl122_273769085.jpg,Bl122,10
9025.754241,9025.759241,1,voc,270772627,270772777,150,spec2/voc/Bl122_270772627.jpg,Bl122,10
6089.51315,6089.52915,1,voc,182685394,182685874,480,spec2/voc/Bl122_182685394.jpg,Bl122,10
6081.229511,6081.243511,1,voc,182436885,182437305,420,spec2/voc/Bl122_182436885.jpg,Bl122,10
7816.923748,7816.935748,1,voc,234507712,234508072,360,spec2/voc/Bl122_234507712.jpg,Bl122,10
10940.716807,10940.725807,1,voc,328221504,328221774,270,spec2/voc/Bl122_328221504.jpg,Bl122,10
14156.008825,14156.181825,1,voc,424680264,424685454,5190,spec2/voc/Bl122_424680264.jpg,Bl122,10
14160.330921,14160.379921,1,voc,424809927,424811397,1470,spec2/voc/Bl122_424809927.jpg,Bl122,10
13219.381389,13219.406389,1,voc,396581441,396582191,750,spec2/voc/Bl122_396581441.jpg,Bl122,10
8949.014967,8949.039967,1,voc,268470449,268471199,750,spec2/voc/Bl122_268470449.jpg,Bl122,10
11888.671845,11888.673845,1,voc,356660155,356660215,60,spec2/voc/Bl122_356660155.jpg,Bl122,10
6097.11315,6097.35915,1,voc,182913394,182920774,7380,spec2/voc/Bl122_182913394.jpg,Bl122,10
10881.138609,10881.144609,1,voc,326434158,326434338,180,spec2/voc/Bl122_326434158.jpg,Bl122,10
10903.073825,10903.171825,1,voc,327092214,327095154,2940,spec2/voc/Bl122_327092214.jpg,Bl122,10
9010.121241,9010.304241,1,voc,270303637,270309127,5490,spec2/voc/Bl122_270303637.jpg,Bl122,10
13999.206512,13999.210512,1,voc,419976195,419976315,120,spec2/voc/Bl122_419976195.jpg,Bl122,10
13195.526662,13195.651662,1,voc,395865799,395869549,3750,spec2/voc/Bl122_395865799.jpg,Bl122,10
5934.646256,5934.716256,1,voc,178039387,178041487,2100,spec2/voc/Bl122_178039387.jpg,Bl122,10
12677.66217,12677.79217,1,voc,380329865,380333765,3900,spec2/voc/Bl122_380329865.jpg,Bl122,10
7884.840748,7884.858748,1,voc,236545222,236545762,540,spec2/voc/Bl122_236545222.jpg,Bl122,10
5942.953256,5943.103256,1,voc,178288597,178293097,4500,spec2/voc/Bl122_178288597.jpg,Bl122,10
10917.176807,10917.190807,1,voc,327515304,327515724,420,spec2/voc/Bl122_327515304.jpg,Bl122,10
5935.999256,5936.084256,1,voc,178079977,178082527,2550,spec2/voc/Bl122_178079977.jpg,Bl122,10
10863.291845,10863.381845,1,voc,325898755,325901455,2700,spec2/voc/Bl122_325898755.jpg,Bl122,10
5931.664256,5931.726256,1,voc,177949927,177951787,1860,spec2/voc/Bl122_177949927.jpg,Bl122,10
11953.451309,11953.458309,1,voc,358603539,358603749,210,spec2/voc/Bl122_358603539.jpg,Bl122,10
6084.27915,6084.31315,1,voc,182528374,182529394,1020,spec2/voc/Bl122_182528374.jpg,Bl122,10
11143.017955,11143.059955,1,voc,334290538,334291798,1260,spec2/voc/Bl122_334290538.jpg,Bl122,10
3809.887649,3809.891649,1,voc,114296629,114296749,120,spec2/voc/Bl122_114296629.jpg,Bl122,10
13193.121662,13193.136662,1,voc,395793649,395794099,450,spec2/voc/Bl122_395793649.jpg,Bl122,10
11185.39518,11185.42218,1,voc,335561855,335562665,810,spec2/voc/Bl122_335561855.jpg,Bl122,10
9127.981981,9127.984981,1,voc,273839459,273839549,90,spec2/voc/Bl122_273839459.jpg,Bl122,10
7939.985748,7940.000748,1,voc,238199572,238200022,450,spec2/voc/Bl122_238199572.jpg,Bl122,10
9071.247241,9071.269241,1,voc,272137417,272138077,660,spec2/voc/Bl122_272137417.jpg,Bl122,10
10887.503136,10887.673136,1,voc,326625094,326630194,5100,spec2/voc/Bl122_326625094.jpg,Bl122,10
5970.824256,5970.843256,1,voc,179124727,179125297,570,spec2/voc/Bl122_179124727.jpg,Bl122,10
9098.974241,9099.019241,1,voc,272969227,272970577,1350,spec2/voc/Bl122_272969227.jpg,Bl122,10
6108.611706,6108.633706,1,voc,183258351,183259011,660,spec2/voc/Bl122_183258351.jpg,Bl122,10
13907.785611,13907.787611,1,voc,417233568,417233628,60,spec2/voc/Bl122_417233568.jpg,Bl122,10
5964.629256,5964.643256,1,voc,178938877,178939297,420,spec2/voc/Bl122_178938877.jpg,Bl122,10
5954.808256,5954.821256,1,voc,178644247,178644637,390,spec2/voc/Bl122_178644247.jpg,Bl122,10
13818.839617,13818.844617,1,voc,414565188,414565338,150,spec2/voc/Bl122_414565188.jpg,Bl122,10
9090.761241,9090.781241,1,voc,272722837,272723437,600,spec2/voc/Bl122_272722837.jpg,Bl122,10
8982.394025,8982.502025,1,voc,269471820,269475060,3240,spec2/voc/Bl122_269471820.jpg,Bl122,10
5997.061256,5997.064256,1,voc,179911837,179911927,90,spec2/voc/Bl122_179911837.jpg,Bl122,10
14842.898682,14842.914682,1,voc,445286960,445287440,480,spec2/voc/Bl122_445286960.jpg,Bl122,10
8008.667748,8008.681748,1,voc,240260032,240260452,420,spec2/voc/Bl122_240260032.jpg,Bl122,10
6040.920065,6040.929065,1,voc,181227601,181227871,270,spec2/voc/Bl122_181227601.jpg,Bl122,10
8031.845748,8031.850748,1,voc,240955372,240955522,150,spec2/voc/Bl122_240955372.jpg,Bl122,10
14802.128551,14802.188551,1,voc,444063856,444065656,1800,spec2/voc/Bl122_444063856.jpg,Bl122,10
8926.908773,8927.126773,1,voc,267807263,267813803,6540,spec2/voc/Bl122_267807263.jpg,Bl122,10
5996.377256,5996.383256,1,voc,179891317,179891497,180,spec2/voc/Bl122_179891317.jpg,Bl122,10
11195.23618,11195.24118,1,voc,335857085,335857235,150,spec2/voc/Bl122_335857085.jpg,Bl122,10
9065.387241,9065.392241,1,voc,271961617,271961767,150,spec2/voc/Bl122_271961617.jpg,Bl122,10
11973.749379,11973.757379,1,voc,359212481,359212721,240,spec2/voc/Bl122_359212481.jpg,Bl122,10
9034.998241,9035.267241,1,voc,271049947,271058017,8070,spec2/voc/Bl122_271049947.jpg,Bl122,10
7825.560748,7825.568748,1,voc,234766822,234767062,240,spec2/voc/Bl122_234766822.jpg,Bl122,10
13584.665236,13584.667236,1,voc,407539957,407540017,60,spec2/voc/Bl122_407539957.jpg,Bl122,10
14322.169978,14322.223978,1,voc,429665099,429666719,1620,spec2/voc/Bl122_429665099.jpg,Bl122,10
8951.146967,8951.179967,1,voc,268534409,268535399,990,spec2/voc/Bl122_268534409.jpg,Bl122,10
7959.790748,7959.797748,1,voc,238793722,238793932,210,spec2/voc/Bl122_238793722.jpg,Bl122,10
13541.616816,13541.619816,1,voc,406248504,406248594,90,spec2/voc/Bl122_406248504.jpg,Bl122,10
14156.412825,14156.426825,1,voc,424692384,424692804,420,spec2/voc/Bl122_424692384.jpg,Bl122,10
10903.925825,10903.968825,1,voc,327117774,327119064,1290,spec2/voc/Bl122_327117774.jpg,Bl122,10
3823.030649,3823.063649,1,voc,114690919,114691909,990,spec2/voc/Bl122_114690919.jpg,Bl122,10
11197.47018,11197.51918,1,voc,335924105,335925575,1470,spec2/voc/Bl122_335924105.jpg,Bl122,10
7932.085748,7932.091748,1,voc,237962572,237962752,180,spec2/voc/Bl122_237962572.jpg,Bl122,10
5941.831256,5941.846256,1,voc,178254937,178255387,450,spec2/voc/Bl122_178254937.jpg,Bl122,10
11127.064005,11127.067005,1,voc,333811920,333812010,90,spec2/voc/Bl122_333811920.jpg,Bl122,10
14821.648551,14821.654551,1,voc,444649456,444649636,180,spec2/voc/Bl122_444649456.jpg,Bl122,10
9073.668241,9073.899241,1,voc,272210047,272216977,6930,spec2/voc/Bl122_272210047.jpg,Bl122,10
5946.954256,5946.959256,1,voc,178408627,178408777,150,spec2/voc/Bl122_178408627.jpg,Bl122,10
5963.083256,5963.088256,1,voc,178892497,178892647,150,spec2/voc/Bl122_178892497.jpg,Bl122,10
6038.388533,6038.473533,1,voc,181151655,181154205,2550,spec2/voc/Bl122_181151655.jpg,Bl122,10
5969.466256,5969.646256,1,voc,179083987,179089387,5400,spec2/voc/Bl122_179083987.jpg,Bl122,10
13558.536616,13558.545616,1,voc,406756098,406756368,270,spec2/voc/Bl122_406756098.jpg,Bl122,10
14526.907046,14526.960046,1,voc,435807211,435808801,1590,spec2/voc/Bl122_435807211.jpg,Bl122,10
9062.707241,9062.734241,1,voc,271881217,271882027,810,spec2/voc/Bl122_271881217.jpg,Bl122,10
5977.924256,5977.930256,1,voc,179337727,179337907,180,spec2/voc/Bl122_179337727.jpg,Bl122,10
5956.491256,5956.499256,1,voc,178694737,178694977,240,spec2/voc/Bl122_178694737.jpg,Bl122,10
9136.040255,9136.388255,1,voc,274081207,274091647,10440,spec2/voc/Bl122_274081207.jpg,Bl122,10
3893.590652,3893.615652,1,voc,116807719,116808469,750,spec2/voc/Bl122_116807719.jpg,Bl122,10
5975.092256,5975.117256,1,voc,179252767,179253517,750,spec2/voc/Bl122_179252767.jpg,Bl122,10
10918.447807,10918.455807,1,voc,327553434,327553674,240,spec2/voc/Bl122_327553434.jpg,Bl122,10
14840.031682,14840.057682,1,voc,445200950,445201730,780,spec2/voc/Bl122_445200950.jpg,Bl122,10
11206.915894,11206.954894,1,voc,336207476,336208646,1170,spec2/voc/Bl122_336207476.jpg,Bl122,10
5970.895256,5970.898256,1,voc,179126857,179126947,90,spec2/voc/Bl122_179126857.jpg,Bl122,10
13949.608911,13949.685911,1,voc,418488267,418490577,2310,spec2/voc/Bl122_418488267.jpg,Bl122,10
14810.809551,14810.813551,1,voc,444324286,444324406,120,spec2/voc/Bl122_444324286.jpg,Bl122,10
8950.696967,8950.763967,1,voc,268520909,268522919,2010,spec2/voc/Bl122_268520909.jpg,Bl122,10
9095.545241,9095.557241,1,voc,272866357,272866717,360,spec2/voc/Bl122_272866357.jpg,Bl122,10
11168.15918,11168.16818,1,voc,335044775,335045045,270,spec2/voc/Bl122_335044775.jpg,Bl122,10
6021.721533,6021.728533,1,voc,180651645,180651855,210,spec2/voc/Bl122_180651645.jpg,Bl122,10
14793.841551,14793.877551,1,voc,443815246,443816326,1080,spec2/voc/Bl122_443815246.jpg,Bl122,10
7995.264748,7995.271748,1,voc,239857942,239858152,210,spec2/voc/Bl122_239857942.jpg,Bl122,10
5954.747256,5954.801256,1,voc,178642417,178644037,1620,spec2/voc/Bl122_178642417.jpg,Bl122,10
13162.204891,13162.207891,1,voc,394866146,394866236,90,spec2/voc/Bl122_394866146.jpg,Bl122,10
13979.354216,13979.360216,1,voc,419380626,419380806,180,spec2/voc/Bl122_419380626.jpg,Bl122,10
6024.216533,6024.292533,1,voc,180726495,180728775,2280,spec2/voc/Bl122_180726495.jpg,Bl122,10
11166.59618,11166.70418,1,voc,334997885,335001125,3240,spec2/voc/Bl122_334997885.jpg,Bl122,10
3876.947848,3877.022848,1,voc,116308435,116310685,2250,spec2/voc/Bl122_116308435.jpg,Bl122,10
3801.517649,3801.710649,1,voc,114045529,114051319,5790,spec2/voc/Bl122_114045529.jpg,Bl122,10
8213.472724,8213.486724,1,voc,246404181,246404601,420,spec2/voc/Bl122_246404181.jpg,Bl122,10
13176.611701,13176.614701,1,voc,395298351,395298441,90,spec2/voc/Bl122_395298351.jpg,Bl122,10
6051.6772,6051.6892,1,voc,181550316,181550676,360,spec2/voc/Bl122_181550316.jpg,Bl122,10
7984.399748,7984.434748,1,voc,239531992,239533042,1050,spec2/voc/Bl122_239531992.jpg,Bl122,10
8031.707748,8031.725748,1,voc,240951232,240951772,540,spec2/voc/Bl122_240951232.jpg,Bl122,10
6033.255533,6033.282533,1,voc,180997665,180998475,810,spec2/voc/Bl122_180997665.jpg,Bl122,10
8018.603748,8018.606748,1,voc,240558112,240558202,90,spec2/voc/Bl122_240558112.jpg,Bl122,10
3829.534649,3829.544649,1,voc,114886039,114886339,300,spec2/voc/Bl122_114886039.jpg,Bl122,10
14817.182551,14817.202551,1,voc,444515476,444516076,600,spec2/voc/Bl122_444515476.jpg,Bl122,10
11163.29218,11163.32118,1,voc,334898765,334899635,870,spec2/voc/Bl122_334898765.jpg,Bl122,10
14794.321551,14794.330551,1,voc,443829646,443829916,270,spec2/voc/Bl122_443829646.jpg,Bl122,10
14821.019551,14821.089551,1,voc,444630586,444632686,2100,spec2/voc/Bl122_444630586.jpg,Bl122,10
13569.551052,13569.620052,1,voc,407086531,407088601,2070,spec2/voc/Bl122_407086531.jpg,Bl122,10
13176.454701,13176.567701,1,voc,395293641,395297031,3390,spec2/voc/Bl122_395293641.jpg,Bl122,10
5948.537256,5948.546256,1,voc,178456117,178456387,270,spec2/voc/Bl122_178456117.jpg,Bl122,10
12631.674392,12631.678392,1,voc,378950231,378950351,120,spec2/voc/Bl122_378950231.jpg,Bl122,10
3829.188649,3829.385649,1,voc,114875659,114881569,5910,spec2/voc/Bl122_114875659.jpg,Bl122,10
9047.914241,9048.007241,1,voc,271437427,271440217,2790,spec2/voc/Bl122_271437427.jpg,Bl122,10
6139.023293,6139.027293,1,voc,184170698,184170818,120,spec2/voc/Bl122_184170698.jpg,Bl122,10
6052.3002,6052.3342,1,voc,181569006,181570026,1020,spec2/voc/Bl122_181569006.jpg,Bl122,10
6224.489295,6224.660295,1,voc,186734678,186739808,5130,spec2/voc/Bl122_186734678.jpg,Bl122,10
7815.242748,7815.255748,1,voc,234457282,234457672,390,spec2/voc/Bl122_234457282.jpg,Bl122,10
9150.505842,9150.508842,1,voc,274515175,274515265,90,spec2/voc/Bl122_274515175.jpg,Bl122,10
5977.580256,5977.599256,1,voc,179327407,179327977,570,spec2/voc/Bl122_179327407.jpg,Bl122,10
8015.274748,8015.297748,1,voc,240458242,240458932,690,spec2/voc/Bl122_240458242.jpg,Bl122,10
6076.214705,6076.239705,1,voc,182286441,182287191,750,spec2/voc/Bl122_182286441.jpg,Bl122,10
14162.838897,14162.862897,1,voc,424885166,424885886,720,spec2/voc/Bl122_424885166.jpg,Bl122,10
8984.108025,8984.110025,1,voc,269523240,269523300,60,spec2/voc/Bl122_269523240.jpg,Bl122,10
3793.293649,3793.395649,1,voc,113798809,113801869,3060,spec2/voc/Bl122_113798809.jpg,Bl122,10
6009.282533,6009.347533,1,voc,180278475,180280425,1950,spec2/voc/Bl122_180278475.jpg,Bl122,10
5948.602256,5948.607256,1,voc,178458067,178458217,150,spec2/voc/Bl122_178458067.jpg,Bl122,10
13244.578606,13244.583606,1,voc,397337358,397337508,150,spec2/voc/Bl122_397337358.jpg,Bl122,10
3877.972848,3877.995848,1,voc,116339185,116339875,690,spec2/voc/Bl122_116339185.jpg,Bl122,10
3809.815649,3809.848649,1,voc,114294469,114295459,990,spec2/voc/Bl122_114294469.jpg,Bl122,10
9085.074241,9085.160241,1,voc,272552227,272554807,2580,spec2/voc/Bl122_272552227.jpg,Bl122,10
3869.544367,3869.549367,1,voc,116086331,116086481,150,spec2/voc/Bl122_116086331.jpg,Bl122,10
11209.308894,11209.334894,1,voc,336279266,336280046,780,spec2/voc/Bl122_336279266.jpg,Bl122,10
13952.523911,13952.530911,1,voc,418575717,418575927,210,spec2/voc/Bl122_418575717.jpg,Bl122,10
6164.286343,6164.425343,1,voc,184928590,184932760,4170,spec2/voc/Bl122_184928590.jpg,Bl122,10
9115.053184,9115.064184,1,voc,273451595,273451925,330,spec2/voc/Bl122_273451595.jpg,Bl122,10
13814.772617,13814.985617,1,voc,414443178,414449568,6390,spec2/voc/Bl122_414443178.jpg,Bl122,10
6154.084349,6154.139349,1,voc,184622530,184624180,1650,spec2/voc/Bl122_184622530.jpg,Bl122,10
14822.236551,14822.255551,1,voc,444667096,444667666,570,spec2/voc/Bl122_444667096.jpg,Bl122,10
5951.885256,5951.891256,1,voc,178556557,178556737,180,spec2/voc/Bl122_178556557.jpg,Bl122,10
14815.730551,14815.734551,1,voc,444471916,444472036,120,spec2/voc/Bl122_444471916.jpg,Bl122,10
7856.132748,7856.134748,1,voc,235683982,235684042,60,spec2/voc/Bl122_235683982.jpg,Bl122,10
6107.401706,6107.433706,1,voc,183222051,183223011,960,spec2/voc/Bl122_183222051.jpg,Bl122,10
11134.784005,11134.906005,1,voc,334043520,334047180,3660,spec2/voc/Bl122_334043520.jpg,Bl122,10
6028.118533,6028.130533,1,voc,180843555,180843915,360,spec2/voc/Bl122_180843555.jpg,Bl122,10
9132.328981,9132.385981,1,voc,273969869,273971579,1710,spec2/voc/Bl122_273969869.jpg,Bl122,10
6105.785706,6105.793706,1,voc,183173571,183173811,240,spec2/voc/Bl122_183173571.jpg,Bl122,10
9015.228241,9015.311241,1,voc,270456847,270459337,2490,spec2/voc/Bl122_270456847.jpg,Bl122,10
3829.781649,3829.787649,1,voc,114893449,114893629,180,spec2/voc/Bl122_114893449.jpg,Bl122,10
7798.907748,7798.911748,1,voc,233967232,233967352,120,spec2/voc/Bl122_233967232.jpg,Bl122,10
13179.944701,13179.966701,1,voc,395398341,395399001,660,spec2/voc/Bl122_395398341.jpg,Bl122,10
6142.453349,6142.467349,1,voc,184273600,184274020,420,spec2/voc/Bl122_184273600.jpg,Bl122,10
11152.03718,11152.04118,1,voc,334561115,334561235,120,spec2/voc/Bl122_334561115.jpg,Bl122,10
3883.528062,3883.793062,1,voc,116505841,116513791,7950,spec2/voc/Bl122_116505841.jpg,Bl122,10
13216.450389,13216.462389,1,voc,396493511,396493871,360,spec2/voc/Bl122_396493511.jpg,Bl122,10
10932.553807,10932.568807,1,voc,327976614,327977064,450,spec2/voc/Bl122_327976614.jpg,Bl122,10
11127.294005,11127.395005,1,voc,333818820,333821850,3030,spec2/voc/Bl122_333818820.jpg,Bl122,10
9094.706241,9094.808241,1,voc,272841187,272844247,3060,spec2/voc/Bl122_272841187.jpg,Bl122,10
7968.289748,7968.302748,1,voc,239048692,239049082,390,spec2/voc/Bl122_239048692.jpg,Bl122,10
3046.492486,3046.737486,1,voc,91394774,91402124,7350,spec2/voc/Bl122_91394774.jpg,Bl122,10
7841.634748,7841.676748,1,voc,235249042,235250302,1260,spec2/voc/Bl122_235249042.jpg,Bl122,10
8980.881025,8980.888025,1,voc,269426430,269426640,210,spec2/voc/Bl122_269426430.jpg,Bl122,10
9043.832241,9044.002241,1,voc,271314967,271320067,5100,spec2/voc/Bl122_271314967.jpg,Bl122,10
14015.121222,14015.127222,1,voc,420453636,420453816,180,spec2/voc/Bl122_420453636.jpg,Bl122,10
14824.571551,14824.577551,1,voc,444737146,444737326,180,spec2/voc/Bl122_444737146.jpg,Bl122,10
7869.383748,7869.387748,1,voc,236081512,236081632,120,spec2/voc/Bl122_236081512.jpg,Bl122,10
5961.023256,5961.052256,1,voc,178830697,178831567,870,spec2/voc/Bl122_178830697.jpg,Bl122,10
3820.505649,3820.511649,1,voc,114615169,114615349,180,spec2/voc/Bl122_114615169.jpg,Bl122,10
5987.755256,5987.854256,1,voc,179632657,179635627,2970,spec2/voc/Bl122_179632657.jpg,Bl122,10
6056.657705,6056.661705,1,voc,181699731,181699851,120,spec2/voc/Bl122_181699731.jpg,Bl122,10
8921.002773,8921.011773,1,voc,267630083,267630353,270,spec2/voc/Bl122_267630083.jpg,Bl122,10
9100.827241,9100.830241,1,voc,273024817,273024907,90,spec2/voc/Bl122_273024817.jpg,Bl122,10
6025.674533,6025.680533,1,voc,180770235,180770415,180,spec2/voc/Bl122_180770235.jpg,Bl122,10
9091.116241,9091.122241,1,voc,272733487,272733667,180,spec2/voc/Bl122_272733487.jpg,Bl122,10
9060.409241,9060.419241,1,voc,271812277,271812577,300,spec2/voc/Bl122_271812277.jpg,Bl122,10
3846.134415,3846.213415,1,voc,115384032,115386402,2370,spec2/voc/Bl122_115384032.jpg,Bl122,10
5961.889256,5961.903256,1,voc,178856677,178857097,420,spec2/voc/Bl122_178856677.jpg,Bl122,10
9074.716241,9074.819241,1,voc,272241487,272244577,3090,spec2/voc/Bl122_272241487.jpg,Bl122,10
14149.400855,14149.582855,1,voc,424482025,424487485,5460,spec2/voc/Bl122_424482025.jpg,Bl122,10
7952.222821,7952.266821,1,voc,238566684,238568004,1320,spec2/voc/Bl122_238566684.jpg,Bl122,10
14201.077387,14201.080387,1,voc,426032321,426032411,90,spec2/voc/Bl122_426032321.jpg,Bl122,10
13818.339617,13818.348617,1,voc,414550188,414550458,270,spec2/voc/Bl122_414550188.jpg,Bl122,10
9044.137241,9044.145241,1,voc,271324117,271324357,240,spec2/voc/Bl122_271324117.jpg,Bl122,10
9082.832241,9082.836241,1,voc,272484967,272485087,120,spec2/voc/Bl122_272484967.jpg,Bl122,10
6029.622533,6029.626533,1,voc,180888675,180888795,120,spec2/voc/Bl122_180888675.jpg,Bl122,10
5934.591256,5934.608256,1,voc,178037737,178038247,510,spec2/voc/Bl122_178037737.jpg,Bl122,10
6063.084705,6063.419705,1,voc,181892541,181902591,10050,spec2/voc/Bl122_181892541.jpg,Bl122,10
12606.341559,12606.405559,1,voc,378190246,378192166,1920,spec2/voc/Bl122_378190246.jpg,Bl122,10
5972.358256,5972.363256,1,voc,179170747,179170897,150,spec2/voc/Bl122_179170747.jpg,Bl122,10
6144.653349,6144.667349,1,voc,184339600,184340020,420,spec2/voc/Bl122_184339600.jpg,Bl122,10
6170.743327,6170.779327,1,voc,185122299,185123379,1080,spec2/voc/Bl122_185122299.jpg,Bl122,10
5953.124256,5953.134256,1,voc,178593727,178594027,300,spec2/voc/Bl122_178593727.jpg,Bl122,10
6175.732327,6175.835327,1,voc,185271969,185275059,3090,spec2/voc/Bl122_185271969.jpg,Bl122,10
14803.077551,14803.330551,1,voc,444092326,444099916,7590,spec2/voc/Bl122_444092326.jpg,Bl122,10
13200.606389,13200.609389,1,voc,396018191,396018281,90,spec2/voc/Bl122_396018191.jpg,Bl122,10
11159.20518,11159.21118,1,voc,334776155,334776335,180,spec2/voc/Bl122_334776155.jpg,Bl122,10
7844.379748,7844.386748,1,voc,235331392,235331602,210,spec2/voc/Bl122_235331392.jpg,Bl122,10
7937.663748,7937.665748,1,voc,238129912,238129972,60,spec2/voc/Bl122_238129912.jpg,Bl122,10
8993.243241,8993.249241,1,voc,269797297,269797477,180,spec2/voc/Bl122_269797297.jpg,Bl122,10
10885.375162,10885.388162,1,voc,326561254,326561644,390,spec2/voc/Bl122_326561254.jpg,Bl122,10
13952.898911,13952.911911,1,voc,418586967,418587357,390,spec2/voc/Bl122_418586967.jpg,Bl122,10
9030.380241,9030.401241,1,voc,270911407,270912037,630,spec2/voc/Bl122_270911407.jpg,Bl122,10
11163.59818,11163.64418,1,voc,334907945,334909325,1380,spec2/voc/Bl122_334907945.jpg,Bl122,10
9062.813241,9062.968241,1,voc,271884397,271889047,4650,spec2/voc/Bl122_271884397.jpg,Bl122,10
14809.770551,14809.772551,1,voc,444293116,444293176,60,spec2/voc/Bl122_444293116.jpg,Bl122,10
5934.867256,5935.013256,1,voc,178046017,178050397,4380,spec2/voc/Bl122_178046017.jpg,Bl122,10
11150.66218,11150.67718,1,voc,334519865,334520315,450,spec2/voc/Bl122_334519865.jpg,Bl122,10
6222.535295,6222.568295,1,voc,186676058,186677048,990,spec2/voc/Bl122_186676058.jpg,Bl122,10
5979.206256,5979.231256,1,voc,179376187,179376937,750,spec2/voc/Bl122_179376187.jpg,Bl122,10
13921.597981,13921.600981,1,voc,417647939,417648029,90,spec2/voc/Bl122_417647939.jpg,Bl122,10
13974.147117,13974.281117,1,voc,419224413,419228433,4020,spec2/voc/Bl122_419224413.jpg,Bl122,10
14822.456551,14822.500551,1,voc,444673696,444675016,1320,spec2/voc/Bl122_444673696.jpg,Bl122,10
13815.488617,13815.501617,1,voc,414464658,414465048,390,spec2/voc/Bl122_414464658.jpg,Bl122,10
6113.228706,6113.234706,1,voc,183396861,183397041,180,spec2/voc/Bl122_183396861.jpg,Bl122,10
7978.043748,7978.046748,1,voc,239341312,239341402,90,spec2/voc/Bl122_239341312.jpg,Bl122,10
14782.208844,14782.352844,1,voc,443466265,443470585,4320,spec2/voc/Bl122_443466265.jpg,Bl122,10
13603.883736,13603.963736,1,voc,408116512,408118912,2400,spec2/voc/Bl122_408116512.jpg,Bl122,10
8001.136748,8001.167748,1,voc,240034102,240035032,930,spec2/voc/Bl122_240034102.jpg,Bl122,10
5945.284256,5945.432256,1,voc,178358527,178362967,4440,spec2/voc/Bl122_178358527.jpg,Bl122,10
9078.819241,9078.836241,1,voc,272364577,272365087,510,spec2/voc/Bl122_272364577.jpg,Bl122,10
3871.252367,3871.407367,1,voc,116137571,116142221,4650,spec2/voc/Bl122_116137571.jpg,Bl122,10
7998.852748,7998.856748,1,voc,239965582,239965702,120,spec2/voc/Bl122_239965582.jpg,Bl122,10
13949.319911,13949.488911,1,voc,418479597,418484667,5070,spec2/voc/Bl122_418479597.jpg,Bl122,10
13208.805389,13208.807389,1,voc,396264161,396264221,60,spec2/voc/Bl122_396264161.jpg,Bl122,10
11888.938845,11888.949845,1,voc,356668165,356668495,330,spec2/voc/Bl122_356668165.jpg,Bl122,10
8213.950724,8213.956724,1,voc,246418521,246418701,180,spec2/voc/Bl122_246418521.jpg,Bl122,10
10846.073344,10846.226344,1,voc,325382200,325386790,4590,spec2/voc/Bl122_325382200.jpg,Bl122,10
10919.800807,10919.805807,1,voc,327594024,327594174,150,spec2/voc/Bl122_327594024.jpg,Bl122,10
3825.374649,3825.404649,1,voc,114761239,114762139,900,spec2/voc/Bl122_114761239.jpg,Bl122,10
10934.103807,10934.285807,1,voc,328023114,328028574,5460,spec2/voc/Bl122_328023114.jpg,Bl122,10
9152.755842,9152.803842,1,voc,274582675,274584115,1440,spec2/voc/Bl122_274582675.jpg,Bl122,10
5955.156256,5955.163256,1,voc,178654687,178654897,210,spec2/voc/Bl122_178654687.jpg,Bl122,10
5942.027256,5942.045256,1,voc,178260817,178261357,540,spec2/voc/Bl122_178260817.jpg,Bl122,10
10954.087807,10954.125807,1,voc,328622634,328623774,1140,spec2/voc/Bl122_328622634.jpg,Bl122,10
9093.107241,9093.223241,1,voc,272793217,272796697,3480,spec2/voc/Bl122_272793217.jpg,Bl122,10
14349.569116,14349.588116,1,voc,430487073,430487643,570,spec2/voc/Bl122_430487073.jpg,Bl122,10
8916.339773,8916.342773,1,voc,267490193,267490283,90,spec2/voc/Bl122_267490193.jpg,Bl122,10
9027.832241,9027.941241,1,voc,270834967,270838237,3270,spec2/voc/Bl122_270834967.jpg,Bl122,10
9078.300241,9078.325241,1,voc,272349007,272349757,750,spec2/voc/Bl122_272349007.jpg,Bl122,10
7798.707748,7798.711748,1,voc,233961232,233961352,120,spec2/voc/Bl122_233961232.jpg,Bl122,10
6050.4102,6050.4232,1,voc,181512306,181512696,390,spec2/voc/Bl122_181512306.jpg,Bl122,10
11162.47418,11162.53118,1,voc,334874225,334875935,1710,spec2/voc/Bl122_334874225.jpg,Bl122,10
6055.997705,6056.006705,1,voc,181679931,181680201,270,spec2/voc/Bl122_181679931.jpg,Bl122,10
6061.536705,6061.672705,1,voc,181846101,181850181,4080,spec2/voc/Bl122_181846101.jpg,Bl122,10
8207.928882,8207.937882,1,voc,246237866,246238136,270,spec2/voc/Bl122_246237866.jpg,Bl122,10
13822.63622,13822.94522,1,voc,414679086,414688356,9270,spec2/voc/Bl122_414679086.jpg,Bl122,10
13958.016384,13958.040384,1,voc,418740491,418741211,720,spec2/voc/Bl122_418740491.jpg,Bl122,10
9054.264241,9054.606241,1,voc,271627927,271638187,10260,spec2/voc/Bl122_271627927.jpg,Bl122,10
7978.550748,7978.553748,1,voc,239356522,239356612,90,spec2/voc/Bl122_239356522.jpg,Bl122,10
13188.171662,13188.173662,1,voc,395645149,395645209,60,spec2/voc/Bl122_395645149.jpg,Bl122,10
14841.371682,14841.398682,1,voc,445241150,445241960,810,spec2/voc/Bl122_445241150.jpg,Bl122,10
6185.526327,6185.619327,1,voc,185565789,185568579,2790,spec2/voc/Bl122_185565789.jpg,Bl122,10
10912.903807,10912.906807,1,voc,327387114,327387204,90,spec2/voc/Bl122_327387114.jpg,Bl122,10
13984.340943,13984.347943,1,voc,419530228,419530438,210,spec2/voc/Bl122_419530228.jpg,Bl122,10
11129.847005,11129.926005,1,voc,333895410,333897780,2370,spec2/voc/Bl122_333895410.jpg,Bl122,10
14838.587682,14838.589682,1,voc,445157630,445157690,60,spec2/voc/Bl122_445157630.jpg,Bl122,10
7990.930748,7990.937748,1,voc,239727922,239728132,210,spec2/voc/Bl122_239727922.jpg,Bl122,10
9041.756241,9041.994241,1,voc,271252687,271259827,7140,spec2/voc/Bl122_271252687.jpg,Bl122,10
11181.41718,11181.57518,1,voc,335442515,335447255,4740,spec2/voc/Bl122_335442515.jpg,Bl122,10
5961.070256,5961.073256,1,voc,178832107,178832197,90,spec2/voc/Bl122_178832107.jpg,Bl122,10
9152.007842,9152.055842,1,voc,274560235,274561675,1440,spec2/voc/Bl122_274560235.jpg,Bl122,10
6047.6022,6047.6122,1,voc,181428066,181428366,300,spec2/voc/Bl122_181428066.jpg,Bl122,10
13200.740389,13200.742389,1,voc,396022211,396022271,60,spec2/voc/Bl122_396022211.jpg,Bl122,10
6131.812293,6131.833293,1,voc,183954368,183954998,630,spec2/voc/Bl122_183954368.jpg,Bl122,10
13949.830911,13949.837911,1,voc,418494927,418495137,210,spec2/voc/Bl122_418494927.jpg,Bl122,10
7945.542748,7945.551748,1,voc,238366282,238366552,270,spec2/voc/Bl122_238366282.jpg,Bl122,10
6056.013705,6056.200705,1,voc,181680411,181686021,5610,spec2/voc/Bl122_181680411.jpg,Bl122,10
6182.698327,6182.751327,1,voc,185480949,185482539,1590,spec2/voc/Bl122_185480949.jpg,Bl122,10
3804.480649,3804.664649,1,voc,114134419,114139939,5520,spec2/voc/Bl122_114134419.jpg,Bl122,10
7723.450941,7723.635941,1,voc,231703528,231709078,5550,spec2/voc/Bl122_231703528.jpg,Bl122,10
9064.126241,9064.132241,1,voc,271923787,271923967,180,spec2/voc/Bl122_271923787.jpg,Bl122,10
3819.869649,3820.040649,1,voc,114596089,114601219,5130,spec2/voc/Bl122_114596089.jpg,Bl122,10
5995.199256,5995.227256,1,voc,179855977,179856817,840,spec2/voc/Bl122_179855977.jpg,Bl122,10
10938.909807,10939.114807,1,voc,328167294,328173444,6150,spec2/voc/Bl122_328167294.jpg,Bl122,10
6149.381349,6149.487349,1,voc,184481440,184484620,3180,spec2/voc/Bl122_184481440.jpg,Bl122,10
9150.435842,9150.458842,1,voc,274513075,274513765,690,spec2/voc/Bl122_274513075.jpg,Bl122,10
13583.124236,13583.336236,1,voc,407493727,407500087,6360,spec2/voc/Bl122_407493727.jpg,Bl122,10
6159.155349,6159.390349,1,voc,184774660,184781710,7050,spec2/voc/Bl122_184774660.jpg,Bl122,10
8981.361025,8981.373025,1,voc,269440830,269441190,360,spec2/voc/Bl122_269440830.jpg,Bl122,10
14820.610551,14820.708551,1,voc,444618316,444621256,2940,spec2/voc/Bl122_444618316.jpg,Bl122,10
13589.236236,13589.246236,1,voc,407677087,407677387,300,spec2/voc/Bl122_407677087.jpg,Bl122,10
8927.180773,8927.210773,1,voc,267815423,267816323,900,spec2/voc/Bl122_267815423.jpg,Bl122,10
10910.851807,10910.967807,1,voc,327325554,327329034,3480,spec2/voc/Bl122_327325554.jpg,Bl122,10
13162.236891,13162.238891,1,voc,394867106,394867166,60,spec2/voc/Bl122_394867106.jpg,Bl122,10
6188.285327,6188.305327,1,voc,185648559,185649159,600,spec2/voc/Bl122_185648559.jpg,Bl122,10
5977.393256,5977.545256,1,voc,179321797,179326357,4560,spec2/voc/Bl122_179321797.jpg,Bl122,10
13534.570952,13534.609952,1,voc,406037128,406038298,1170,spec2/voc/Bl122_406037128.jpg,Bl122,10
3850.541415,3850.547415,1,voc,115516242,115516422,180,spec2/voc/Bl122_115516242.jpg,Bl122,10
14835.754682,14835.760682,1,voc,445072640,445072820,180,spec2/voc/Bl122_445072640.jpg,Bl122,10
12645.146825,12645.150825,1,voc,379354404,379354524,120,spec2/voc/Bl122_379354404.jpg,Bl122,10
3893.675652,3893.800652,1,voc,116810269,116814019,3750,spec2/voc/Bl122_116810269.jpg,Bl122,10
6114.824706,6114.873706,1,voc,183444741,183446211,1470,spec2/voc/Bl122_183444741.jpg,Bl122,10
9097.805241,9097.824241,1,voc,272934157,272934727,570,spec2/voc/Bl122_272934157.jpg,Bl122,10
7887.115748,7887.151748,1,voc,236613472,236614552,1080,spec2/voc/Bl122_236613472.jpg,Bl122,10
