,onset,offset,label,onset_sample,offset_sample,length,path,bird
0,2126.485183,2126.643183,1,63794555,63799295,4740,audio/Bl122_63794555.jpg,Bl122
1,765.922271,766.049271,1,22977668,22981478,3810,audio/Or61_22977668.jpg,Or61
2,716.808271,716.861271,1,21504248,21505838,1590,audio/Or61_21504248.jpg,Or61
3,2040.688469,2040.696469,2,61220654,61220894,240,audio/Bl122_61220654.jpg,Bl122
4,1956.036779,1956.081779,2,58681103,58682453,1350,audio/Bl122_58681103.jpg,Bl122
5,15259.732114,15259.757114,1,457791963,457792713,750,audio/Ti81_457791963.jpg,Ti81
6,1996.595779,1996.602779,2,59897873,59898083,210,audio/Bl122_59897873.jpg,Bl122
7,2195.165183,2195.171183,2,65854955,65855135,180,audio/Bl122_65854955.jpg,Bl122
8,1486.458018,1486.462018,2,44593740,44593860,120,audio/Li145_44593740.jpg,Li145
9,715.666271,715.690271,1,21469988,21470708,720,audio/Or61_21469988.jpg,Or61
10,2142.050183,2142.055183,2,64261505,64261655,150,audio/Bl122_64261505.jpg,Bl122
11,496.867221,496.925221,2,14906016,14907756,1740,audio/Or61_14906016.jpg,Or61
12,2100.347961,2100.481961,1,63010438,63014458,4020,audio/Bl122_63010438.jpg,Bl122
13,2048.579469,2048.703469,1,61457384,61461104,3720,audio/Bl122_61457384.jpg,Bl122
14,15081.216682,15081.404682,1,452436500,452442140,5640,audio/Ti81_452436500.jpg,Ti81
15,491.362221,491.384221,1,14740866,14741526,660,audio/Or61_14740866.jpg,Or61
16,1812.554013,1812.558013,2,54376620,54376740,120,audio/Bl122_54376620.jpg,Bl122
17,1934.704613,1934.709613,2,58041138,58041288,150,audio/Bl122_58041138.jpg,Bl122
18,1814.228379,1814.312379,1,54426851,54429371,2520,audio/Bl122_54426851.jpg,Bl122
19,8084.335803,8084.361803,1,242530074,242530854,780,audio/Li145_242530074.jpg,Li145
20,395.992529,396.019529,1,11879775,11880585,810,audio/Or61_11879775.jpg,Or61
21,2195.824183,2195.897183,1,65874725,65876915,2190,audio/Bl122_65874725.jpg,Bl122
22,5707.351085,5707.454085,1,171220532,171223622,3090,audio/Li145_171220532.jpg,Li145
23,9180.779829,9180.801829,1,275423394,275424054,660,audio/Li145_275423394.jpg,Li145
24,15143.561403,15143.676403,1,454306842,454310292,3450,audio/Ti81_454306842.jpg,Ti81
25,2056.935469,2056.946469,1,61708064,61708394,330,audio/Bl122_61708064.jpg,Bl122
26,349.452039,349.650039,1,10483561,10489501,5940,audio/Li145_10483561.jpg,Li145
27,430.056962,430.228962,1,12901708,12906868,5160,audio/Or61_12901708.jpg,Or61
28,2067.536469,2067.686469,1,62026094,62030594,4500,audio/Bl122_62026094.jpg,Bl122
29,15039.986813,15039.997914,1,451199604,451199937,333,audio/Ti81_451199604.jpg,Ti81
30,531.707416,531.736416,1,15951222,15952092,870,audio/Or61_15951222.jpg,Or61
31,625.916417,626.054417,1,18777492,18781632,4140,audio/Or61_18777492.jpg,Or61
32,2224.610183,2224.625183,2,66738305,66738755,450,audio/Bl122_66738305.jpg,Bl122
33,1945.663779,1945.676779,2,58369913,58370303,390,audio/Bl122_58369913.jpg,Bl122
34,15286.133439,15286.173439,1,458584003,458585203,1200,audio/Ti81_458584003.jpg,Ti81
35,7569.559558,7569.572558,1,227086786,227087176,390,audio/Li145_227086786.jpg,Li145
36,766.535271,766.541271,2,22996058,22996238,180,audio/Or61_22996058.jpg,Or61
37,8083.357803,8083.371803,2,242500734,242501154,420,audio/Li145_242500734.jpg,Li145
38,1946.834779,1946.861779,1,58405043,58405853,810,audio/Bl122_58405043.jpg,Bl122
39,574.16471,574.24871,1,17224941,17227461,2520,audio/Or61_17224941.jpg,Or61
40,543.483416,543.504416,1,16304502,16305132,630,audio/Or61_16304502.jpg,Or61
41,2219.997183,2220.005183,2,66599915,66600155,240,audio/Bl122_66599915.jpg,Bl122
42,717.076271,717.308271,1,21512288,21519248,6960,audio/Or61_21512288.jpg,Or61
43,15314.710428,15314.794428,1,459441312,459443832,2520,audio/Ti81_459441312.jpg,Ti81
44,486.954221,487.187221,1,14608626,14615616,6990,audio/Or61_14608626.jpg,Or61
45,1970.897779,1970.976779,1,59126933,59129303,2370,audio/Bl122_59126933.jpg,Bl122
46,488.726221,488.734221,2,14661786,14662026,240,audio/Or61_14661786.jpg,Or61
47,1963.915779,1964.005779,1,58917473,58920173,2700,audio/Bl122_58917473.jpg,Bl122
48,2083.947961,2083.949961,2,62518438,62518498,60,audio/Bl122_62518438.jpg,Bl122
49,768.029271,768.059271,1,23040878,23041778,900,audio/Or61_23040878.jpg,Or61
50,1961.108779,1961.384779,1,58833263,58841543,8280,audio/Bl122_58833263.jpg,Bl122
51,2120.521183,2120.544183,1,63615635,63616325,690,audio/Bl122_63615635.jpg,Bl122
52,9172.280804,9172.338804,1,275168424,275170164,1740,audio/Li145_275168424.jpg,Li145
53,724.995271,725.006271,1,21749858,21750188,330,audio/Or61_21749858.jpg,Or61
54,185.932971,186.008971,1,5577989,5580269,2280,audio/Or61_5577989.jpg,Or61
55,1947.804779,1947.999779,1,58434143,58439993,5850,audio/Bl122_58434143.jpg,Bl122
56,217.472413,217.666413,1,6524172,6529992,5820,audio/Or61_6524172.jpg,Or61
57,2168.953183,2169.027183,2,65068595,65070815,2220,audio/Bl122_65068595.jpg,Bl122
58,2125.326183,2125.342183,2,63759785,63760265,480,audio/Bl122_63759785.jpg,Bl122
59,2165.558183,2165.571183,2,64966745,64967135,390,audio/Bl122_64966745.jpg,Bl122
60,2177.584183,2177.593183,2,65327525,65327795,270,audio/Bl122_65327525.jpg,Bl122
61,15156.607257,15156.623257,1,454698217,454698697,480,audio/Ti81_454698217.jpg,Ti81
62,2006.411779,2006.417779,2,60192353,60192533,180,audio/Bl122_60192353.jpg,Bl122
63,3414.344587,3414.501767,1,102430337,102435053,4716,audio/Ti81_102430337.jpg,Ti81
64,2038.329469,2038.332469,2,61149884,61149974,90,audio/Bl122_61149884.jpg,Bl122
65,15344.127971,15344.201971,1,460323839,460326059,2220,audio/Ti81_460323839.jpg,Ti81
66,8097.440141,8097.681141,1,242923204,242930434,7230,audio/Li145_242923204.jpg,Li145
67,15228.633443,15228.698443,1,456859003,456860953,1950,audio/Ti81_456859003.jpg,Ti81
68,2110.966183,2111.007183,1,63328985,63330215,1230,audio/Bl122_63328985.jpg,Bl122
69,820.757419,820.764419,2,24622722,24622932,210,audio/Bl122_24622722.jpg,Bl122
70,2040.548815,2040.569815,2,61216464,61217094,630,audio/Li145_61216464.jpg,Li145
71,2127.793183,2128.067183,1,63833795,63842015,8220,audio/Bl122_63833795.jpg,Bl122
72,478.599221,478.604221,2,14357976,14358126,150,audio/Or61_14357976.jpg,Or61
73,388.577161,388.609161,1,11657314,11658274,960,audio/Or61_11657314.jpg,Or61
74,493.603221,493.673221,1,14808096,14810196,2100,audio/Or61_14808096.jpg,Or61
75,510.778221,510.924221,1,15323346,15327726,4380,audio/Or61_15323346.jpg,Or61
76,2195.362183,2195.367183,2,65860865,65861015,150,audio/Bl122_65860865.jpg,Bl122
77,15298.202664,15298.221664,1,458946079,458946649,570,audio/Ti81_458946079.jpg,Ti81
78,1794.621115,1794.625115,2,53838633,53838753,120,audio/Bl122_53838633.jpg,Bl122
79,2152.490183,2152.494183,2,64574705,64574825,120,audio/Bl122_64574705.jpg,Bl122
80,2088.282961,2088.347961,1,62648488,62650438,1950,audio/Bl122_62648488.jpg,Bl122
81,1989.326779,1989.333779,2,59679803,59680013,210,audio/Bl122_59679803.jpg,Bl122
82,806.207882,806.326882,1,24186236,24189806,3570,audio/Or61_24186236.jpg,Or61
83,15055.388966,15055.443966,1,451661668,451663318,1650,audio/Ti81_451661668.jpg,Ti81
84,482.330221,482.334221,2,14469906,14470026,120,audio/Or61_14469906.jpg,Or61
85,729.019271,729.052271,1,21870578,21871568,990,audio/Or61_21870578.jpg,Or61
86,2013.209959,2013.214959,2,60396298,60396448,150,audio/Bl122_60396298.jpg,Bl122
87,323.839795,324.087795,1,9715193,9722633,7440,audio/Or61_9715193.jpg,Or61
88,1961.456779,1961.461779,2,58843703,58843853,150,audio/Bl122_58843703.jpg,Bl122
89,15068.070415,15068.083562,1,452042112,452042506,394,audio/Ti81_452042112.jpg,Ti81
90,2216.070183,2216.073183,2,66482105,66482195,90,audio/Bl122_66482105.jpg,Bl122
91,724.315271,724.574271,1,21729458,21737228,7770,audio/Or61_21729458.jpg,Or61
92,15047.631966,15047.648966,1,451428958,451429468,510,audio/Ti81_451428958.jpg,Ti81
93,750.832271,750.864271,1,22524968,22525928,960,audio/Or61_22524968.jpg,Or61
94,2200.018183,2200.043183,2,66000545,66001295,750,audio/Bl122_66000545.jpg,Bl122
95,6332.022902,6332.254902,1,189960687,189967647,6960,audio/Li145_189960687.jpg,Li145
96,3428.831907,3429.133905,1,102864957,102874017,9060,audio/Ti81_102864957.jpg,Ti81
97,15074.884682,15075.067682,1,452246540,452252030,5490,audio/Ti81_452246540.jpg,Ti81
98,2221.226183,2221.229183,2,66636785,66636875,90,audio/Bl122_66636785.jpg,Bl122
99,728.896271,728.928271,1,21866888,21867848,960,audio/Or61_21866888.jpg,Or61
100,790.464827,790.466827,2,23713944,23714004,60,audio/Or61_23713944.jpg,Or61
101,1954.270779,1954.296779,2,58628123,58628903,780,audio/Bl122_58628123.jpg,Bl122
102,3471.078811,3471.102148,1,104132364,104133064,700,audio/Ti81_104132364.jpg,Ti81
103,15224.514443,15224.551443,1,456735433,456736543,1110,audio/Ti81_456735433.jpg,Ti81
104,718.915271,718.945271,1,21567458,21568358,900,audio/Or61_21567458.jpg,Or61
105,2132.254183,2132.259183,2,63967625,63967775,150,audio/Bl122_63967625.jpg,Bl122
106,2221.173183,2221.202183,2,66635195,66636065,870,audio/Bl122_66635195.jpg,Bl122
107,480.851221,480.982221,1,14425536,14429466,3930,audio/Or61_14425536.jpg,Or61
108,527.402416,527.475416,1,15822072,15824262,2190,audio/Or61_15822072.jpg,Or61
109,2006.001779,2006.030779,1,60180053,60180923,870,audio/Bl122_60180053.jpg,Bl122
110,15317.404428,15317.569428,1,459522132,459527082,4950,audio/Ti81_459522132.jpg,Ti81
111,2145.797183,2145.867183,2,64373915,64376015,2100,audio/Bl122_64373915.jpg,Bl122
112,502.491221,502.496221,1,15074736,15074886,150,audio/Or61_15074736.jpg,Or61
113,476.078221,476.086221,2,14282346,14282586,240,audio/Or61_14282346.jpg,Or61
114,2169.601183,2169.613183,2,65088035,65088395,360,audio/Bl122_65088035.jpg,Bl122
115,1958.810779,1958.938779,2,58764323,58768163,3840,audio/Bl122_58764323.jpg,Bl122
116,1940.862779,1940.898779,2,58225883,58226963,1080,audio/Bl122_58225883.jpg,Bl122
117,15242.547874,15242.748084,1,457276436,457282442,6006,audio/Ti81_457276436.jpg,Ti81
118,1775.153974,1775.176974,1,53254619,53255309,690,audio/Bl122_53254619.jpg,Bl122
119,15071.358682,15071.532682,1,452140760,452145980,5220,audio/Ti81_452140760.jpg,Ti81
120,2208.932183,2208.955183,2,66267965,66268655,690,audio/Bl122_66267965.jpg,Bl122
121,550.113416,550.293416,1,16503402,16508802,5400,audio/Or61_16503402.jpg,Or61
122,482.140221,482.144221,2,14464206,14464326,120,audio/Or61_14464206.jpg,Or61
123,565.645416,565.715416,2,16969362,16971462,2100,audio/Or61_16969362.jpg,Or61
124,9167.730583,9167.759583,1,275031917,275032787,870,audio/Li145_275031917.jpg,Li145
125,626.723417,626.730417,2,18801702,18801912,210,audio/Or61_18801702.jpg,Or61
126,15023.114227,15023.156171,1,450693426,450694685,1259,audio/Ti81_450693426.jpg,Ti81
127,15227.700443,15227.759443,1,456831013,456832783,1770,audio/Ti81_456831013.jpg,Ti81
128,3419.679567,3419.686915,1,102590387,102590607,220,audio/Ti81_102590387.jpg,Ti81
129,15214.95558,15214.97158,1,456448667,456449147,480,audio/Ti81_456448667.jpg,Ti81
130,387.884161,387.907161,1,11636524,11637214,690,audio/Or61_11636524.jpg,Or61
131,15161.836257,15161.964257,1,454855087,454858927,3840,audio/Ti81_454855087.jpg,Ti81
132,614.325417,614.356417,1,18429762,18430692,930,audio/Or61_18429762.jpg,Or61
133,747.475271,747.504271,1,22424258,22425128,870,audio/Or61_22424258.jpg,Or61
134,711.192271,711.222271,1,21335768,21336668,900,audio/Or61_21335768.jpg,Or61
135,2083.173961,2083.210961,2,62495218,62496328,1110,audio/Bl122_62495218.jpg,Bl122
136,1785.75543,1785.78243,1,53572662,53573472,810,audio/Bl122_53572662.jpg,Bl122
137,3583.134686,3583.160686,1,107494040,107494820,780,audio/Li145_107494040.jpg,Li145
138,406.556692,406.570692,2,12196700,12197120,420,audio/Or61_12196700.jpg,Or61
139,2159.831183,2159.834183,2,64794935,64795025,90,audio/Bl122_64794935.jpg,Bl122
140,1756.657261,1756.925261,1,52699717,52707757,8040,audio/Bl122_52699717.jpg,Bl122
141,1969.295779,1969.327779,1,59078873,59079833,960,audio/Bl122_59078873.jpg,Bl122
142,2149.082183,2149.309183,1,64472465,64479275,6810,audio/Bl122_64472465.jpg,Bl122
143,15263.848358,15263.884358,1,457915450,457916530,1080,audio/Ti81_457915450.jpg,Ti81
144,3446.102111,3446.11769,1,103383063,103383530,467,audio/Ti81_103383063.jpg,Ti81
145,487.742221,487.748221,2,14632266,14632446,180,audio/Or61_14632266.jpg,Or61
146,1951.483779,1951.506779,2,58544513,58545203,690,audio/Bl122_58544513.jpg,Bl122
147,2160.257183,2160.425183,1,64807715,64812755,5040,audio/Bl122_64807715.jpg,Bl122
148,2152.774183,2152.796183,2,64583225,64583885,660,audio/Bl122_64583225.jpg,Bl122
149,15223.811443,15223.832443,1,456714343,456714973,630,audio/Ti81_456714343.jpg,Ti81
150,2116.204183,2116.456183,1,63486125,63493685,7560,audio/Bl122_63486125.jpg,Bl122
151,1944.075779,1944.104779,2,58322273,58323143,870,audio/Bl122_58322273.jpg,Bl122
152,1774.577974,1774.593974,2,53237339,53237819,480,audio/Bl122_53237339.jpg,Bl122
153,1994.303779,1994.309779,2,59829113,59829293,180,audio/Bl122_59829113.jpg,Bl122
154,2146.088183,2146.100183,2,64382645,64383005,360,audio/Bl122_64382645.jpg,Bl122
155,768.261271,768.320271,1,23047838,23049608,1770,audio/Or61_23047838.jpg,Or61
156,15206.67858,15206.84158,1,456200357,456205247,4890,audio/Ti81_456200357.jpg,Ti81
157,15069.238682,15069.307682,1,452077160,452079230,2070,audio/Ti81_452077160.jpg,Ti81
158,517.970221,517.993221,1,15539106,15539796,690,audio/Or61_15539106.jpg,Or61
159,9168.601583,9168.685583,1,275058047,275060567,2520,audio/Li145_275058047.jpg,Li145
160,15343.301971,15343.326971,1,460299059,460299809,750,audio/Ti81_460299059.jpg,Ti81
161,2047.429469,2047.668469,1,61422884,61430054,7170,audio/Bl122_61422884.jpg,Bl122
162,704.333271,704.365271,1,21129998,21130958,960,audio/Or61_21129998.jpg,Or61
163,2185.209183,2185.372183,1,65556275,65561165,4890,audio/Bl122_65556275.jpg,Bl122
164,186.569971,186.573971,2,5597099,5597219,120,audio/Or61_5597099.jpg,Or61
165,2004.216779,2004.259779,1,60126503,60127793,1290,audio/Bl122_60126503.jpg,Bl122
166,1991.818779,1991.829779,2,59754563,59754893,330,audio/Bl122_59754563.jpg,Bl122
167,2035.535469,2035.586469,1,61066064,61067594,1530,audio/Bl122_61066064.jpg,Bl122
168,2154.400183,2154.483183,2,64632005,64634495,2490,audio/Bl122_64632005.jpg,Bl122
169,558.336416,558.360416,2,16750092,16750812,720,audio/Or61_16750092.jpg,Or61
170,1963.578779,1963.596779,2,58907363,58907903,540,audio/Bl122_58907363.jpg,Bl122
171,6302.792561,6302.820561,1,189083776,189084616,840,audio/Li145_189083776.jpg,Li145
172,531.537416,531.549416,2,15946122,15946482,360,audio/Or61_15946122.jpg,Or61
173,2037.974469,2037.983469,2,61139234,61139504,270,audio/Bl122_61139234.jpg,Bl122
174,1995.925779,1996.202779,1,59877773,59886083,8310,audio/Bl122_59877773.jpg,Bl122
175,7567.922558,7568.082558,1,227037676,227042476,4800,audio/Li145_227037676.jpg,Li145
176,2003.778779,2003.825779,1,60113363,60114773,1410,audio/Bl122_60113363.jpg,Bl122
177,1967.313779,1967.322779,2,59019413,59019683,270,audio/Bl122_59019413.jpg,Bl122
178,1799.768115,1799.955115,1,53993043,53998653,5610,audio/Bl122_53993043.jpg,Bl122
179,2124.838183,2124.921183,1,63745145,63747635,2490,audio/Bl122_63745145.jpg,Bl122
180,15297.772664,15297.788664,1,458933179,458933659,480,audio/Ti81_458933179.jpg,Ti81
181,619.092417,619.131417,1,18572772,18573942,1170,audio/Or61_18572772.jpg,Or61
182,5712.096036,5712.225036,1,171362881,171366751,3870,audio/Li145_171362881.jpg,Li145
183,756.697271,756.735271,1,22700918,22702058,1140,audio/Or61_22700918.jpg,Or61
184,2218.079183,2218.116183,2,66542375,66543485,1110,audio/Bl122_66542375.jpg,Bl122
185,2058.561469,2058.578469,1,61756844,61757354,510,audio/Bl122_61756844.jpg,Bl122
186,1788.504115,1788.510115,2,53655123,53655303,180,audio/Bl122_53655123.jpg,Bl122
187,2150.139183,2150.165183,1,64504175,64504955,780,audio/Bl122_64504175.jpg,Bl122
188,423.457081,423.463081,2,12703712,12703892,180,audio/Or61_12703712.jpg,Or61
189,181.270971,181.340971,1,5438129,5440229,2100,audio/Or61_5438129.jpg,Or61
190,3418.970427,3419.062263,1,102569112,102571867,2755,audio/Ti81_102569112.jpg,Ti81
191,562.407416,562.615416,1,16872222,16878462,6240,audio/Or61_16872222.jpg,Or61
192,7546.264781,7546.287781,1,226387943,226388633,690,audio/Li145_226387943.jpg,Li145
193,2055.781469,2055.785469,2,61673444,61673564,120,audio/Bl122_61673444.jpg,Bl122
194,14901.245659,14901.417977,1,447037369,447042539,5170,audio/Ti81_447037369.jpg,Ti81
195,2227.686183,2227.744183,1,66830585,66832325,1740,audio/Bl122_66830585.jpg,Bl122
196,441.696265,441.699265,2,13250887,13250977,90,audio/Or61_13250887.jpg,Or61
197,622.559417,622.592417,1,18676782,18677772,990,audio/Or61_18676782.jpg,Or61
198,2153.199183,2153.288183,2,64595975,64598645,2670,audio/Bl122_64595975.jpg,Bl122
199,2234.660183,2234.923183,1,67039805,67047695,7890,audio/Bl122_67039805.jpg,Bl122
200,608.463417,608.613417,1,18253902,18258402,4500,audio/Or61_18253902.jpg,Or61
201,2221.247183,2221.258183,1,66637415,66637745,330,audio/Bl122_66637415.jpg,Bl122
202,329.032967,329.061967,1,9870989,9871859,870,audio/Or61_9870989.jpg,Or61
203,607.961417,607.966417,2,18238842,18238992,150,audio/Or61_18238842.jpg,Or61
204,2050.285469,2050.310469,1,61508564,61509314,750,audio/Bl122_61508564.jpg,Bl122
205,549.035416,549.063416,1,16471062,16471902,840,audio/Or61_16471062.jpg,Or61
206,15316.613428,15316.830428,1,459498402,459504912,6510,audio/Ti81_459498402.jpg,Ti81
207,635.642417,635.660417,1,19069272,19069812,540,audio/Or61_19069272.jpg,Or61
208,637.249417,637.253417,2,19117482,19117602,120,audio/Or61_19117482.jpg,Or61
209,590.129088,590.328088,1,17703872,17709842,5970,audio/Or61_17703872.jpg,Or61
210,15071.706682,15071.911682,1,452151200,452157350,6150,audio/Ti81_452151200.jpg,Ti81
211,2222.056183,2222.063183,2,66661685,66661895,210,audio/Bl122_66661685.jpg,Bl122
212,748.051271,748.068271,2,22441538,22442048,510,audio/Or61_22441538.jpg,Or61
213,471.334221,471.338221,2,14140026,14140146,120,audio/Or61_14140026.jpg,Or61
214,2175.641183,2175.645183,2,65269235,65269355,120,audio/Bl122_65269235.jpg,Bl122
215,1950.173779,1950.177779,2,58505213,58505333,120,audio/Bl122_58505213.jpg,Bl122
216,1769.614657,1769.712657,2,53088439,53091379,2940,audio/Bl122_53088439.jpg,Bl122
217,2082.587961,2082.591961,2,62477638,62477758,120,audio/Bl122_62477638.jpg,Bl122
218,2184.344183,2184.448183,1,65530325,65533445,3120,audio/Bl122_65530325.jpg,Bl122
219,2129.535183,2129.648183,1,63886055,63889445,3390,audio/Bl122_63886055.jpg,Bl122
220,512.715221,512.826221,1,15381456,15384786,3330,audio/Or61_15381456.jpg,Or61
221,767.571271,767.582271,1,23027138,23027468,330,audio/Or61_23027138.jpg,Or61
222,2215.643183,2215.646183,2,66469295,66469385,90,audio/Bl122_66469295.jpg,Bl122
223,15273.599439,15273.634439,1,458207983,458209033,1050,audio/Ti81_458207983.jpg,Ti81
224,2088.703961,2088.708961,2,62661118,62661268,150,audio/Bl122_62661118.jpg,Bl122
225,499.786221,499.788221,2,14993586,14993646,60,audio/Or61_14993586.jpg,Or61
226,1962.830779,1962.834779,2,58884923,58885043,120,audio/Bl122_58884923.jpg,Bl122
227,2159.284183,2159.311183,1,64778525,64779335,810,audio/Bl122_64778525.jpg,Bl122
228,471.077221,471.181221,1,14132316,14135436,3120,audio/Or61_14132316.jpg,Or61
229,8083.065803,8083.109803,2,242491974,242493294,1320,audio/Li145_242491974.jpg,Li145
230,506.643221,506.647221,2,15199296,15199416,120,audio/Or61_15199296.jpg,Or61
231,2004.441779,2004.466779,2,60133253,60134003,750,audio/Bl122_60133253.jpg,Bl122
232,2049.308469,2049.356469,2,61479254,61480694,1440,audio/Bl122_61479254.jpg,Bl122
233,1964.065779,1964.076779,2,58921973,58922303,330,audio/Bl122_58921973.jpg,Bl122
234,551.240416,551.280416,1,16537212,16538412,1200,audio/Or61_16537212.jpg,Or61
235,2218.228183,2218.241183,2,66546845,66547235,390,audio/Bl122_66546845.jpg,Bl122
236,1800.778115,1800.815115,1,54023343,54024453,1110,audio/Bl122_54023343.jpg,Bl122
237,2038.866469,2038.871469,2,61165994,61166144,150,audio/Bl122_61165994.jpg,Bl122
238,5706.059085,5706.097085,1,171181772,171182912,1140,audio/Li145_171181772.jpg,Li145
239,15143.285403,15143.344403,1,454298562,454300332,1770,audio/Ti81_454298562.jpg,Ti81
240,563.119416,563.164416,1,16893582,16894932,1350,audio/Or61_16893582.jpg,Or61
241,2162.561183,2162.606183,2,64876835,64878185,1350,audio/Bl122_64876835.jpg,Bl122
242,750.994271,751.002271,1,22529828,22530068,240,audio/Or61_22529828.jpg,Or61
243,2040.362815,2040.367815,2,61210884,61211034,150,audio/Li145_61210884.jpg,Li145
244,2197.682183,2197.703183,2,65930465,65931095,630,audio/Bl122_65930465.jpg,Bl122
245,1946.244779,1946.285779,2,58387343,58388573,1230,audio/Bl122_58387343.jpg,Bl122
246,2231.163183,2231.171183,2,66934895,66935135,240,audio/Bl122_66934895.jpg,Bl122
247,1951.279779,1951.283779,2,58538393,58538513,120,audio/Bl122_58538393.jpg,Bl122
248,2091.932961,2092.029961,1,62757988,62760898,2910,audio/Bl122_62757988.jpg,Bl122
249,2039.975815,2039.996815,1,61199274,61199904,630,audio/Li145_61199274.jpg,Li145
250,7553.293715,7553.324715,1,226598811,226599741,930,audio/Li145_226598811.jpg,Li145
251,725.438271,725.455271,1,21763148,21763658,510,audio/Or61_21763148.jpg,Or61
252,2159.075183,2159.098183,2,64772255,64772945,690,audio/Bl122_64772255.jpg,Bl122
253,2138.767183,2138.773183,2,64163015,64163195,180,audio/Bl122_64163015.jpg,Bl122
254,8092.097536,8092.115536,1,242762926,242763466,540,audio/Li145_242762926.jpg,Li145
255,1949.212779,1949.237779,2,58476383,58477133,750,audio/Bl122_58476383.jpg,Bl122
256,403.149692,403.190692,2,12094490,12095720,1230,audio/Or61_12094490.jpg,Or61
257,391.726161,391.868161,1,11751784,11756044,4260,audio/Or61_11751784.jpg,Or61
258,1814.383379,1814.390379,2,54431501,54431711,210,audio/Bl122_54431501.jpg,Bl122
259,2064.389469,2064.394469,2,61931684,61931834,150,audio/Bl122_61931684.jpg,Bl122
260,3641.593298,3641.769298,1,109247798,109253078,5280,audio/Li145_109247798.jpg,Li145
261,15149.271164,15149.427222,1,454478134,454482816,4682,audio/Ti81_454478134.jpg,Ti81
262,2084.904961,2084.968961,1,62547148,62549068,1920,audio/Bl122_62547148.jpg,Bl122
263,749.532271,749.559271,1,22485968,22486778,810,audio/Or61_22485968.jpg,Or61
264,5968.434227,5968.446227,1,179053026,179053386,360,audio/Li145_179053026.jpg,Li145
265,2191.169183,2191.180183,2,65735075,65735405,330,audio/Bl122_65735075.jpg,Bl122
266,15133.234572,15133.273989,1,453997037,453998219,1182,audio/Ti81_453997037.jpg,Ti81
267,922.162245,922.313118,1,27664867,27669393,4526,audio/Ti81_27664867.jpg,Ti81
268,5841.088404,5841.111404,1,175232652,175233342,690,audio/Li145_175232652.jpg,Li145
269,811.833882,811.837882,2,24355016,24355136,120,audio/Or61_24355016.jpg,Or61
270,8083.903803,8083.914803,2,242517114,242517444,330,audio/Li145_242517114.jpg,Li145
271,2092.188961,2092.222961,1,62765668,62766688,1020,audio/Bl122_62765668.jpg,Bl122
272,491.013221,491.046221,1,14730396,14731386,990,audio/Or61_14730396.jpg,Or61
273,7555.701715,7555.723715,1,226671051,226671711,660,audio/Li145_226671051.jpg,Li145
274,2156.942183,2156.953183,2,64708265,64708595,330,audio/Bl122_64708265.jpg,Bl122
275,2139.423183,2139.436183,1,64182695,64183085,390,audio/Bl122_64182695.jpg,Bl122
276,2206.722183,2206.734183,2,66201665,66202025,360,audio/Bl122_66201665.jpg,Bl122
277,3580.141097,3580.193097,1,107404232,107405792,1560,audio/Li145_107404232.jpg,Li145
278,9166.612583,9166.723583,1,274998377,275001707,3330,audio/Li145_274998377.jpg,Li145
279,3471.626482,3471.65455,1,104148794,104149636,842,audio/Ti81_104148794.jpg,Ti81
280,15061.417966,15061.444966,1,451842538,451843348,810,audio/Ti81_451842538.jpg,Ti81
281,554.569416,554.617416,1,16637082,16638522,1440,audio/Or61_16637082.jpg,Or61
282,747.919271,747.926271,2,22437578,22437788,210,audio/Or61_22437578.jpg,Or61
283,15237.852874,15237.950874,1,457135586,457138526,2940,audio/Ti81_457135586.jpg,Ti81
284,1961.005779,1961.022779,2,58830173,58830683,510,audio/Bl122_58830173.jpg,Bl122
285,357.855391,358.015391,1,10735661,10740461,4800,audio/Li145_10735661.jpg,Li145
286,2166.545183,2166.554183,2,64996355,64996625,270,audio/Bl122_64996355.jpg,Bl122
287,1938.332779,1938.353779,2,58149983,58150613,630,audio/Bl122_58149983.jpg,Bl122
288,14946.945355,14947.08664,1,448408360,448412599,4239,audio/Ti81_448408360.jpg,Ti81
289,2211.515183,2211.518183,2,66345455,66345545,90,audio/Bl122_66345455.jpg,Bl122
290,2164.519183,2164.571183,1,64935575,64937135,1560,audio/Bl122_64935575.jpg,Bl122
291,1991.074779,1991.099779,2,59732243,59732993,750,audio/Bl122_59732243.jpg,Bl122
292,15263.068358,15263.125358,1,457892050,457893760,1710,audio/Ti81_457892050.jpg,Ti81
293,1970.000779,1970.003779,2,59100023,59100113,90,audio/Bl122_59100023.jpg,Bl122
294,2124.354183,2124.420183,2,63730625,63732605,1980,audio/Bl122_63730625.jpg,Bl122
295,1988.257779,1988.374779,1,59647733,59651243,3510,audio/Bl122_59647733.jpg,Bl122
296,2040.699815,2040.706815,2,61220994,61221204,210,audio/Li145_61220994.jpg,Li145
297,15277.789439,15277.829439,1,458333683,458334883,1200,audio/Ti81_458333683.jpg,Ti81
298,1795.829115,1796.197115,1,53874873,53885913,11040,audio/Bl122_53874873.jpg,Bl122
299,2059.036469,2059.194469,1,61771094,61775834,4740,audio/Bl122_61771094.jpg,Bl122
300,2144.106183,2144.202183,2,64323185,64326065,2880,audio/Bl122_64323185.jpg,Bl122
301,15205.13458,15205.15758,1,456154037,456154727,690,audio/Ti81_456154037.jpg,Ti81
302,811.848882,812.063882,1,24355466,24361916,6450,audio/Or61_24355466.jpg,Or61
303,8097.853141,8097.870141,1,242935594,242936104,510,audio/Li145_242935594.jpg,Li145
304,1751.954186,1752.211186,1,52558625,52566335,7710,audio/Bl122_52558625.jpg,Bl122
305,15334.25401,15334.38501,1,460027620,460031550,3930,audio/Ti81_460027620.jpg,Ti81
306,3419.306107,3419.324903,1,102579183,102579747,564,audio/Ti81_102579183.jpg,Ti81
307,3468.977441,3469.03673,1,104069323,104071101,1778,audio/Ti81_104069323.jpg,Ti81
308,2084.229961,2084.277961,1,62526898,62528338,1440,audio/Bl122_62526898.jpg,Bl122
309,2029.429908,2029.433908,2,60882897,60883017,120,audio/Bl122_60882897.jpg,Bl122
310,15239.392874,15239.437866,1,457181786,457183135,1349,audio/Ti81_457181786.jpg,Ti81
311,15160.686257,15160.917257,1,454820587,454827517,6930,audio/Ti81_454820587.jpg,Ti81
312,1769.235657,1769.352657,1,53077069,53080579,3510,audio/Bl122_53077069.jpg,Bl122
313,631.818417,631.937417,1,18954552,18958122,3570,audio/Or61_18954552.jpg,Or61
314,8084.615803,8084.666803,1,242538474,242540004,1530,audio/Li145_242538474.jpg,Li145
315,749.017271,749.045271,1,22470518,22471358,840,audio/Or61_22470518.jpg,Or61
316,15154.909257,15154.957257,1,454647277,454648717,1440,audio/Ti81_454647277.jpg,Ti81
317,15162.392574,15162.439979,1,454871777,454873199,1422,audio/Ti81_454871777.jpg,Ti81
318,15047.691966,15047.714966,1,451430758,451431448,690,audio/Ti81_451430758.jpg,Ti81
319,2167.137183,2167.141183,2,65014115,65014235,120,audio/Bl122_65014115.jpg,Bl122
320,9176.382719,9176.583719,1,275291481,275297511,6030,audio/Li145_275291481.jpg,Li145
321,2004.828779,2004.835779,2,60144863,60145073,210,audio/Bl122_60144863.jpg,Bl122
322,511.564221,511.608221,1,15346926,15348246,1320,audio/Or61_15346926.jpg,Or61
323,15329.281625,15329.344625,1,459878448,459880338,1890,audio/Ti81_459878448.jpg,Ti81
324,5.395509,5.474509,1,161865,164235,2370,audio/Or61_161865.jpg,Or61
325,600.994417,600.999417,2,18029832,18029982,150,audio/Or61_18029832.jpg,Or61
326,492.068221,492.100221,1,14762046,14763006,960,audio/Or61_14762046.jpg,Or61
327,1951.812779,1952.061779,1,58554383,58561853,7470,audio/Bl122_58554383.jpg,Bl122
328,2214.153183,2214.163183,2,66424595,66424895,300,audio/Bl122_66424595.jpg,Bl122
329,796.868827,797.003827,1,23906064,23910114,4050,audio/Or61_23906064.jpg,Or61
330,9166.089583,9166.095583,1,274982687,274982867,180,audio/Li145_274982687.jpg,Li145
331,419.521581,419.527581,2,12585647,12585827,180,audio/Or61_12585647.jpg,Or61
332,1977.255779,1977.296779,1,59317673,59318903,1230,audio/Bl122_59317673.jpg,Bl122
333,2189.020183,2189.026183,2,65670605,65670785,180,audio/Bl122_65670605.jpg,Bl122
334,557.334416,557.356416,1,16720032,16720692,660,audio/Or61_16720032.jpg,Or61
335,2114.041183,2114.054183,2,63421235,63421625,390,audio/Bl122_63421235.jpg,Bl122
336,1982.177779,1982.228779,1,59465333,59466863,1530,audio/Bl122_59465333.jpg,Bl122
337,322.5957,322.7387,1,9677871,9682161,4290,audio/Li145_9677871.jpg,Li145
338,1770.830657,1770.879657,1,53124919,53126389,1470,audio/Bl122_53124919.jpg,Bl122
339,601.056417,601.086417,1,18031692,18032592,900,audio/Or61_18031692.jpg,Or61
340,2098.747961,2098.786961,1,62962438,62963608,1170,audio/Bl122_62962438.jpg,Bl122
341,2203.456183,2203.459183,2,66103685,66103775,90,audio/Bl122_66103685.jpg,Bl122
342,15248.889074,15249.113074,1,457466672,457473392,6720,audio/Ti81_457466672.jpg,Ti81
343,2179.097183,2179.124183,1,65372915,65373725,810,audio/Bl122_65372915.jpg,Bl122
344,3466.999443,3467.102884,1,104009983,104013086,3103,audio/Ti81_104009983.jpg,Ti81
345,1972.540779,1972.545779,2,59176223,59176373,150,audio/Bl122_59176223.jpg,Bl122
346,637.257417,637.449417,1,19117722,19123482,5760,audio/Or61_19117722.jpg,Or61
347,443.86466,444.04866,1,13315939,13321459,5520,audio/Or61_13315939.jpg,Or61
348,2012.945959,2013.120959,1,60388378,60393628,5250,audio/Bl122_60388378.jpg,Bl122
349,2217.005183,2217.017183,2,66510155,66510515,360,audio/Bl122_66510155.jpg,Bl122
350,9166.333583,9166.357583,1,274990007,274990727,720,audio/Li145_274990007.jpg,Li145
351,2099.575961,2099.588961,2,62987278,62987668,390,audio/Bl122_62987278.jpg,Bl122
352,1989.784779,1989.818779,2,59693543,59694563,1020,audio/Bl122_59693543.jpg,Bl122
353,15075.454682,15075.553682,1,452263640,452266610,2970,audio/Ti81_452263640.jpg,Ti81
354,1957.589779,1957.595779,2,58727693,58727873,180,audio/Bl122_58727693.jpg,Bl122
355,2132.033183,2132.036183,2,63960995,63961085,90,audio/Bl122_63960995.jpg,Bl122
356,2161.551183,2161.576183,2,64846535,64847285,750,audio/Bl122_64846535.jpg,Bl122
357,1992.610779,1992.827779,1,59778323,59784833,6510,audio/Bl122_59778323.jpg,Bl122
358,5835.268068,5835.321068,1,175058042,175059632,1590,audio/Li145_175058042.jpg,Li145
359,578.77171,578.96371,1,17363151,17368911,5760,audio/Or61_17363151.jpg,Or61
360,729.402271,729.405271,1,21882068,21882158,90,audio/Or61_21882068.jpg,Or61
361,476.063221,476.067221,2,14281896,14282016,120,audio/Or61_14281896.jpg,Or61
362,7552.775715,7552.784715,1,226583271,226583541,270,audio/Li145_226583271.jpg,Li145
363,15143.347403,15143.393403,1,454300422,454301802,1380,audio/Ti81_454300422.jpg,Ti81
364,737.430271,737.538271,1,22122908,22126148,3240,audio/Or61_22122908.jpg,Or61
365,15252.591074,15252.616074,1,457577732,457578482,750,audio/Ti81_457577732.jpg,Ti81
366,2211.199183,2211.463183,1,66335975,66343895,7920,audio/Bl122_66335975.jpg,Bl122
367,508.880221,508.893221,1,15266406,15266796,390,audio/Or61_15266406.jpg,Or61
368,15036.234042,15036.298251,1,451087021,451088947,1926,audio/Ti81_451087021.jpg,Ti81
369,406.024692,406.229692,1,12180740,12186890,6150,audio/Or61_12180740.jpg,Or61
370,1797.199115,1797.370115,1,53915973,53921103,5130,audio/Bl122_53915973.jpg,Bl122
371,1938.589779,1938.593779,2,58157693,58157813,120,audio/Bl122_58157693.jpg,Bl122
372,611.529417,611.537417,2,18345882,18346122,240,audio/Or61_18345882.jpg,Or61
373,7554.243715,7554.247715,1,226627311,226627431,120,audio/Li145_226627311.jpg,Li145
374,15028.847835,15028.879119,1,450865435,450866373,938,audio/Ti81_450865435.jpg,Ti81
375,762.743271,762.785271,1,22882298,22883558,1260,audio/Or61_22882298.jpg,Or61
376,1789.047115,1789.060115,1,53671413,53671803,390,audio/Bl122_53671413.jpg,Bl122
377,2056.838469,2056.878469,1,61705154,61706354,1200,audio/Bl122_61705154.jpg,Bl122
378,15220.853443,15221.05659,1,456625603,456631697,6094,audio/Ti81_456625603.jpg,Ti81
379,1945.817779,1945.901779,1,58374533,58377053,2520,audio/Bl122_58374533.jpg,Bl122
380,2169.503183,2169.583183,2,65085095,65087495,2400,audio/Bl122_65085095.jpg,Bl122
381,14927.909018,14928.082093,1,447837270,447842462,5192,audio/Ti81_447837270.jpg,Ti81
382,2184.462183,2184.468183,2,65533865,65534045,180,audio/Bl122_65533865.jpg,Bl122
383,15026.122285,15026.177285,1,450783668,450785318,1650,audio/Ti81_450783668.jpg,Ti81
384,742.604271,742.837271,1,22278128,22285118,6990,audio/Or61_22278128.jpg,Or61
385,549.150416,549.187416,1,16474512,16475622,1110,audio/Or61_16474512.jpg,Or61
386,6333.616902,6333.649902,1,190008507,190009497,990,audio/Li145_190008507.jpg,Li145
387,2214.165183,2214.172183,2,66424955,66425165,210,audio/Bl122_66424955.jpg,Bl122
388,15164.840257,15164.882257,1,454945207,454946467,1260,audio/Ti81_454945207.jpg,Ti81
389,1989.203779,1989.322779,1,59676113,59679683,3570,audio/Bl122_59676113.jpg,Bl122
390,1967.645779,1967.696779,1,59029373,59030903,1530,audio/Bl122_59029373.jpg,Bl122
391,15223.671443,15223.708443,1,456710143,456711253,1110,audio/Ti81_456710143.jpg,Ti81
392,2064.518469,2064.743469,1,61935554,61942304,6750,audio/Bl122_61935554.jpg,Bl122
393,488.373221,488.376221,2,14651196,14651286,90,audio/Or61_14651196.jpg,Or61
394,780.919878,780.936878,1,23427596,23428106,510,audio/Or61_23427596.jpg,Or61
395,2013.607959,2013.613959,2,60408238,60408418,180,audio/Bl122_60408238.jpg,Bl122
396,187.691971,187.697971,2,5630759,5630939,180,audio/Or61_5630759.jpg,Or61
397,15298.678664,15298.741664,1,458960359,458962249,1890,audio/Ti81_458960359.jpg,Ti81
398,798.420827,798.470827,1,23952624,23954124,1500,audio/Or61_23952624.jpg,Or61
399,2130.951183,2130.965183,2,63928535,63928955,420,audio/Bl122_63928535.jpg,Bl122
400,3580.251097,3580.312097,1,107407532,107409362,1830,audio/Li145_107407532.jpg,Li145
401,2119.170183,2119.184183,1,63575105,63575525,420,audio/Bl122_63575105.jpg,Bl122
402,543.121416,543.254416,1,16293642,16297632,3990,audio/Or61_16293642.jpg,Or61
403,2107.262377,2107.265377,2,63217871,63217961,90,audio/Bl122_63217871.jpg,Bl122
404,3544.152205,3544.228146,1,106324566,106326844,2278,audio/Ti81_106324566.jpg,Ti81
405,512.059221,512.078221,1,15361776,15362346,570,audio/Or61_15361776.jpg,Or61
406,1975.598779,1975.618779,2,59267963,59268563,600,audio/Bl122_59267963.jpg,Bl122
407,1989.009779,1989.042779,1,59670293,59671283,990,audio/Bl122_59670293.jpg,Bl122
408,15231.160443,15231.197443,1,456934813,456935923,1110,audio/Ti81_456934813.jpg,Ti81
409,477.890221,478.090221,1,14336706,14342706,6000,audio/Or61_14336706.jpg,Or61
410,1991.612779,1991.617779,2,59748383,59748533,150,audio/Bl122_59748383.jpg,Bl122
411,2162.081183,2162.085183,2,64862435,64862555,120,audio/Bl122_64862435.jpg,Bl122
412,1955.029779,1955.040779,2,58650893,58651223,330,audio/Bl122_58650893.jpg,Bl122
413,1971.717779,1971.792779,2,59151533,59153783,2250,audio/Bl122_59151533.jpg,Bl122
414,1967.253779,1967.293779,1,59017613,59018813,1200,audio/Bl122_59017613.jpg,Bl122
415,6332.351902,6332.356902,2,189970557,189970707,150,audio/Li145_189970557.jpg,Li145
416,1992.506779,1992.545779,1,59775203,59776373,1170,audio/Bl122_59775203.jpg,Bl122
417,812.311882,812.317882,2,24369356,24369536,180,audio/Or61_24369356.jpg,Or61
418,3471.934093,3472.079163,1,104158022,104162374,4352,audio/Ti81_104158022.jpg,Ti81
419,15283.088439,15283.401439,1,458492653,458502043,9390,audio/Ti81_458492653.jpg,Ti81
420,2013.747959,2013.749959,2,60412438,60412498,60,audio/Bl122_60412438.jpg,Bl122
421,476.242221,476.251221,2,14287266,14287536,270,audio/Or61_14287266.jpg,Or61
422,5969.638227,5969.641227,1,179089146,179089236,90,audio/Li145_179089146.jpg,Li145
423,15032.887214,15032.923292,1,450986616,450987698,1082,audio/Ti81_450986616.jpg,Ti81
424,750.057271,750.134271,1,22501718,22504028,2310,audio/Or61_22501718.jpg,Or61
425,2068.831469,2068.861469,2,62064944,62065844,900,audio/Bl122_62064944.jpg,Bl122
426,1985.455779,1985.461779,2,59563673,59563853,180,audio/Bl122_59563673.jpg,Bl122
427,2194.721183,2194.734183,2,65841635,65842025,390,audio/Bl122_65841635.jpg,Bl122
428,2119.077183,2119.128183,1,63572315,63573845,1530,audio/Bl122_63572315.jpg,Bl122
429,1992.039779,1992.100779,1,59761193,59763023,1830,audio/Bl122_59761193.jpg,Bl122
430,1948.632779,1948.654779,1,58458983,58459643,660,audio/Bl122_58458983.jpg,Bl122
431,15026.326518,15026.410407,1,450789795,450792312,2517,audio/Ti81_450789795.jpg,Ti81
432,2212.624183,2212.673183,2,66378725,66380195,1470,audio/Bl122_66378725.jpg,Bl122
433,8889.764716,8889.769716,1,266692941,266693091,150,audio/Li145_266692941.jpg,Li145
434,15227.218443,15227.498443,1,456816553,456824953,8400,audio/Ti81_456816553.jpg,Ti81
435,708.950271,709.001271,1,21268508,21270038,1530,audio/Or61_21268508.jpg,Or61
436,1975.650779,1975.655779,2,59269523,59269673,150,audio/Bl122_59269523.jpg,Bl122
437,15093.971823,15094.100823,1,452819154,452823024,3870,audio/Ti81_452819154.jpg,Ti81
438,485.828221,485.854221,2,14574846,14575626,780,audio/Or61_14574846.jpg,Or61
439,621.691417,621.720417,1,18650742,18651612,870,audio/Or61_18650742.jpg,Or61
440,488.183221,488.200221,2,14645496,14646006,510,audio/Or61_14645496.jpg,Or61
441,2033.277469,2033.461469,2,60998324,61003844,5520,audio/Bl122_60998324.jpg,Bl122
442,2150.168183,2150.195183,1,64505045,64505855,810,audio/Bl122_64505045.jpg,Bl122
443,411.669165,411.805165,1,12350074,12354154,4080,audio/Or61_12350074.jpg,Or61
444,15067.424682,15067.787682,1,452022740,452033630,10890,audio/Ti81_452022740.jpg,Ti81
445,743.678271,743.697271,1,22310348,22310918,570,audio/Or61_22310348.jpg,Or61
446,5685.295974,5685.363974,1,170558879,170560919,2040,audio/Li145_170558879.jpg,Li145
447,2163.012183,2163.123183,2,64890365,64893695,3330,audio/Bl122_64890365.jpg,Bl122
448,15036.380121,15036.442564,1,451091403,451093276,1873,audio/Ti81_451091403.jpg,Ti81
449,406.389692,406.408692,2,12191690,12192260,570,audio/Or61_12191690.jpg,Or61
450,1942.097779,1942.151779,1,58262933,58264553,1620,audio/Bl122_58262933.jpg,Bl122
451,5840.324404,5840.361404,2,175209732,175210842,1110,audio/Li145_175209732.jpg,Li145
452,2184.828183,2184.973183,1,65544845,65549195,4350,audio/Bl122_65544845.jpg,Bl122
453,818.836882,818.961882,1,24565106,24568856,3750,audio/Or61_24565106.jpg,Or61
454,1966.874779,1967.077779,1,59006243,59012333,6090,audio/Bl122_59006243.jpg,Bl122
455,2162.256183,2162.325183,2,64867685,64869755,2070,audio/Bl122_64867685.jpg,Bl122
456,2038.658469,2038.662469,2,61159754,61159874,120,audio/Bl122_61159754.jpg,Bl122
457,9175.565719,9175.597719,1,275266971,275267931,960,audio/Li145_275266971.jpg,Li145
458,7555.450715,7555.489715,1,226663521,226664691,1170,audio/Li145_226663521.jpg,Li145
459,9046.204911,9046.256911,1,271386147,271387707,1560,audio/Li145_271386147.jpg,Li145
460,2199.991183,2200.000183,2,65999735,66000005,270,audio/Bl122_65999735.jpg,Bl122
461,2006.766779,2006.805779,2,60203003,60204173,1170,audio/Bl122_60203003.jpg,Bl122
462,2138.499183,2138.661183,1,64154975,64159835,4860,audio/Bl122_64154975.jpg,Bl122
463,2156.836183,2156.841183,2,64705085,64705235,150,audio/Bl122_64705085.jpg,Bl122
464,2112.468183,2112.496183,1,63374045,63374885,840,audio/Bl122_63374045.jpg,Bl122
465,2008.557779,2008.620779,1,60256733,60258623,1890,audio/Bl122_60256733.jpg,Bl122
466,2075.228823,2075.456823,1,62256864,62263704,6840,audio/Bl122_62256864.jpg,Bl122
467,405.613692,405.789692,1,12168410,12173690,5280,audio/Or61_12168410.jpg,Or61
468,15213.55458,15213.770471,1,456406637,456413114,6477,audio/Ti81_456406637.jpg,Ti81
469,1949.557779,1949.566779,2,58486733,58487003,270,audio/Bl122_58486733.jpg,Bl122
470,6299.966561,6300.068561,1,188998996,189002056,3060,audio/Li145_188998996.jpg,Li145
471,724.940271,724.964271,1,21748208,21748928,720,audio/Or61_21748208.jpg,Or61
472,9134.527751,9134.551751,1,274035832,274036552,720,audio/Li145_274035832.jpg,Li145
473,9536.723343,9536.745343,1,286101700,286102360,660,audio/Li145_286101700.jpg,Li145
474,15135.766989,15135.941989,1,454073009,454078259,5250,audio/Ti81_454073009.jpg,Ti81
475,2130.686183,2130.689183,2,63920585,63920675,90,audio/Bl122_63920585.jpg,Bl122
476,615.270417,615.278417,2,18458112,18458352,240,audio/Or61_18458112.jpg,Or61
477,503.571221,503.580221,2,15107136,15107406,270,audio/Or61_15107136.jpg,Or61
478,794.236827,794.278827,1,23827104,23828364,1260,audio/Or61_23827104.jpg,Or61
479,2083.512961,2083.555961,2,62505388,62506678,1290,audio/Bl122_62505388.jpg,Bl122
480,1798.599115,1798.603115,2,53957973,53958093,120,audio/Bl122_53957973.jpg,Bl122
481,2072.174469,2072.406469,1,62165234,62172194,6960,audio/Bl122_62165234.jpg,Bl122
482,748.579271,748.602271,1,22457378,22458068,690,audio/Or61_22457378.jpg,Or61
483,1990.399779,1990.412779,2,59711993,59712383,390,audio/Bl122_59711993.jpg,Bl122
484,2226.564183,2226.567183,2,66796925,66797015,90,audio/Bl122_66796925.jpg,Bl122
485,2215.215183,2215.220183,2,66456455,66456605,150,audio/Bl122_66456455.jpg,Bl122
486,2174.773183,2174.951183,1,65243195,65248535,5340,audio/Bl122_65243195.jpg,Bl122
487,797.585827,797.720827,1,23927574,23931624,4050,audio/Or61_23927574.jpg,Or61
488,2049.185469,2049.219469,2,61475564,61476584,1020,audio/Bl122_61475564.jpg,Bl122
489,1988.421779,1988.640779,1,59652653,59659223,6570,audio/Bl122_59652653.jpg,Bl122
490,15096.711823,15096.774823,1,452901354,452903244,1890,audio/Ti81_452901354.jpg,Ti81
491,2048.969469,2048.987469,2,61469084,61469624,540,audio/Bl122_61469084.jpg,Bl122
492,1789.615115,1789.623115,2,53688453,53688693,240,audio/Bl122_53688453.jpg,Bl122
493,15123.797981,15123.895981,1,453713939,453716879,2940,audio/Ti81_453713939.jpg,Ti81
494,6303.236561,6303.259561,1,189097096,189097786,690,audio/Li145_189097096.jpg,Li145
495,2175.781183,2175.792183,2,65273435,65273765,330,audio/Bl122_65273435.jpg,Bl122
496,1934.642613,1934.647613,2,58039278,58039428,150,audio/Bl122_58039278.jpg,Bl122
497,2209.455183,2209.461183,2,66283655,66283835,180,audio/Bl122_66283655.jpg,Bl122
498,7530.838966,7530.941966,1,225925168,225928258,3090,audio/Li145_225925168.jpg,Li145
499,2061.774469,2061.900469,1,61853234,61857014,3780,audio/Bl122_61853234.jpg,Bl122
500,798.565827,798.585827,2,23956974,23957574,600,audio/Or61_23956974.jpg,Or61
501,1958.490779,1958.513779,2,58754723,58755413,690,audio/Bl122_58754723.jpg,Bl122
502,505.871221,505.915221,1,15176136,15177456,1320,audio/Or61_15176136.jpg,Or61
503,9170.976804,9171.155804,1,275129304,275134674,5370,audio/Li145_275129304.jpg,Li145
504,6311.626473,6311.681473,1,189348794,189350444,1650,audio/Li145_189348794.jpg,Li145
505,1815.434379,1815.563379,1,54463031,54466901,3870,audio/Bl122_54463031.jpg,Bl122
506,2220.059183,2220.126183,2,66601775,66603785,2010,audio/Bl122_66601775.jpg,Bl122
507,2097.436961,2097.505961,1,62923108,62925178,2070,audio/Bl122_62923108.jpg,Bl122
508,3416.922291,3417.181651,1,102507668,102515449,7781,audio/Ti81_102507668.jpg,Ti81
509,15089.8379,15089.9919,1,452695137,452699757,4620,audio/Ti81_452695137.jpg,Ti81
510,2172.973183,2172.980183,2,65189195,65189405,210,audio/Bl122_65189195.jpg,Bl122
511,2197.738183,2197.780183,2,65932145,65933405,1260,audio/Bl122_65932145.jpg,Bl122
512,15237.571874,15237.634874,1,457127156,457129046,1890,audio/Ti81_457127156.jpg,Ti81
513,2145.327183,2145.381183,2,64359815,64361435,1620,audio/Bl122_64359815.jpg,Bl122
514,1952.559779,1952.583779,1,58576793,58577513,720,audio/Bl122_58576793.jpg,Bl122
515,3621.54853,3621.55153,2,108646455,108646545,90,audio/Li145_108646455.jpg,Li145
516,603.057417,603.074417,2,18091722,18092232,510,audio/Or61_18091722.jpg,Or61
517,550.515416,550.555416,1,16515462,16516662,1200,audio/Or61_16515462.jpg,Or61
518,2156.955183,2156.961183,2,64708655,64708835,180,audio/Bl122_64708655.jpg,Bl122
519,7568.252558,7568.254558,2,227047576,227047636,60,audio/Li145_227047576.jpg,Li145
520,2190.013183,2190.024183,2,65700395,65700725,330,audio/Bl122_65700395.jpg,Bl122
521,2227.417183,2227.454183,2,66822515,66823625,1110,audio/Bl122_66822515.jpg,Bl122
522,2038.277469,2038.288469,2,61148324,61148654,330,audio/Bl122_61148324.jpg,Bl122
523,7553.408715,7553.425715,1,226602261,226602771,510,audio/Li145_226602261.jpg,Li145
524,384.408161,384.418161,2,11532244,11532544,300,audio/Or61_11532244.jpg,Or61
525,15104.597256,15104.707256,1,453137917,453141217,3300,audio/Ti81_453137917.jpg,Ti81
526,15155.033257,15155.064257,1,454650997,454651927,930,audio/Ti81_454650997.jpg,Ti81
527,509.995221,510.054221,1,15299856,15301626,1770,audio/Or61_15299856.jpg,Or61
528,15061.207966,15061.406966,1,451836238,451842208,5970,audio/Ti81_451836238.jpg,Ti81
529,1976.488779,1976.517779,2,59294663,59295533,870,audio/Bl122_59294663.jpg,Bl122
530,2000.073779,2000.090779,2,60002213,60002723,510,audio/Bl122_60002213.jpg,Bl122
531,2053.930469,2054.001469,2,61617914,61620044,2130,audio/Bl122_61617914.jpg,Bl122
532,766.140271,766.171271,1,22984208,22985138,930,audio/Or61_22984208.jpg,Or61
533,495.896221,496.010221,1,14876886,14880306,3420,audio/Or61_14876886.jpg,Or61
534,528.042416,528.051416,2,15841272,15841542,270,audio/Or61_15841272.jpg,Or61
535,1760.208374,1760.367374,1,52806251,52811021,4770,audio/Bl122_52806251.jpg,Bl122
536,609.617417,609.644417,1,18288522,18289332,810,audio/Or61_18288522.jpg,Or61
537,15276.552439,15276.589439,1,458296573,458297683,1110,audio/Ti81_458296573.jpg,Ti81
538,2178.934183,2178.960183,2,65368025,65368805,780,audio/Bl122_65368025.jpg,Bl122
539,1794.003115,1794.027115,1,53820093,53820813,720,audio/Bl122_53820093.jpg,Bl122
540,1789.976115,1790.039115,1,53699283,53701173,1890,audio/Bl122_53699283.jpg,Bl122
541,15058.740142,15058.750003,1,451762204,451762500,296,audio/Ti81_451762204.jpg,Ti81
542,2193.587183,2193.590183,2,65807615,65807705,90,audio/Bl122_65807615.jpg,Bl122
543,2000.441779,2000.448779,2,60013253,60013463,210,audio/Bl122_60013253.jpg,Bl122
544,2050.034469,2050.073469,1,61501034,61502204,1170,audio/Bl122_61501034.jpg,Bl122
545,15043.615707,15043.621006,1,451308471,451308630,159,audio/Ti81_451308471.jpg,Ti81
546,1485.593018,1485.813018,1,44567790,44574390,6600,audio/Li145_44567790.jpg,Li145
547,389.092161,389.230161,1,11672764,11676904,4140,audio/Or61_11672764.jpg,Or61
548,1771.384657,1771.664657,1,53141539,53149939,8400,audio/Bl122_53141539.jpg,Bl122
549,2227.377183,2227.407183,2,66821315,66822215,900,audio/Bl122_66821315.jpg,Bl122
550,2046.297469,2046.445469,1,61388924,61393364,4440,audio/Bl122_61388924.jpg,Bl122
551,2175.047183,2175.402183,1,65251415,65262065,10650,audio/Bl122_65251415.jpg,Bl122
552,606.716417,606.778417,1,18201492,18203352,1860,audio/Or61_18201492.jpg,Or61
553,8096.898141,8096.922141,1,242906944,242907664,720,audio/Li145_242906944.jpg,Li145
554,1800.143115,1800.311115,1,54004293,54009333,5040,audio/Bl122_54004293.jpg,Bl122
555,5968.342227,5968.345227,2,179050266,179050356,90,audio/Li145_179050266.jpg,Li145
556,2216.172183,2216.196183,1,66485165,66485885,720,audio/Bl122_66485165.jpg,Bl122
557,15036.639102,15036.69877,1,451099173,451100963,1790,audio/Ti81_451099173.jpg,Ti81
558,2195.946183,2196.171183,1,65878385,65885135,6750,audio/Bl122_65878385.jpg,Bl122
559,727.265271,727.316271,1,21817958,21819488,1530,audio/Or61_21817958.jpg,Or61
560,2218.351183,2218.354183,2,66550535,66550625,90,audio/Bl122_66550535.jpg,Bl122
561,814.255882,814.311882,1,24427676,24429356,1680,audio/Or61_24427676.jpg,Or61
562,672.691078,672.724078,1,20180732,20181722,990,audio/Or61_20180732.jpg,Or61
563,2171.749183,2171.754183,1,65152475,65152625,150,audio/Bl122_65152475.jpg,Bl122
564,492.837221,492.869221,2,14785116,14786076,960,audio/Or61_14785116.jpg,Or61
565,1951.765779,1951.803779,2,58552973,58554113,1140,audio/Bl122_58552973.jpg,Bl122
566,545.937416,545.944416,2,16378122,16378332,210,audio/Or61_16378122.jpg,Or61
567,15158.991257,15159.201257,1,454769737,454776037,6300,audio/Ti81_454769737.jpg,Ti81
568,2004.530779,2004.537779,2,60135923,60136133,210,audio/Bl122_60135923.jpg,Bl122
569,551.356416,551.360416,2,16540692,16540812,120,audio/Or61_16540692.jpg,Or61
570,15285.882439,15285.905439,1,458576473,458577163,690,audio/Ti81_458576473.jpg,Ti81
571,5970.044227,5970.175227,1,179101326,179105256,3930,audio/Li145_179101326.jpg,Li145
572,810.788882,810.971882,1,24323666,24329156,5490,audio/Or61_24323666.jpg,Or61
573,2178.141183,2178.222183,1,65344235,65346665,2430,audio/Bl122_65344235.jpg,Bl122
574,1939.701779,1939.735779,2,58191053,58192073,1020,audio/Bl122_58191053.jpg,Bl122
575,1768.690657,1768.909657,1,53060719,53067289,6570,audio/Bl122_53060719.jpg,Bl122
576,1770.081657,1770.118657,1,53102449,53103559,1110,audio/Bl122_53102449.jpg,Bl122
577,1992.403779,1992.416779,1,59772113,59772503,390,audio/Bl122_59772113.jpg,Bl122
578,1992.481779,1992.496779,1,59774453,59774903,450,audio/Bl122_59774453.jpg,Bl122
579,602.559417,602.566417,2,18076782,18076992,210,audio/Or61_18076782.jpg,Or61
580,2050.251469,2050.282469,1,61507544,61508474,930,audio/Bl122_61507544.jpg,Bl122
581,1997.339779,1997.355779,1,59920193,59920673,480,audio/Bl122_59920193.jpg,Bl122
582,2220.919183,2220.945183,2,66627575,66628355,780,audio/Bl122_66627575.jpg,Bl122
583,15110.130554,15110.145218,1,453303916,453304356,440,audio/Ti81_453303916.jpg,Ti81
584,541.876416,541.903416,1,16256292,16257102,810,audio/Or61_16256292.jpg,Or61
585,2141.967183,2141.991183,1,64259015,64259735,720,audio/Bl122_64259015.jpg,Bl122
586,1945.095779,1945.108779,2,58352873,58353263,390,audio/Bl122_58352873.jpg,Bl122
587,564.366416,564.648416,1,16930992,16939452,8460,audio/Or61_16930992.jpg,Or61
588,2175.450183,2175.461183,2,65263505,65263835,330,audio/Bl122_65263505.jpg,Bl122
589,15241.998874,15242.249874,1,457259966,457267496,7530,audio/Ti81_457259966.jpg,Ti81
590,817.793882,817.848882,1,24533816,24535466,1650,audio/Or61_24533816.jpg,Or61
591,2169.201183,2169.207183,2,65076035,65076215,180,audio/Bl122_65076035.jpg,Bl122
592,2049.051469,2049.084469,2,61471544,61472534,990,audio/Bl122_61471544.jpg,Bl122
593,2228.282183,2228.292183,2,66848465,66848765,300,audio/Bl122_66848465.jpg,Bl122
594,1988.394779,1988.411779,2,59651843,59652353,510,audio/Bl122_59651843.jpg,Bl122
595,15122.346981,15122.654981,1,453670409,453679649,9240,audio/Ti81_453670409.jpg,Ti81
596,2222.272183,2222.279183,2,66668165,66668375,210,audio/Bl122_66668165.jpg,Bl122
597,2149.582183,2149.675183,1,64487465,64490255,2790,audio/Bl122_64487465.jpg,Bl122
598,745.070229,745.261229,1,22352106,22357836,5730,audio/Bl122_22352106.jpg,Bl122
599,736.035271,736.040271,2,22081058,22081208,150,audio/Or61_22081058.jpg,Or61
600,2139.699183,2139.710183,2,64190975,64191305,330,audio/Bl122_64190975.jpg,Bl122
601,548.675416,548.739416,1,16460262,16462182,1920,audio/Or61_16460262.jpg,Or61
602,3412.428906,3412.498792,1,102372867,102374963,2096,audio/Ti81_102372867.jpg,Ti81
603,501.315221,501.318221,2,15039456,15039546,90,audio/Or61_15039456.jpg,Or61
604,215.192857,215.404857,1,6455785,6462145,6360,audio/Or61_6455785.jpg,Or61
605,514.719221,514.923221,1,15441576,15447696,6120,audio/Or61_15441576.jpg,Or61
606,2169.404183,2169.416183,2,65082125,65082485,360,audio/Bl122_65082125.jpg,Bl122
607,15264.482358,15264.521358,1,457934470,457935640,1170,audio/Ti81_457934470.jpg,Ti81
608,811.507882,811.549882,1,24345236,24346496,1260,audio/Or61_24345236.jpg,Or61
609,493.114221,493.390221,1,14793426,14801706,8280,audio/Or61_14793426.jpg,Or61
610,1946.612779,1946.634779,2,58398383,58399043,660,audio/Bl122_58398383.jpg,Bl122
611,15304.090132,15304.10606,1,459122703,459123181,478,audio/Ti81_459122703.jpg,Ti81
612,1812.214013,1812.264013,1,54366420,54367920,1500,audio/Bl122_54366420.jpg,Bl122
613,9182.101829,9182.104829,1,275463054,275463144,90,audio/Li145_275463054.jpg,Li145
614,1984.669779,1984.715779,1,59540093,59541473,1380,audio/Bl122_59540093.jpg,Bl122
615,602.988417,603.013417,2,18089652,18090402,750,audio/Or61_18089652.jpg,Or61
616,2227.853183,2228.111183,1,66835595,66843335,7740,audio/Bl122_66835595.jpg,Bl122
617,1966.707779,1966.718779,2,59001233,59001563,330,audio/Bl122_59001233.jpg,Bl122
618,9172.510804,9172.527804,1,275175324,275175834,510,audio/Li145_275175324.jpg,Li145
619,2066.582469,2066.609469,2,61997474,61998284,810,audio/Bl122_61997474.jpg,Bl122
620,728.866271,728.889271,1,21865988,21866678,690,audio/Or61_21865988.jpg,Or61
621,746.271271,746.282271,1,22388138,22388468,330,audio/Or61_22388138.jpg,Or61
622,15327.955625,15327.998625,1,459838668,459839958,1290,audio/Ti81_459838668.jpg,Ti81
623,504.522221,504.539221,2,15135666,15136176,510,audio/Or61_15135666.jpg,Or61
624,15279.359439,15279.638439,1,458380783,458389153,8370,audio/Ti81_458380783.jpg,Ti81
625,765.344271,765.401271,1,22960328,22962038,1710,audio/Or61_22960328.jpg,Or61
626,501.842221,501.999221,1,15055266,15059976,4710,audio/Or61_15055266.jpg,Or61
627,672.287078,672.348078,1,20168612,20170442,1830,audio/Or61_20168612.jpg,Or61
628,2184.244183,2184.311183,1,65527325,65529335,2010,audio/Bl122_65527325.jpg,Bl122
629,1995.016779,1995.030779,2,59850503,59850923,420,audio/Bl122_59850503.jpg,Bl122
630,186.579971,186.584971,2,5597399,5597549,150,audio/Or61_5597399.jpg,Or61
631,2100.131961,2100.136961,2,63003958,63004108,150,audio/Bl122_63003958.jpg,Bl122
632,561.954416,562.121416,1,16858632,16863642,5010,audio/Or61_16858632.jpg,Or61
633,2006.258779,2006.292779,2,60187763,60188783,1020,audio/Bl122_60187763.jpg,Bl122
634,15068.116682,15068.153682,1,452043500,452044610,1110,audio/Ti81_452043500.jpg,Ti81
635,736.778271,736.794271,1,22103348,22103828,480,audio/Or61_22103348.jpg,Or61
636,315.393631,315.476631,1,9461808,9464298,2490,audio/Or61_9461808.jpg,Or61
637,2192.453183,2192.458183,2,65773595,65773745,150,audio/Bl122_65773595.jpg,Bl122
638,15165.241257,15165.289257,1,454957237,454958677,1440,audio/Ti81_454957237.jpg,Ti81
639,2043.889093,2043.904093,1,61316672,61317122,450,audio/Li145_61316672.jpg,Li145
640,2148.353183,2148.443183,2,64450595,64453295,2700,audio/Bl122_64450595.jpg,Bl122
641,773.185271,773.208271,1,23195558,23196248,690,audio/Or61_23195558.jpg,Or61
642,531.177416,531.208416,1,15935322,15936252,930,audio/Or61_15935322.jpg,Or61
643,5720.928018,5720.948018,1,171627840,171628440,600,audio/Li145_171627840.jpg,Li145
644,764.929271,765.146271,1,22947878,22954388,6510,audio/Or61_22947878.jpg,Or61
645,5887.984515,5888.038515,1,176639535,176641155,1620,audio/Li145_176639535.jpg,Li145
646,2159.142183,2159.166183,1,64774265,64774985,720,audio/Bl122_64774265.jpg,Bl122
647,9175.329719,9175.398719,1,275259891,275261961,2070,audio/Li145_275259891.jpg,Li145
648,2191.681183,2191.698183,2,65750435,65750945,510,audio/Bl122_65750435.jpg,Bl122
649,183.995971,184.005971,2,5519879,5520179,300,audio/Or61_5519879.jpg,Or61
650,755.557271,755.764271,1,22666718,22672928,6210,audio/Or61_22666718.jpg,Or61
651,2186.904183,2186.956183,2,65607125,65608685,1560,audio/Bl122_65607125.jpg,Bl122
652,9719.501773,9719.7108,1,291585053,291591324,6271,audio/Ti81_291585053.jpg,Ti81
653,399.260529,399.409529,1,11977815,11982285,4470,audio/Or61_11977815.jpg,Or61
654,2214.841183,2214.852183,2,66445235,66445565,330,audio/Bl122_66445235.jpg,Bl122
655,2161.512183,2161.527183,2,64845365,64845815,450,audio/Bl122_64845365.jpg,Bl122
656,15343.248971,15343.273971,1,460297469,460298219,750,audio/Ti81_460297469.jpg,Ti81
657,771.150271,771.158271,2,23134508,23134748,240,audio/Or61_23134508.jpg,Or61
658,15264.016358,15264.057358,1,457920490,457921720,1230,audio/Ti81_457920490.jpg,Ti81
659,2001.168779,2001.184779,2,60035063,60035543,480,audio/Bl122_60035063.jpg,Bl122
660,2048.508469,2048.552469,2,61455254,61456574,1320,audio/Bl122_61455254.jpg,Bl122
661,763.570271,763.647271,1,22907108,22909418,2310,audio/Or61_22907108.jpg,Or61
662,541.688416,541.725416,1,16250652,16251762,1110,audio/Or61_16250652.jpg,Or61
663,15281.956439,15281.998439,1,458458693,458459953,1260,audio/Ti81_458458693.jpg,Ti81
664,2154.511183,2154.703183,1,64635335,64641095,5760,audio/Bl122_64635335.jpg,Bl122
665,15328.105625,15328.126625,1,459843168,459843798,630,audio/Ti81_459843168.jpg,Ti81
666,8084.467803,8084.510803,1,242534034,242535324,1290,audio/Li145_242534034.jpg,Li145
667,8083.261803,8083.265803,2,242497854,242497974,120,audio/Li145_242497854.jpg,Li145
668,560.714416,560.744416,1,16821432,16822332,900,audio/Or61_16821432.jpg,Or61
669,2195.742183,2195.756183,2,65872265,65872685,420,audio/Bl122_65872265.jpg,Bl122
670,626.180417,626.255417,1,18785412,18787662,2250,audio/Or61_18785412.jpg,Or61
671,748.895271,749.010271,1,22466858,22470308,3450,audio/Or61_22466858.jpg,Or61
672,730.570271,730.595271,1,21917108,21917858,750,audio/Or61_21917108.jpg,Or61
673,15155.161257,15155.198257,1,454654837,454655947,1110,audio/Ti81_454654837.jpg,Ti81
674,1966.868779,1966.872779,2,59006063,59006183,120,audio/Bl122_59006063.jpg,Bl122
675,1767.643823,1767.807823,1,53029314,53034234,4920,audio/Bl122_53029314.jpg,Bl122
676,765.653271,765.727271,1,22969598,22971818,2220,audio/Or61_22969598.jpg,Or61
677,1799.080115,1799.086115,2,53972403,53972583,180,audio/Bl122_53972403.jpg,Bl122
678,2196.454183,2196.572183,1,65893625,65897165,3540,audio/Bl122_65893625.jpg,Bl122
679,498.320221,498.363221,1,14949606,14950896,1290,audio/Or61_14949606.jpg,Or61
680,2176.881183,2176.893183,2,65306435,65306795,360,audio/Bl122_65306435.jpg,Bl122
681,385.148462,385.369462,1,11554453,11561083,6630,audio/Bl122_11554453.jpg,Bl122
682,2137.950183,2138.315183,1,64138505,64149455,10950,audio/Bl122_64138505.jpg,Bl122
683,183.665971,183.694971,2,5509979,5510849,870,audio/Or61_5509979.jpg,Or61
684,498.234221,498.248221,2,14947026,14947446,420,audio/Or61_14947026.jpg,Or61
685,2144.534183,2144.559183,2,64336025,64336775,750,audio/Bl122_64336025.jpg,Bl122
686,560.825416,560.858416,1,16824762,16825752,990,audio/Or61_16824762.jpg,Or61
687,546.153416,546.168416,1,16384602,16385052,450,audio/Or61_16384602.jpg,Or61
688,2142.043183,2142.046183,2,64261295,64261385,90,audio/Bl122_64261295.jpg,Bl122
689,188.008971,188.155971,1,5640269,5644679,4410,audio/Or61_5640269.jpg,Or61
690,612.725417,612.756417,2,18381762,18382692,930,audio/Or61_18381762.jpg,Or61
691,793.314827,793.336827,2,23799444,23800104,660,audio/Or61_23799444.jpg,Or61
692,15129.006981,15129.038981,1,453870209,453871169,960,audio/Ti81_453870209.jpg,Ti81
693,748.494271,748.526271,1,22454828,22455788,960,audio/Or61_22454828.jpg,Or61
694,1814.846379,1814.855379,2,54445391,54445661,270,audio/Bl122_54445391.jpg,Bl122
695,481.984221,481.993221,2,14459526,14459796,270,audio/Or61_14459526.jpg,Or61
696,621.893417,622.153417,1,18656802,18664602,7800,audio/Or61_18656802.jpg,Or61
697,181.256971,181.264971,1,5437709,5437949,240,audio/Or61_5437709.jpg,Or61
698,620.481417,620.595417,1,18614442,18617862,3420,audio/Or61_18614442.jpg,Or61
699,183.138971,183.159971,1,5494169,5494799,630,audio/Or61_5494169.jpg,Or61
700,590.336088,590.382088,1,17710082,17711462,1380,audio/Or61_17710082.jpg,Or61
701,15305.446373,15305.603373,1,459163391,459168101,4710,audio/Ti81_459163391.jpg,Ti81
702,3412.275763,3412.365075,1,102368272,102370952,2680,audio/Ti81_102368272.jpg,Ti81
703,728.350271,728.372271,1,21850508,21851168,660,audio/Or61_21850508.jpg,Or61
704,2162.446183,2162.457183,2,64873385,64873715,330,audio/Bl122_64873385.jpg,Bl122
705,2132.070183,2132.080183,2,63962105,63962405,300,audio/Bl122_63962105.jpg,Bl122
706,725.239271,725.420271,1,21757178,21762608,5430,audio/Or61_21757178.jpg,Or61
707,2158.166183,2158.235183,2,64744985,64747055,2070,audio/Bl122_64744985.jpg,Bl122
708,3542.908388,3542.945475,1,106287251,106288364,1113,audio/Ti81_106287251.jpg,Ti81
709,794.087827,794.174827,1,23822634,23825244,2610,audio/Or61_23822634.jpg,Or61
710,2141.907183,2141.935183,2,64257215,64258055,840,audio/Bl122_64257215.jpg,Bl122
711,629.088417,629.126417,1,18872652,18873792,1140,audio/Or61_18872652.jpg,Or61
712,1991.039779,1991.048779,2,59731193,59731463,270,audio/Bl122_59731193.jpg,Bl122
713,603.740417,604.053417,1,18112212,18121602,9390,audio/Or61_18112212.jpg,Or61
714,2107.951377,2108.056377,1,63238541,63241691,3150,audio/Bl122_63238541.jpg,Bl122
715,15267.428358,15267.646358,1,458022850,458029390,6540,audio/Ti81_458022850.jpg,Ti81
716,2059.837469,2059.853469,1,61795124,61795604,480,audio/Bl122_61795124.jpg,Bl122
717,15043.589216,15043.606877,1,451307676,451308206,530,audio/Ti81_451307676.jpg,Ti81
718,767.379271,767.427271,1,23021378,23022818,1440,audio/Or61_23021378.jpg,Or61
719,1989.948779,1989.953779,2,59698463,59698613,150,audio/Bl122_59698463.jpg,Bl122
720,804.553882,804.556882,2,24136616,24136706,90,audio/Or61_24136616.jpg,Or61
721,2142.139183,2142.164183,2,64264175,64264925,750,audio/Bl122_64264175.jpg,Bl122
722,2193.875183,2194.000183,1,65816255,65820005,3750,audio/Bl122_65816255.jpg,Bl122
723,1944.441779,1944.447779,2,58333253,58333433,180,audio/Bl122_58333253.jpg,Bl122
724,278.1174,278.1854,1,8343521,8345562,2041,audio/Or61_8343521.jpg,Or61
725,1994.320779,1994.424779,1,59829623,59832743,3120,audio/Bl122_59829623.jpg,Bl122
726,15137.917989,15137.978989,1,454137539,454139369,1830,audio/Ti81_454137539.jpg,Ti81
727,2221.392183,2221.576183,1,66641765,66647285,5520,audio/Bl122_66641765.jpg,Bl122
728,2141.269183,2141.361183,1,64238075,64240835,2760,audio/Bl122_64238075.jpg,Bl122
729,527.720416,527.878416,1,15831612,15836352,4740,audio/Or61_15831612.jpg,Or61
730,616.968417,617.017417,1,18509052,18510522,1470,audio/Or61_18509052.jpg,Or61
731,15347.623971,15347.676971,1,460428719,460430309,1590,audio/Ti81_460428719.jpg,Ti81
732,15308.860373,15308.985373,1,459265811,459269561,3750,audio/Ti81_459265811.jpg,Ti81
733,15220.401443,15220.485443,1,456612043,456614563,2520,audio/Ti81_456612043.jpg,Ti81
734,487.978221,487.989221,2,14639346,14639676,330,audio/Or61_14639346.jpg,Or61
735,15177.697145,15177.829145,1,455330914,455334874,3960,audio/Ti81_455330914.jpg,Ti81
736,541.781416,541.810416,1,16253442,16254312,870,audio/Or61_16253442.jpg,Or61
737,3450.586098,3450.639332,1,103517582,103519179,1597,audio/Ti81_103517582.jpg,Ti81
738,2053.081469,2053.144469,1,61592444,61594334,1890,audio/Bl122_61592444.jpg,Bl122
739,2156.899183,2156.909183,2,64706975,64707275,300,audio/Bl122_64706975.jpg,Bl122
740,1947.780779,1947.799779,2,58433423,58433993,570,audio/Bl122_58433423.jpg,Bl122
741,8828.038654,8828.230654,1,264841159,264846919,5760,audio/Li145_264841159.jpg,Li145
742,1791.488115,1791.499115,2,53744643,53744973,330,audio/Bl122_53744643.jpg,Bl122
743,604.171417,604.341417,1,18125142,18130242,5100,audio/Or61_18125142.jpg,Or61
744,2034.798469,2034.966469,1,61043954,61048994,5040,audio/Bl122_61043954.jpg,Bl122
745,752.757271,752.960271,1,22582718,22588808,6090,audio/Or61_22582718.jpg,Or61
746,14945.732822,14945.781767,1,448371984,448373453,1469,audio/Ti81_448371984.jpg,Ti81
747,766.286271,766.344271,1,22988588,22990328,1740,audio/Or61_22988588.jpg,Or61
748,610.039417,610.059417,1,18301182,18301782,600,audio/Or61_18301182.jpg,Or61
749,441.924265,441.943265,1,13257727,13258297,570,audio/Or61_13257727.jpg,Or61
750,565.347416,565.354416,2,16960422,16960632,210,audio/Or61_16960422.jpg,Or61
751,14762.481735,14762.651214,1,442874452,442879536,5084,audio/Ti81_442874452.jpg,Ti81
752,545.708416,545.737416,1,16371252,16372122,870,audio/Or61_16371252.jpg,Or61
753,535.890416,535.960416,1,16076712,16078812,2100,audio/Or61_16076712.jpg,Or61
754,544.391416,544.410416,1,16331742,16332312,570,audio/Or61_16331742.jpg,Or61
755,712.512271,712.559271,1,21375368,21376778,1410,audio/Or61_21375368.jpg,Or61
756,738.022271,738.221271,1,22140668,22146638,5970,audio/Or61_22140668.jpg,Or61
757,1964.029779,1964.057779,2,58920893,58921733,840,audio/Bl122_58920893.jpg,Bl122
758,1938.624779,1938.667779,2,58158743,58160033,1290,audio/Bl122_58158743.jpg,Bl122
759,517.997221,518.188221,1,15539916,15545646,5730,audio/Or61_15539916.jpg,Or61
760,300.119938,300.122938,2,9003598,9003688,90,audio/Or61_9003598.jpg,Or61
761,1767.101823,1767.338823,1,53013054,53020164,7110,audio/Bl122_53013054.jpg,Bl122
762,1958.519779,1958.554779,2,58755593,58756643,1050,audio/Bl122_58755593.jpg,Bl122
763,389.296161,389.374161,1,11678884,11681224,2340,audio/Or61_11678884.jpg,Or61
764,1789.594115,1789.599115,2,53687823,53687973,150,audio/Bl122_53687823.jpg,Bl122
765,2171.398183,2171.408183,2,65141945,65142245,300,audio/Bl122_65141945.jpg,Bl122
766,15215.807217,15215.84558,1,456474216,456475367,1151,audio/Ti81_456474216.jpg,Ti81
767,2216.480183,2216.547183,1,66494405,66496415,2010,audio/Bl122_66494405.jpg,Bl122
768,15252.489074,15252.589074,1,457574672,457577672,3000,audio/Ti81_457574672.jpg,Ti81
769,1985.615779,1985.830779,1,59568473,59574923,6450,audio/Bl122_59568473.jpg,Bl122
770,2062.207469,2062.367469,1,61866224,61871024,4800,audio/Bl122_61866224.jpg,Bl122
771,2013.771959,2013.775959,2,60413158,60413278,120,audio/Bl122_60413158.jpg,Bl122
772,3446.413128,3446.470147,1,103392393,103394104,1711,audio/Ti81_103392393.jpg,Ti81
773,1773.704974,1773.950974,1,53211149,53218529,7380,audio/Bl122_53211149.jpg,Bl122
774,3447.964746,3447.979884,1,103438942,103439396,454,audio/Ti81_103438942.jpg,Ti81
775,2175.797183,2176.053183,1,65273915,65281595,7680,audio/Bl122_65273915.jpg,Bl122
776,15328.833625,15328.875625,1,459865008,459866268,1260,audio/Ti81_459865008.jpg,Ti81
777,718.136271,718.162271,1,21544088,21544868,780,audio/Or61_21544088.jpg,Or61
778,2181.788183,2181.803183,2,65453645,65454095,450,audio/Bl122_65453645.jpg,Bl122
779,15339.452971,15339.826971,1,460183589,460194809,11220,audio/Ti81_460183589.jpg,Ti81
780,8742.926692,8742.930692,1,262287800,262287920,120,audio/Li145_262287800.jpg,Li145
781,490.483221,490.697221,1,14714496,14720916,6420,audio/Or61_14714496.jpg,Or61
782,482.336221,482.344221,1,14470086,14470326,240,audio/Or61_14470086.jpg,Or61
783,811.733882,811.756882,1,24352016,24352706,690,audio/Or61_24352016.jpg,Or61
784,473.651221,473.656221,2,14209536,14209686,150,audio/Or61_14209536.jpg,Or61
785,762.538271,762.548271,1,22876148,22876448,300,audio/Or61_22876148.jpg,Or61
786,1782.045323,1782.052323,2,53461359,53461569,210,audio/Bl122_53461359.jpg,Bl122
787,2001.116779,2001.123779,2,60033503,60033713,210,audio/Bl122_60033503.jpg,Bl122
788,2205.913183,2206.183183,1,66177395,66185495,8100,audio/Bl122_66177395.jpg,Bl122
789,705.706271,705.737271,1,21171188,21172118,930,audio/Or61_21171188.jpg,Or61
790,15037.415794,15037.687769,1,451122473,451130633,8160,audio/Ti81_451122473.jpg,Ti81
791,1785.61743,1785.69843,1,53568522,53570952,2430,audio/Bl122_53568522.jpg,Bl122
792,543.694416,543.773416,1,16310832,16313202,2370,audio/Or61_16310832.jpg,Or61
793,2092.293961,2092.482961,1,62768818,62774488,5670,audio/Bl122_62768818.jpg,Bl122
794,15042.148608,15042.162737,1,451264458,451264882,424,audio/Ti81_451264458.jpg,Ti81
795,507.665221,507.687221,1,15229956,15230616,660,audio/Or61_15229956.jpg,Or61
796,711.607271,711.760271,1,21348218,21352808,4590,audio/Or61_21348218.jpg,Or61
797,6954.727285,6954.818285,1,208641818,208644548,2730,audio/Li145_208641818.jpg,Li145
798,2207.625183,2207.639183,2,66228755,66229175,420,audio/Bl122_66228755.jpg,Bl122
799,561.688416,561.701416,1,16850652,16851042,390,audio/Or61_16850652.jpg,Or61
800,1974.258779,1974.314779,1,59227763,59229443,1680,audio/Bl122_59227763.jpg,Bl122
801,14941.523017,14941.683729,1,448245690,448250511,4821,audio/Ti81_448245690.jpg,Ti81
802,2180.342183,2180.401183,1,65410265,65412035,1770,audio/Bl122_65410265.jpg,Bl122
803,719.203271,719.236271,1,21576098,21577088,990,audio/Or61_21576098.jpg,Or61
804,2145.645183,2145.658183,2,64369355,64369745,390,audio/Bl122_64369355.jpg,Bl122
805,7550.583715,7550.638715,1,226517511,226519161,1650,audio/Li145_226517511.jpg,Li145
806,3545.088727,3545.114713,1,106352661,106353441,780,audio/Ti81_106352661.jpg,Ti81
807,1962.712779,1962.720779,2,58881383,58881623,240,audio/Bl122_58881383.jpg,Bl122
808,3545.133887,3545.155585,1,106354016,106354667,651,audio/Ti81_106354016.jpg,Ti81
809,673.964078,674.223078,1,20218922,20226692,7770,audio/Or61_20218922.jpg,Or61
810,2056.577469,2056.650469,1,61697324,61699514,2190,audio/Bl122_61697324.jpg,Bl122
811,1788.998115,1789.012115,1,53669943,53670363,420,audio/Bl122_53669943.jpg,Bl122
812,1774.412974,1774.506974,1,53232389,53235209,2820,audio/Bl122_53232389.jpg,Bl122
813,1939.130779,1939.136779,2,58173923,58174103,180,audio/Bl122_58173923.jpg,Bl122
814,565.780416,565.786416,2,16973412,16973592,180,audio/Or61_16973412.jpg,Or61
815,1992.896779,1992.902779,2,59786903,59787083,180,audio/Bl122_59786903.jpg,Bl122
816,2208.429183,2208.465183,2,66252875,66253955,1080,audio/Bl122_66252875.jpg,Bl122
817,7569.599558,7569.610558,1,227087986,227088316,330,audio/Li145_227087986.jpg,Li145
818,550.298416,550.327416,1,16508952,16509822,870,audio/Or61_16508952.jpg,Or61
819,15209.50558,15209.89258,1,456285167,456296777,11610,audio/Ti81_456285167.jpg,Ti81
820,2083.903961,2083.914961,2,62517118,62517448,330,audio/Bl122_62517118.jpg,Bl122
821,2139.463183,2139.472183,2,64183895,64184165,270,audio/Bl122_64183895.jpg,Bl122
822,483.893221,483.969221,1,14516796,14519076,2280,audio/Or61_14516796.jpg,Or61
823,491.852221,491.947221,1,14755566,14758416,2850,audio/Or61_14755566.jpg,Or61
824,714.011271,714.081271,1,21420338,21422438,2100,audio/Or61_21420338.jpg,Or61
825,15148.318716,15148.447716,1,454449561,454453431,3870,audio/Ti81_454449561.jpg,Ti81
826,501.684221,501.701221,2,15050526,15051036,510,audio/Or61_15050526.jpg,Or61
827,2177.146183,2177.363183,1,65314385,65320895,6510,audio/Bl122_65314385.jpg,Bl122
828,2133.540183,2133.577183,1,64006205,64007315,1110,audio/Bl122_64006205.jpg,Bl122
829,3415.041932,3415.076244,1,102451257,102452287,1030,audio/Ti81_102451257.jpg,Ti81
830,486.568221,486.581221,2,14597046,14597436,390,audio/Or61_14597046.jpg,Or61
831,532.381416,532.386416,2,15971442,15971592,150,audio/Or61_15971442.jpg,Or61
832,722.843271,722.861271,1,21685298,21685838,540,audio/Or61_21685298.jpg,Or61
833,2072.509469,2072.569469,2,62175284,62177084,1800,audio/Bl122_62175284.jpg,Bl122
834,746.669271,746.731271,1,22400078,22401938,1860,audio/Or61_22400078.jpg,Or61
835,2151.605183,2151.658183,1,64548155,64549745,1590,audio/Bl122_64548155.jpg,Bl122
836,2199.948183,2199.958183,2,65998445,65998745,300,audio/Bl122_65998445.jpg,Bl122
837,2038.263469,2038.266469,2,61147904,61147994,90,audio/Bl122_61147904.jpg,Bl122
838,556.544416,556.710416,1,16696332,16701312,4980,audio/Or61_16696332.jpg,Or61
839,15333.77701,15333.86101,1,460013310,460015830,2520,audio/Ti81_460013310.jpg,Ti81
840,1949.619779,1949.626779,2,58488593,58488803,210,audio/Bl122_58488593.jpg,Bl122
841,1971.028779,1971.034779,2,59130863,59131043,180,audio/Bl122_59130863.jpg,Bl122
842,755.051271,755.220271,1,22651538,22656608,5070,audio/Or61_22651538.jpg,Or61
843,2160.500183,2160.721183,1,64815005,64821635,6630,audio/Bl122_64815005.jpg,Bl122
844,14765.628934,14765.794061,1,442968868,442973821,4953,audio/Ti81_442968868.jpg,Ti81
845,2144.378183,2144.400183,2,64331345,64332005,660,audio/Bl122_64331345.jpg,Bl122
846,530.287416,530.291416,2,15908622,15908742,120,audio/Or61_15908622.jpg,Or61
847,3409.798724,3409.828747,1,102293961,102294862,901,audio/Ti81_102293961.jpg,Ti81
848,14940.608193,14940.628629,1,448218245,448218858,613,audio/Ti81_448218245.jpg,Ti81
849,3427.078452,3427.283947,1,102812353,102818518,6165,audio/Ti81_102812353.jpg,Ti81
850,2196.377183,2196.451183,2,65891315,65893535,2220,audio/Bl122_65891315.jpg,Bl122
851,1991.958779,1991.966779,2,59758763,59759003,240,audio/Bl122_59758763.jpg,Bl122
852,2059.944469,2059.974469,1,61798334,61799234,900,audio/Bl122_61798334.jpg,Bl122
853,2166.640183,2166.672183,2,64999205,65000165,960,audio/Bl122_64999205.jpg,Bl122
854,470.236221,470.271221,1,14107086,14108136,1050,audio/Or61_14107086.jpg,Or61
855,2192.905183,2192.937183,2,65787155,65788115,960,audio/Bl122_65787155.jpg,Bl122
856,15034.417639,15034.498122,1,451032529,451034943,2414,audio/Ti81_451032529.jpg,Ti81
857,620.286417,620.296417,2,18608592,18608892,300,audio/Or61_18608592.jpg,Or61
858,2171.052183,2171.204183,1,65131565,65136125,4560,audio/Bl122_65131565.jpg,Bl122
859,7551.920715,7552.070715,1,226557621,226562121,4500,audio/Li145_226557621.jpg,Li145
860,183.084971,183.131971,1,5492549,5493959,1410,audio/Or61_5492549.jpg,Or61
861,2119.058183,2119.062183,2,63571745,63571865,120,audio/Bl122_63571745.jpg,Bl122
862,1988.839779,1988.854779,2,59665193,59665643,450,audio/Bl122_59665193.jpg,Bl122
863,716.104271,716.108271,1,21483128,21483248,120,audio/Or61_21483128.jpg,Or61
864,1979.585779,1979.590779,2,59387573,59387723,150,audio/Bl122_59387573.jpg,Bl122
865,15021.879618,15021.897658,1,450656388,450656929,541,audio/Ti81_450656388.jpg,Ti81
866,715.951271,716.101271,1,21478538,21483038,4500,audio/Or61_21478538.jpg,Or61
867,7553.246715,7553.252715,1,226597401,226597581,180,audio/Li145_226597401.jpg,Li145
868,2046.291469,2046.295469,2,61388744,61388864,120,audio/Bl122_61388744.jpg,Bl122
869,748.675271,748.694271,1,22460258,22460828,570,audio/Or61_22460258.jpg,Or61
870,2040.586815,2040.589815,2,61217604,61217694,90,audio/Li145_61217604.jpg,Li145
871,1770.503657,1770.515657,2,53115109,53115469,360,audio/Bl122_53115109.jpg,Bl122
872,2133.942183,2134.155183,1,64018265,64024655,6390,audio/Bl122_64018265.jpg,Bl122
873,2139.387183,2139.410183,1,64181615,64182305,690,audio/Bl122_64181615.jpg,Bl122
874,2158.960183,2158.964183,2,64768805,64768925,120,audio/Bl122_64768805.jpg,Bl122
875,5.148509,5.180509,1,154455,155415,960,audio/Or61_154455.jpg,Or61
876,15035.946929,15035.961169,1,451078407,451078835,428,audio/Ti81_451078407.jpg,Ti81
877,181.446971,181.464971,1,5443409,5443949,540,audio/Or61_5443409.jpg,Or61
878,3466.049298,3466.169643,1,103981478,103985089,3611,audio/Ti81_103981478.jpg,Ti81
879,15034.773881,15034.828755,1,451043216,451044862,1646,audio/Ti81_451043216.jpg,Ti81
880,479.011221,479.085221,1,14370336,14372556,2220,audio/Or61_14370336.jpg,Or61
881,2144.431183,2144.450183,2,64332935,64333505,570,audio/Bl122_64332935.jpg,Bl122
882,2059.976469,2059.990469,1,61799294,61799714,420,audio/Bl122_61799294.jpg,Bl122
883,715.484271,715.488271,2,21464528,21464648,120,audio/Or61_21464528.jpg,Or61
884,1789.781115,1789.789115,2,53693433,53693673,240,audio/Bl122_53693433.jpg,Bl122
885,2100.773961,2100.847961,2,63023218,63025438,2220,audio/Bl122_63023218.jpg,Bl122
886,2207.382183,2207.440183,1,66221465,66223205,1740,audio/Bl122_66221465.jpg,Bl122
887,527.352416,527.370416,1,15820572,15821112,540,audio/Or61_15820572.jpg,Or61
888,2032.135469,2032.211469,1,60964064,60966344,2280,audio/Bl122_60964064.jpg,Bl122
889,2107.336377,2107.347377,1,63220091,63220421,330,audio/Bl122_63220091.jpg,Bl122
890,2095.012961,2095.025961,1,62850388,62850778,390,audio/Bl122_62850388.jpg,Bl122
891,2049.622469,2049.711469,2,61488674,61491344,2670,audio/Bl122_61488674.jpg,Bl122
892,1749.799622,1750.008622,1,52493988,52500258,6270,audio/Bl122_52493988.jpg,Bl122
893,8829.059654,8829.154654,1,264871789,264874639,2850,audio/Li145_264871789.jpg,Li145
894,403.625692,403.628692,2,12108770,12108860,90,audio/Or61_12108770.jpg,Or61
895,15052.326966,15052.350966,1,451569808,451570528,720,audio/Ti81_451569808.jpg,Ti81
896,15249.478074,15249.512074,1,457484342,457485362,1020,audio/Ti81_457484342.jpg,Ti81
897,2109.504082,2109.762082,1,63285122,63292862,7740,audio/Bl122_63285122.jpg,Bl122
898,1789.033115,1789.043115,1,53670993,53671293,300,audio/Bl122_53670993.jpg,Bl122
899,710.419271,710.489271,1,21312578,21314678,2100,audio/Or61_21312578.jpg,Or61
900,2228.544183,2228.550183,2,66856325,66856505,180,audio/Bl122_66856325.jpg,Bl122
901,1485.522018,1485.527018,1,44565660,44565810,150,audio/Li145_44565660.jpg,Li145
902,2107.605377,2107.624377,1,63228161,63228731,570,audio/Bl122_63228161.jpg,Bl122
903,482.507221,482.626221,1,14475216,14478786,3570,audio/Or61_14475216.jpg,Or61
904,15244.082874,15244.125874,1,457322486,457323776,1290,audio/Ti81_457322486.jpg,Ti81
905,509.812221,509.912221,1,15294366,15297366,3000,audio/Or61_15294366.jpg,Or61
906,542.951416,543.052416,1,16288542,16291572,3030,audio/Or61_16288542.jpg,Or61
907,481.162221,481.168221,2,14434866,14435046,180,audio/Or61_14434866.jpg,Or61
908,717.438271,717.473271,1,21523148,21524198,1050,audio/Or61_21523148.jpg,Or61
909,15116.384981,15116.448981,1,453491549,453493469,1920,audio/Ti81_453491549.jpg,Ti81
910,15283.721439,15284.148439,1,458511643,458524453,12810,audio/Ti81_458511643.jpg,Ti81
911,2066.958469,2067.005469,1,62008754,62010164,1410,audio/Bl122_62008754.jpg,Bl122
912,1987.202779,1987.219779,2,59616083,59616593,510,audio/Bl122_59616083.jpg,Bl122
913,554.907416,554.920416,1,16647222,16647612,390,audio/Or61_16647222.jpg,Or61
914,2155.836183,2155.845183,2,64675085,64675355,270,audio/Bl122_64675085.jpg,Bl122
915,2119.892183,2119.934183,1,63596765,63598025,1260,audio/Bl122_63596765.jpg,Bl122
916,631.366417,631.382417,1,18940992,18941472,480,audio/Or61_18940992.jpg,Or61
917,1973.470779,1973.736779,1,59204123,59212103,7980,audio/Bl122_59204123.jpg,Bl122
918,743.562271,743.568271,2,22306868,22307048,180,audio/Or61_22306868.jpg,Or61
919,473.627221,473.646221,1,14208816,14209386,570,audio/Or61_14208816.jpg,Or61
920,729.205271,729.220271,1,21876158,21876608,450,audio/Or61_21876158.jpg,Or61
921,541.199416,541.204416,2,16235982,16236132,150,audio/Or61_16235982.jpg,Or61
922,14773.569056,14773.738346,1,443207071,443212150,5079,audio/Ti81_443207071.jpg,Ti81
923,2049.993469,2050.008469,1,61499804,61500254,450,audio/Bl122_61499804.jpg,Bl122
924,473.473221,473.477221,2,14204196,14204316,120,audio/Or61_14204196.jpg,Or61
925,2101.109961,2101.120961,2,63033298,63033628,330,audio/Bl122_63033298.jpg,Bl122
926,494.094221,494.121221,2,14822826,14823636,810,audio/Or61_14822826.jpg,Or61
927,866.744602,866.799602,1,26002338,26003988,1650,audio/Bl122_26002338.jpg,Bl122
928,15226.263443,15226.323443,1,456787903,456789703,1800,audio/Ti81_456787903.jpg,Ti81
929,470.697221,470.702221,2,14120916,14121066,150,audio/Or61_14120916.jpg,Or61
930,483.765221,483.851221,1,14512956,14515536,2580,audio/Or61_14512956.jpg,Or61
931,924.102903,924.374373,1,27723087,27731231,8144,audio/Ti81_27723087.jpg,Ti81
932,14897.406098,14897.704689,1,446922182,446931140,8958,audio/Ti81_446922182.jpg,Ti81
933,3547.556178,3547.580903,1,106426685,106427427,742,audio/Ti81_106426685.jpg,Ti81
934,709.940271,710.050271,1,21298208,21301508,3300,audio/Or61_21298208.jpg,Or61
935,527.373416,527.397416,1,15821202,15821922,720,audio/Or61_15821202.jpg,Or61
936,3465.440256,3465.580785,1,103963207,103967423,4216,audio/Ti81_103963207.jpg,Ti81
937,2215.652183,2215.660183,2,66469565,66469805,240,audio/Bl122_66469565.jpg,Bl122
938,15250.193074,15250.396074,1,457505792,457511882,6090,audio/Ti81_457505792.jpg,Ti81
939,2156.968183,2156.988183,2,64709045,64709645,600,audio/Bl122_64709045.jpg,Bl122
940,471.686221,471.701221,1,14150586,14151036,450,audio/Or61_14150586.jpg,Or61
941,388.845161,388.953161,1,11665354,11668594,3240,audio/Or61_11665354.jpg,Or61
942,1949.075779,1949.084779,2,58472273,58472543,270,audio/Bl122_58472273.jpg,Bl122
943,787.639827,787.686827,1,23629194,23630604,1410,audio/Or61_23629194.jpg,Or61
944,1944.540779,1944.573779,1,58336223,58337213,990,audio/Bl122_58336223.jpg,Bl122
945,2196.365183,2196.375183,2,65890955,65891255,300,audio/Bl122_65890955.jpg,Bl122
946,15093.276823,15093.410823,1,452798304,452802324,4020,audio/Ti81_452798304.jpg,Ti81
947,2038.129469,2038.137469,2,61143884,61144124,240,audio/Bl122_61143884.jpg,Bl122
948,2230.929183,2231.143183,1,66927875,66934295,6420,audio/Bl122_66927875.jpg,Bl122
949,1787.617115,1787.706115,2,53628513,53631183,2670,audio/Bl122_53628513.jpg,Bl122
950,15025.740309,15025.855169,1,450772209,450775655,3446,audio/Ti81_450772209.jpg,Ti81
951,2085.965961,2086.062961,1,62578978,62581888,2910,audio/Bl122_62578978.jpg,Bl122
952,441.068265,441.393265,1,13232047,13241797,9750,audio/Or61_13232047.jpg,Or61
953,1770.883657,1770.893657,1,53126509,53126809,300,audio/Bl122_53126509.jpg,Bl122
954,2158.554183,2158.632183,1,64756625,64758965,2340,audio/Bl122_64756625.jpg,Bl122
955,2228.586183,2228.590183,2,66857585,66857705,120,audio/Bl122_66857585.jpg,Bl122
956,804.393882,804.405882,1,24131816,24132176,360,audio/Or61_24131816.jpg,Or61
957,672.987078,673.048078,1,20189612,20191442,1830,audio/Or61_20189612.jpg,Or61
958,2209.761183,2210.053183,1,66292835,66301595,8760,audio/Bl122_66292835.jpg,Bl122
959,171.961297,172.217297,1,5158838,5166518,7680,audio/Or61_5158838.jpg,Or61
960,746.804271,746.811271,1,22404128,22404338,210,audio/Or61_22404128.jpg,Or61
961,2212.578183,2212.620183,2,66377345,66378605,1260,audio/Bl122_66377345.jpg,Bl122
962,15129.211981,15129.515981,1,453876359,453885479,9120,audio/Ti81_453876359.jpg,Ti81
963,510.567221,510.611221,1,15317016,15318336,1320,audio/Or61_15317016.jpg,Or61
964,15221.490443,15221.745443,1,456644713,456652363,7650,audio/Ti81_456644713.jpg,Ti81
965,2146.866183,2146.871183,2,64405985,64406135,150,audio/Bl122_64405985.jpg,Bl122
966,2199.963183,2199.982183,2,65998895,65999465,570,audio/Bl122_65998895.jpg,Bl122
967,2134.197183,2134.201183,2,64025915,64026035,120,audio/Bl122_64025915.jpg,Bl122
968,405.854692,405.999692,1,12175640,12179990,4350,audio/Or61_12175640.jpg,Or61
969,547.134416,547.143416,2,16414032,16414302,270,audio/Or61_16414032.jpg,Or61
970,14943.422299,14943.618837,1,448302668,448308565,5897,audio/Ti81_448302668.jpg,Ti81
971,721.012271,721.083271,1,21630368,21632498,2130,audio/Or61_21630368.jpg,Or61
972,570.517517,570.600517,1,17115525,17118015,2490,audio/Or61_17115525.jpg,Or61
973,1951.322779,1951.326779,2,58539683,58539803,120,audio/Bl122_58539683.jpg,Bl122
974,2223.864183,2223.875183,2,66715925,66716255,330,audio/Bl122_66715925.jpg,Bl122
975,14905.894584,14906.189266,1,447176837,447185677,8840,audio/Ti81_447176837.jpg,Ti81
976,527.595416,527.603416,1,15827862,15828102,240,audio/Or61_15827862.jpg,Or61
977,2038.356469,2038.359469,2,61150694,61150784,90,audio/Bl122_61150694.jpg,Bl122
978,479.755221,479.896221,1,14392656,14396886,4230,audio/Or61_14392656.jpg,Or61
979,1954.932779,1954.936779,2,58647983,58648103,120,audio/Bl122_58647983.jpg,Bl122
980,397.171529,397.179529,2,11915145,11915385,240,audio/Or61_11915145.jpg,Or61
981,849.116919,849.280469,1,25473507,25478414,4907,audio/Ti81_25473507.jpg,Ti81
982,2164.585183,2165.030183,1,64937555,64950905,13350,audio/Bl122_64937555.jpg,Bl122
983,15127.373981,15127.463981,1,453821219,453823919,2700,audio/Ti81_453821219.jpg,Ti81
984,791.860827,791.931827,1,23755824,23757954,2130,audio/Or61_23755824.jpg,Or61
985,2211.052183,2211.070183,2,66331565,66332105,540,audio/Bl122_66331565.jpg,Bl122
986,2219.909183,2219.933183,2,66597275,66597995,720,audio/Bl122_66597275.jpg,Bl122
987,15299.841664,15299.978664,1,458995249,458999359,4110,audio/Ti81_458995249.jpg,Ti81
988,1948.166779,1948.178779,2,58445003,58445363,360,audio/Bl122_58445003.jpg,Bl122
989,531.878416,531.882416,2,15956352,15956472,120,audio/Or61_15956352.jpg,Or61
990,2075.631823,2075.759823,1,62268954,62272794,3840,audio/Bl122_62268954.jpg,Bl122
991,607.116417,607.189417,2,18213492,18215682,2190,audio/Or61_18213492.jpg,Or61
992,15207.96858,15208.26758,1,456239057,456248027,8970,audio/Ti81_456239057.jpg,Ti81
993,8889.112716,8889.137716,1,266673381,266674131,750,audio/Li145_266673381.jpg,Li145
994,2005.458779,2005.462779,2,60163763,60163883,120,audio/Bl122_60163763.jpg,Bl122
995,14942.622017,14942.665159,1,448278660,448279954,1294,audio/Ti81_448278660.jpg,Ti81
996,1982.661779,1982.691779,2,59479853,59480753,900,audio/Bl122_59479853.jpg,Bl122
997,2224.146183,2224.272183,1,66724385,66728165,3780,audio/Bl122_66724385.jpg,Bl122
998,1947.224779,1947.238779,2,58416743,58417163,420,audio/Bl122_58416743.jpg,Bl122
999,1975.468779,1975.476779,2,59264063,59264303,240,audio/Bl122_59264063.jpg,Bl122
1000,15282.094439,15282.496439,1,458462833,458474893,12060,audio/Ti81_458462833.jpg,Ti81
1001,2226.904183,2226.907183,2,66807125,66807215,90,audio/Bl122_66807125.jpg,Bl122
1002,2086.574961,2086.687961,1,62597248,62600638,3390,audio/Bl122_62597248.jpg,Bl122
1003,507.875221,508.256221,1,15236256,15247686,11430,audio/Or61_15236256.jpg,Or61
1004,2220.592183,2220.615183,2,66617765,66618455,690,audio/Bl122_66617765.jpg,Bl122
1005,787.408827,787.511827,1,23622264,23625354,3090,audio/Or61_23622264.jpg,Or61
1006,2069.810469,2069.822469,2,62094314,62094674,360,audio/Bl122_62094314.jpg,Bl122
1007,2162.613183,2162.812183,1,64878395,64884365,5970,audio/Bl122_64878395.jpg,Bl122
1008,2049.600469,2049.612469,2,61488014,61488374,360,audio/Bl122_61488014.jpg,Bl122
1009,7492.600261,7492.652261,1,224778007,224779567,1560,audio/Li145_224778007.jpg,Li145
1010,15282.637439,15282.861052,1,458479123,458485831,6708,audio/Ti81_458479123.jpg,Ti81
1011,479.322221,479.447221,1,14379666,14383416,3750,audio/Or61_14379666.jpg,Or61
1012,503.057221,503.060221,2,15091716,15091806,90,audio/Or61_15091716.jpg,Or61
1013,1486.466018,1486.481018,1,44593980,44594430,450,audio/Li145_44593980.jpg,Li145
1014,2178.899183,2178.927183,2,65366975,65367815,840,audio/Bl122_65366975.jpg,Bl122
1015,2185.826183,2185.927183,1,65574785,65577815,3030,audio/Bl122_65574785.jpg,Bl122
1016,657.646685,657.658685,1,19729400,19729760,360,audio/Li145_19729400.jpg,Li145
1017,491.760221,491.847221,2,14752806,14755416,2610,audio/Or61_14752806.jpg,Or61
1018,537.010416,537.022416,1,16110312,16110672,360,audio/Or61_16110312.jpg,Or61
1019,396.077529,396.101529,1,11882325,11883045,720,audio/Or61_11882325.jpg,Or61
1020,15314.150428,15314.283428,1,459424512,459428502,3990,audio/Ti81_459424512.jpg,Ti81
1021,813.746882,814.005882,1,24412406,24420176,7770,audio/Or61_24412406.jpg,Or61
1022,5707.276085,5707.338085,1,171218282,171220142,1860,audio/Li145_171218282.jpg,Li145
1023,1941.368779,1941.399779,1,58241063,58241993,930,audio/Bl122_58241063.jpg,Bl122
1024,2182.537183,2182.569183,1,65476115,65477075,960,audio/Bl122_65476115.jpg,Bl122
1025,485.577221,485.823221,1,14567316,14574696,7380,audio/Or61_14567316.jpg,Or61
1026,619.488417,619.574417,1,18584652,18587232,2580,audio/Or61_18584652.jpg,Or61
1027,2039.168815,2039.185815,1,61175064,61175574,510,audio/Li145_61175064.jpg,Li145
1028,626.705417,626.714417,2,18801162,18801432,270,audio/Or61_18801162.jpg,Or61
1029,792.478827,792.501827,1,23774364,23775054,690,audio/Or61_23774364.jpg,Or61
1030,729.188271,729.202271,1,21875648,21876068,420,audio/Or61_21875648.jpg,Or61
1031,736.920271,736.926271,2,22107608,22107788,180,audio/Or61_22107608.jpg,Or61
1032,1954.191779,1954.195779,2,58625753,58625873,120,audio/Bl122_58625753.jpg,Bl122
1033,2035.165469,2035.199469,2,61054964,61055984,1020,audio/Bl122_61054964.jpg,Bl122
1034,2200.428183,2200.431183,2,66012845,66012935,90,audio/Bl122_66012845.jpg,Bl122
1035,2149.551183,2149.560183,2,64486535,64486805,270,audio/Bl122_64486535.jpg,Bl122
1036,817.778882,817.782882,2,24533366,24533486,120,audio/Or61_24533366.jpg,Or61
1037,1951.358779,1951.370779,2,58540763,58541123,360,audio/Bl122_58540763.jpg,Bl122
1038,15032.162013,15032.171726,1,450964860,450965151,291,audio/Ti81_450964860.jpg,Ti81
1039,562.220416,562.299416,1,16866612,16868982,2370,audio/Or61_16866612.jpg,Or61
1040,391.218161,391.234161,2,11736544,11737024,480,audio/Or61_11736544.jpg,Or61
1041,2224.031183,2224.066183,2,66720935,66721985,1050,audio/Bl122_66720935.jpg,Bl122
1042,15023.991648,15024.184528,1,450719749,450725535,5786,audio/Ti81_450719749.jpg,Ti81
1043,1946.910779,1947.122779,1,58407323,58413683,6360,audio/Bl122_58407323.jpg,Bl122
1044,2146.105183,2146.111183,2,64383155,64383335,180,audio/Bl122_64383155.jpg,Bl122
1045,15047.402966,15047.462966,1,451422088,451423888,1800,audio/Ti81_451422088.jpg,Ti81
1046,1977.348779,1977.589779,1,59320463,59327693,7230,audio/Bl122_59320463.jpg,Bl122
1047,723.503271,723.524271,1,21705098,21705728,630,audio/Or61_21705098.jpg,Or61
1048,3471.129144,3471.189443,1,104133874,104135683,1809,audio/Ti81_104133874.jpg,Ti81
1049,428.072969,428.317969,1,12842189,12849539,7350,audio/Or61_12842189.jpg,Or61
1050,1946.639779,1946.671779,1,58399193,58400153,960,audio/Bl122_58399193.jpg,Bl122
1051,712.603271,712.665271,1,21378098,21379958,1860,audio/Or61_21378098.jpg,Or61
1052,15034.321515,15034.405024,1,451029645,451032150,2505,audio/Ti81_451029645.jpg,Ti81
1053,1799.543115,1799.574115,1,53986293,53987223,930,audio/Bl122_53986293.jpg,Bl122
1054,743.605271,743.627271,1,22308158,22308818,660,audio/Or61_22308158.jpg,Or61
1055,747.288271,747.297271,1,22418648,22418918,270,audio/Or61_22418648.jpg,Or61
1056,1976.291779,1976.481779,1,59288753,59294453,5700,audio/Bl122_59288753.jpg,Bl122
1057,1968.991779,1969.078779,2,59069753,59072363,2610,audio/Bl122_59069753.jpg,Bl122
1058,2162.883183,2162.954183,2,64886495,64888625,2130,audio/Bl122_64886495.jpg,Bl122
1059,2066.108469,2066.112469,2,61983254,61983374,120,audio/Bl122_61983254.jpg,Bl122
1060,15165.710257,15165.783257,1,454971307,454973497,2190,audio/Ti81_454971307.jpg,Ti81
1061,471.955221,471.958221,2,14158656,14158746,90,audio/Or61_14158656.jpg,Or61
1062,1943.853779,1943.856779,2,58315613,58315703,90,audio/Bl122_58315613.jpg,Bl122
1063,2071.588469,2071.644469,1,62147654,62149334,1680,audio/Bl122_62147654.jpg,Bl122
1064,15317.696428,15317.858428,1,459530892,459535752,4860,audio/Ti81_459530892.jpg,Ti81
1065,2201.201183,2201.207183,2,66036035,66036215,180,audio/Bl122_66036035.jpg,Bl122
1066,1795.655115,1795.660115,2,53869653,53869803,150,audio/Bl122_53869653.jpg,Bl122
1067,2084.629961,2084.641961,2,62538898,62539258,360,audio/Bl122_62538898.jpg,Bl122
1068,730.647271,730.686271,1,21919418,21920588,1170,audio/Or61_21919418.jpg,Or61
1069,15304.291373,15304.351373,1,459128741,459130541,1800,audio/Ti81_459128741.jpg,Ti81
1070,1991.798779,1991.805779,2,59753963,59754173,210,audio/Bl122_59753963.jpg,Bl122
1071,2166.700183,2166.731183,2,65001005,65001935,930,audio/Bl122_65001005.jpg,Bl122
1072,15127.184981,15127.222981,1,453815549,453816689,1140,audio/Ti81_453815549.jpg,Ti81
1073,543.060416,543.113416,1,16291812,16293402,1590,audio/Or61_16291812.jpg,Or61
1074,6949.514842,6949.535842,2,208485445,208486075,630,audio/Li145_208485445.jpg,Li145
1075,2226.754183,2226.862183,1,66802625,66805865,3240,audio/Bl122_66802625.jpg,Bl122
1076,3467.137196,3467.185132,1,104014115,104015553,1438,audio/Ti81_104014115.jpg,Ti81
1077,2133.001183,2133.260183,1,63990035,63997805,7770,audio/Bl122_63990035.jpg,Bl122
1078,610.269417,610.286417,1,18308082,18308592,510,audio/Or61_18308082.jpg,Or61
1079,2231.500183,2231.543183,1,66945005,66946295,1290,audio/Bl122_66945005.jpg,Bl122
1080,729.361271,729.365271,1,21880838,21880958,120,audio/Or61_21880838.jpg,Or61
1081,1769.041657,1769.066657,1,53071249,53071999,750,audio/Bl122_53071249.jpg,Bl122
1082,15047.364966,15047.395966,1,451420948,451421878,930,audio/Ti81_451420948.jpg,Ti81
1083,2091.898961,2091.904961,2,62756968,62757148,180,audio/Bl122_62756968.jpg,Bl122
1084,2075.869823,2075.954823,1,62276094,62278644,2550,audio/Bl122_62276094.jpg,Bl122
1085,1774.607974,1774.622974,2,53238239,53238689,450,audio/Bl122_53238239.jpg,Bl122
1086,9170.925804,9170.961804,1,275127774,275128854,1080,audio/Li145_275127774.jpg,Li145
1087,1984.823779,1984.899779,1,59544713,59546993,2280,audio/Bl122_59544713.jpg,Bl122
1088,2056.759469,2056.785469,1,61702784,61703564,780,audio/Bl122_61702784.jpg,Bl122
1089,15028.25494,15028.319169,1,450847648,450849575,1927,audio/Ti81_450847648.jpg,Ti81
1090,1977.167779,1977.178779,1,59315033,59315363,330,audio/Bl122_59315033.jpg,Bl122
1091,2101.095961,2101.098961,2,63032878,63032968,90,audio/Bl122_63032878.jpg,Bl122
1092,1788.480115,1788.499115,2,53654403,53654973,570,audio/Bl122_53654403.jpg,Bl122
1093,563.256416,563.282416,2,16897692,16898472,780,audio/Or61_16897692.jpg,Or61
1094,15138.178989,15138.261989,1,454145369,454147859,2490,audio/Ti81_454145369.jpg,Ti81
1095,1956.608779,1956.621779,2,58698263,58698653,390,audio/Bl122_58698263.jpg,Bl122
1096,2059.532469,2059.567469,2,61785974,61787024,1050,audio/Bl122_61785974.jpg,Bl122
1097,2130.092183,2130.113183,2,63902765,63903395,630,audio/Bl122_63902765.jpg,Bl122
1098,209.023642,209.103642,1,6270709,6273109,2400,audio/Or61_6270709.jpg,Or61
1099,1945.274779,1945.283779,2,58358243,58358513,270,audio/Bl122_58358243.jpg,Bl122
1100,385.388161,385.411161,1,11561644,11562334,690,audio/Or61_11561644.jpg,Or61
1101,2218.274183,2218.317183,1,66548225,66549515,1290,audio/Bl122_66548225.jpg,Bl122
1102,2051.456469,2051.567469,1,61543694,61547024,3330,audio/Bl122_61543694.jpg,Bl122
1103,1955.331779,1955.384779,1,58659953,58661543,1590,audio/Bl122_58659953.jpg,Bl122
1104,3465.889594,3466.026086,1,103976687,103980782,4095,audio/Ti81_103976687.jpg,Ti81
1105,15125.540981,15125.937981,1,453766229,453778139,11910,audio/Ti81_453766229.jpg,Ti81
1106,518.702221,518.722221,1,15561066,15561666,600,audio/Or61_15561066.jpg,Or61
1107,501.445221,501.455221,2,15043356,15043656,300,audio/Or61_15043356.jpg,Or61
1108,2067.010469,2067.017469,2,62010314,62010524,210,audio/Bl122_62010314.jpg,Bl122
1109,535.028416,535.032416,2,16050852,16050972,120,audio/Or61_16050852.jpg,Or61
1110,15088.5599,15088.7829,1,452656797,452663487,6690,audio/Ti81_452656797.jpg,Ti81
1111,1957.575779,1957.583779,2,58727273,58727513,240,audio/Bl122_58727273.jpg,Bl122
1112,15277.748439,15277.766439,1,458332453,458332993,540,audio/Ti81_458332453.jpg,Ti81
1113,2167.121183,2167.128183,2,65013635,65013845,210,audio/Bl122_65013635.jpg,Bl122
1114,631.470417,631.600417,1,18944112,18948012,3900,audio/Or61_18944112.jpg,Or61
1115,501.421221,501.429221,2,15042636,15042876,240,audio/Or61_15042636.jpg,Or61
1116,1968.487779,1968.496779,2,59054633,59054903,270,audio/Bl122_59054633.jpg,Bl122
1117,15090.9049,15090.9479,1,452727147,452728437,1290,audio/Ti81_452727147.jpg,Ti81
1118,2045.052469,2045.060469,2,61351574,61351814,240,audio/Bl122_61351574.jpg,Bl122
1119,2082.742961,2082.781961,2,62482288,62483458,1170,audio/Bl122_62482288.jpg,Bl122
1120,3544.343067,3544.389363,1,106330292,106331680,1388,audio/Ti81_106330292.jpg,Ti81
1121,2221.867183,2221.877183,2,66656015,66656315,300,audio/Bl122_66656015.jpg,Bl122
1122,923.93336,923.968682,1,27718000,27719060,1060,audio/Ti81_27718000.jpg,Ti81
1123,2048.998469,2049.048469,2,61469954,61471454,1500,audio/Bl122_61469954.jpg,Bl122
1124,5872.881637,5872.900637,1,176186449,176187019,570,audio/Li145_176186449.jpg,Li145
1125,638.004417,638.083417,1,19140132,19142502,2370,audio/Or61_19140132.jpg,Or61
1126,8083.251803,8083.259803,2,242497554,242497794,240,audio/Li145_242497554.jpg,Li145
1127,2224.331183,2224.430183,2,66729935,66732905,2970,audio/Bl122_66729935.jpg,Bl122
1128,1969.378779,1969.397779,2,59081363,59081933,570,audio/Bl122_59081363.jpg,Bl122
1129,15138.955989,15139.006989,1,454168679,454170209,1530,audio/Ti81_454168679.jpg,Ti81
1130,15132.615989,15132.689989,1,453978479,453980699,2220,audio/Ti81_453978479.jpg,Ti81
1131,15057.637966,15057.671966,1,451729138,451730158,1020,audio/Ti81_451729138.jpg,Ti81
1132,2054.982469,2055.024469,1,61649474,61650734,1260,audio/Bl122_61649474.jpg,Bl122
1133,2068.696469,2068.714469,2,62060894,62061434,540,audio/Bl122_62060894.jpg,Bl122
1134,756.218271,756.224271,2,22686548,22686728,180,audio/Or61_22686548.jpg,Or61
1135,15238.095874,15238.111874,1,457142876,457143356,480,audio/Ti81_457142876.jpg,Ti81
1136,1990.561779,1991.035779,1,59716853,59731073,14220,audio/Bl122_59716853.jpg,Bl122
1137,15062.805966,15062.936102,1,451884178,451888083,3905,audio/Ti81_451884178.jpg,Ti81
1138,1967.903779,1968.041779,1,59037113,59041253,4140,audio/Bl122_59037113.jpg,Bl122
1139,1938.427779,1938.435779,2,58152833,58153073,240,audio/Bl122_58152833.jpg,Bl122
1140,6957.059877,6957.075877,1,208711796,208712276,480,audio/Li145_208711796.jpg,Li145
1141,2054.737469,2054.760469,1,61642124,61642814,690,audio/Bl122_61642124.jpg,Bl122
1142,2223.194183,2223.202183,2,66695825,66696065,240,audio/Bl122_66695825.jpg,Bl122
1143,3451.912164,3452.041329,1,103557364,103561239,3875,audio/Ti81_103557364.jpg,Ti81
1144,477.312221,477.327221,1,14319366,14319816,450,audio/Or61_14319366.jpg,Or61
1145,2164.263183,2164.289183,2,64927895,64928675,780,audio/Bl122_64927895.jpg,Bl122
1146,2201.443183,2201.471183,2,66043295,66044135,840,audio/Bl122_66043295.jpg,Bl122
1147,1953.271779,1953.377779,1,58598153,58601333,3180,audio/Bl122_58598153.jpg,Bl122
1148,3582.561686,3582.848686,1,107476850,107485460,8610,audio/Li145_107476850.jpg,Li145
1149,15057.532966,15057.577966,1,451725988,451727338,1350,audio/Ti81_451725988.jpg,Ti81
1150,9166.821583,9167.011583,1,275004647,275010347,5700,audio/Li145_275004647.jpg,Li145
1151,15298.053664,15298.151664,1,458941609,458944549,2940,audio/Ti81_458941609.jpg,Ti81
1152,512.025221,512.051221,1,15360756,15361536,780,audio/Or61_15360756.jpg,Or61
1153,2145.994183,2146.009183,2,64379825,64380275,450,audio/Bl122_64379825.jpg,Bl122
1154,1992.103779,1992.131779,1,59763113,59763953,840,audio/Bl122_59763113.jpg,Bl122
1155,2211.079183,2211.082183,2,66332375,66332465,90,audio/Bl122_66332375.jpg,Bl122
1156,15272.683439,15272.721439,1,458180503,458181643,1140,audio/Ti81_458180503.jpg,Ti81
1157,1942.416779,1942.433779,1,58272503,58273013,510,audio/Bl122_58272503.jpg,Bl122
1158,15046.822385,15047.055148,1,451404671,451411654,6983,audio/Ti81_451404671.jpg,Ti81
1159,767.107271,767.193271,1,23013218,23015798,2580,audio/Or61_23013218.jpg,Or61
1160,2097.962961,2098.110961,1,62938888,62943328,4440,audio/Bl122_62938888.jpg,Bl122
1161,614.697417,614.708417,1,18440922,18441252,330,audio/Or61_18440922.jpg,Or61
1162,2206.372183,2206.653183,1,66191165,66199595,8430,audio/Bl122_66191165.jpg,Bl122
1163,2059.808469,2059.831469,1,61794254,61794944,690,audio/Bl122_61794254.jpg,Bl122
1164,789.952827,789.970827,2,23698584,23699124,540,audio/Or61_23698584.jpg,Or61
1165,2070.835469,2070.838469,2,62125064,62125154,90,audio/Bl122_62125064.jpg,Bl122
1166,808.485882,808.560882,1,24254576,24256826,2250,audio/Or61_24254576.jpg,Or61
1167,2136.165183,2136.424183,1,64084955,64092725,7770,audio/Bl122_64084955.jpg,Bl122
1168,2196.354183,2196.358183,2,65890625,65890745,120,audio/Bl122_65890625.jpg,Bl122
1169,1975.035779,1975.040779,2,59251073,59251223,150,audio/Bl122_59251073.jpg,Bl122
1170,2001.328779,2001.448779,1,60039863,60043463,3600,audio/Bl122_60039863.jpg,Bl122
1171,727.445271,727.466271,1,21823358,21823988,630,audio/Or61_21823358.jpg,Or61
1172,2152.682183,2152.735183,1,64580465,64582055,1590,audio/Bl122_64580465.jpg,Bl122
1173,15340.396971,15340.463971,1,460211909,460213919,2010,audio/Ti81_460211909.jpg,Ti81
1174,15260.052114,15260.091114,1,457801563,457802733,1170,audio/Ti81_457801563.jpg,Ti81
1175,489.884221,490.045221,1,14696526,14701356,4830,audio/Or61_14696526.jpg,Or61
1176,497.685221,497.767221,1,14930556,14933016,2460,audio/Or61_14930556.jpg,Or61
1177,15040.590746,15040.766659,1,451217722,451222999,5277,audio/Ti81_451217722.jpg,Ti81
1178,588.627304,588.790304,1,17658819,17663709,4890,audio/Or61_17658819.jpg,Or61
1179,2170.278183,2170.305183,2,65108345,65109155,810,audio/Bl122_65108345.jpg,Bl122
1180,1939.606779,1939.631779,2,58188203,58188953,750,audio/Bl122_58188203.jpg,Bl122
1181,2054.590469,2054.612469,2,61637714,61638374,660,audio/Bl122_61637714.jpg,Bl122
1182,599.543417,599.550417,2,17986302,17986512,210,audio/Or61_17986302.jpg,Or61
1183,2169.449183,2169.486183,2,65083475,65084585,1110,audio/Bl122_65083475.jpg,Bl122
1184,1485.403018,1485.414018,1,44562090,44562420,330,audio/Li145_44562090.jpg,Li145
1185,2227.330183,2227.370183,2,66819905,66821105,1200,audio/Bl122_66819905.jpg,Bl122
1186,3584.340686,3584.431686,1,107530220,107532950,2730,audio/Li145_107530220.jpg,Li145
1187,2179.139183,2179.144183,2,65374175,65374325,150,audio/Bl122_65374175.jpg,Bl122
1188,2192.313183,2192.451183,1,65769395,65773535,4140,audio/Bl122_65769395.jpg,Bl122
1189,15224.025443,15224.082443,1,456720763,456722473,1710,audio/Ti81_456720763.jpg,Ti81
1190,671.798078,671.807078,2,20153942,20154212,270,audio/Or61_20153942.jpg,Or61
1191,2205.413183,2205.437183,2,66162395,66163115,720,audio/Bl122_66162395.jpg,Bl122
1192,15161.682257,15161.817257,1,454850467,454854517,4050,audio/Ti81_454850467.jpg,Ti81
1193,2124.519183,2124.533183,2,63735575,63735995,420,audio/Bl122_63735575.jpg,Bl122
1194,5711.369036,5711.373036,2,171341071,171341191,120,audio/Li145_171341071.jpg,Li145
1195,2229.643183,2229.799183,1,66889295,66893975,4680,audio/Bl122_66889295.jpg,Bl122
1196,796.579827,796.602827,1,23897394,23898084,690,audio/Or61_23897394.jpg,Or61
1197,552.714416,552.776416,1,16581432,16583292,1860,audio/Or61_16581432.jpg,Or61
1198,15156.924257,15156.958257,1,454707727,454708747,1020,audio/Ti81_454707727.jpg,Ti81
1199,488.951221,489.001221,2,14668536,14670036,1500,audio/Or61_14668536.jpg,Or61
1200,797.477827,797.565827,1,23924334,23926974,2640,audio/Or61_23924334.jpg,Or61
1201,2004.516779,2004.522779,2,60135503,60135683,180,audio/Bl122_60135503.jpg,Bl122
1202,546.273416,546.290416,1,16388202,16388712,510,audio/Or61_16388202.jpg,Or61
1203,2115.915183,2115.935183,1,63477455,63478055,600,audio/Bl122_63477455.jpg,Bl122
1204,2132.480183,2132.518183,1,63974405,63975545,1140,audio/Bl122_63974405.jpg,Bl122
1205,2041.947469,2042.024469,2,61258424,61260734,2310,audio/Bl122_61258424.jpg,Bl122
1206,2040.798815,2040.807815,1,61223964,61224234,270,audio/Li145_61223964.jpg,Li145
1207,481.309221,481.351221,1,14439276,14440536,1260,audio/Or61_14439276.jpg,Or61
1208,390.730161,390.795161,1,11721904,11723854,1950,audio/Or61_11721904.jpg,Or61
1209,1952.226779,1952.230779,2,58566803,58566923,120,audio/Bl122_58566803.jpg,Bl122
1210,549.674416,549.702416,1,16490232,16491072,840,audio/Or61_16490232.jpg,Or61
1211,2060.766469,2060.773469,2,61822994,61823204,210,audio/Bl122_61822994.jpg,Bl122
1212,2212.170183,2212.195183,1,66365105,66365855,750,audio/Bl122_66365105.jpg,Bl122
1213,2115.903183,2115.906183,2,63477095,63477185,90,audio/Bl122_63477095.jpg,Bl122
1214,1789.170115,1789.176115,2,53675103,53675283,180,audio/Bl122_53675103.jpg,Bl122
1215,3632.395014,3632.515014,1,108971850,108975450,3600,audio/Li145_108971850.jpg,Li145
1216,15137.410989,15137.441989,1,454122329,454123259,930,audio/Ti81_454122329.jpg,Ti81
1217,528.249416,528.456416,1,15847482,15853692,6210,audio/Or61_15847482.jpg,Or61
1218,15303.975373,15304.008373,1,459119261,459120251,990,audio/Ti81_459119261.jpg,Ti81
1219,15336.31401,15336.51701,1,460089420,460095510,6090,audio/Ti81_460089420.jpg,Ti81
1220,2189.433183,2189.720183,1,65682995,65691605,8610,audio/Bl122_65682995.jpg,Bl122
1221,15344.894971,15344.966971,1,460346849,460349009,2160,audio/Ti81_460346849.jpg,Ti81
1222,2154.486183,2154.494183,2,64634585,64634825,240,audio/Bl122_64634585.jpg,Bl122
1223,15283.588439,15283.647439,1,458507653,458509423,1770,audio/Ti81_458507653.jpg,Ti81
1224,512.628221,512.711221,1,15378846,15381336,2490,audio/Or61_15378846.jpg,Or61
1225,218.028413,218.118413,1,6540852,6543552,2700,audio/Or61_6540852.jpg,Or61
1226,3438.760749,3439.10261,1,103162822,103173078,10256,audio/Ti81_103162822.jpg,Ti81
1227,2219.969183,2219.992183,2,66599075,66599765,690,audio/Bl122_66599075.jpg,Bl122
1228,1991.757779,1991.766779,2,59752733,59753003,270,audio/Bl122_59752733.jpg,Bl122
1229,1814.966379,1815.113379,1,54448991,54453401,4410,audio/Bl122_54448991.jpg,Bl122
1230,8889.308716,8889.322716,1,266679261,266679681,420,audio/Li145_266679261.jpg,Li145
1231,15137.807989,15137.887989,1,454134239,454136639,2400,audio/Ti81_454134239.jpg,Ti81
1232,494.719221,494.965221,1,14841576,14848956,7380,audio/Or61_14841576.jpg,Or61
1233,1978.466779,1978.469779,2,59354003,59354093,90,audio/Bl122_59354003.jpg,Bl122
1234,2070.841469,2070.844469,2,62125244,62125334,90,audio/Bl122_62125244.jpg,Bl122
1235,3464.325361,3464.446064,1,103929760,103933381,3621,audio/Ti81_103929760.jpg,Ti81
1236,1815.185379,1815.252379,1,54455561,54457571,2010,audio/Bl122_54455561.jpg,Bl122
1237,2008.333779,2008.345779,2,60250013,60250373,360,audio/Bl122_60250013.jpg,Bl122
1238,2096.164961,2096.227961,1,62884948,62886838,1890,audio/Bl122_62884948.jpg,Bl122
1239,557.119416,557.210416,1,16713582,16716312,2730,audio/Or61_16713582.jpg,Or61
1240,747.509271,747.548271,1,22425278,22426448,1170,audio/Or61_22425278.jpg,Or61
1241,15107.608256,15107.886256,1,453228247,453236587,8340,audio/Ti81_453228247.jpg,Ti81
1242,560.944416,561.009416,1,16828332,16830282,1950,audio/Or61_16828332.jpg,Or61
1243,2000.468779,2000.514779,2,60014063,60015443,1380,audio/Bl122_60014063.jpg,Bl122
1244,9168.711583,9168.781583,1,275061347,275063447,2100,audio/Li145_275061347.jpg,Li145
1245,502.883221,502.909221,2,15086496,15087276,780,audio/Or61_15086496.jpg,Or61
1246,792.520827,792.525827,2,23775624,23775774,150,audio/Or61_23775624.jpg,Or61
1247,943.316982,943.518061,1,28299509,28305541,6032,audio/Ti81_28299509.jpg,Ti81
1248,2013.788959,2013.803959,2,60413668,60414118,450,audio/Bl122_60413668.jpg,Bl122
1249,504.562221,504.590221,2,15136866,15137706,840,audio/Or61_15136866.jpg,Or61
1250,1793.030115,1793.079115,2,53790903,53792373,1470,audio/Bl122_53790903.jpg,Bl122
1251,536.692416,536.731416,1,16100772,16101942,1170,audio/Or61_16100772.jpg,Or61
1252,1967.595779,1967.639779,1,59027873,59029193,1320,audio/Bl122_59027873.jpg,Bl122
1253,2205.149183,2205.153183,2,66154475,66154595,120,audio/Bl122_66154475.jpg,Bl122
1254,1971.671779,1971.687779,2,59150153,59150633,480,audio/Bl122_59150153.jpg,Bl122
1255,1771.766657,1772.038657,1,53152999,53161159,8160,audio/Bl122_53152999.jpg,Bl122
1256,1966.737779,1966.769779,2,59002133,59003093,960,audio/Bl122_59002133.jpg,Bl122
1257,183.260971,183.282971,1,5497829,5498489,660,audio/Or61_5497829.jpg,Or61
1258,2112.672183,2112.677183,2,63380165,63380315,150,audio/Bl122_63380165.jpg,Bl122
1259,526.745416,526.748416,2,15802362,15802452,90,audio/Or61_15802362.jpg,Or61
1260,2004.486779,2004.494779,2,60134603,60134843,240,audio/Bl122_60134603.jpg,Bl122
1261,2083.823961,2083.834961,2,62514718,62515048,330,audio/Bl122_62514718.jpg,Bl122
1262,547.570416,547.655416,1,16427112,16429662,2550,audio/Or61_16427112.jpg,Or61
1263,2002.254779,2002.265779,2,60067643,60067973,330,audio/Bl122_60067643.jpg,Bl122
1264,1791.275115,1791.360115,1,53738253,53740803,2550,audio/Bl122_53738253.jpg,Bl122
1265,8097.683141,8097.696141,1,242930494,242930884,390,audio/Li145_242930494.jpg,Li145
1266,15336.52401,15336.55001,1,460095720,460096500,780,audio/Ti81_460095720.jpg,Ti81
1267,1997.146779,1997.152779,2,59914403,59914583,180,audio/Bl122_59914403.jpg,Bl122
1268,1952.254779,1952.272779,2,58567643,58568183,540,audio/Bl122_58567643.jpg,Bl122
1269,841.224291,841.391311,1,25236728,25241739,5011,audio/Ti81_25236728.jpg,Ti81
1270,611.461417,611.467417,2,18343842,18344022,180,audio/Or61_18343842.jpg,Or61
1271,2165.366183,2165.372183,2,64960985,64961165,180,audio/Bl122_64960985.jpg,Bl122
1272,2216.471183,2216.477183,2,66494135,66494315,180,audio/Bl122_66494135.jpg,Bl122
1273,491.391221,491.429221,2,14741736,14742876,1140,audio/Or61_14741736.jpg,Or61
1274,2163.487183,2163.490183,2,64904615,64904705,90,audio/Bl122_64904615.jpg,Bl122
1275,15329.617625,15329.687625,1,459888528,459890628,2100,audio/Ti81_459888528.jpg,Ti81
1276,3464.942981,3464.980069,1,103948289,103949402,1113,audio/Ti81_103948289.jpg,Ti81
1277,2107.384377,2107.396377,1,63221531,63221891,360,audio/Bl122_63221531.jpg,Bl122
1278,607.495417,607.772417,1,18224862,18233172,8310,audio/Or61_18224862.jpg,Or61
1279,592.885457,592.955457,1,17786563,17788663,2100,audio/Or61_17786563.jpg,Or61
1280,748.635271,748.662271,1,22459058,22459868,810,audio/Or61_22459058.jpg,Or61
1281,15236.884874,15236.953874,1,457106546,457108616,2070,audio/Ti81_457106546.jpg,Ti81
1282,3472.347606,3472.358959,1,104170428,104170768,340,audio/Ti81_104170428.jpg,Ti81
1283,15032.267576,15032.283723,1,450968027,450968511,484,audio/Ti81_450968027.jpg,Ti81
1284,1982.947779,1983.128779,1,59488433,59493863,5430,audio/Bl122_59488433.jpg,Bl122
1285,15104.028256,15104.208256,1,453120847,453126247,5400,audio/Ti81_453120847.jpg,Ti81
1286,15304.452373,15304.508373,1,459133571,459135251,1680,audio/Ti81_459133571.jpg,Ti81
1287,487.792221,487.795221,2,14633766,14633856,90,audio/Or61_14633766.jpg,Or61
1288,747.768271,747.808271,1,22433048,22434248,1200,audio/Or61_22433048.jpg,Or61
1289,728.098271,728.230271,1,21842948,21846908,3960,audio/Or61_21842948.jpg,Or61
1290,818.421882,818.479882,1,24552656,24554396,1740,audio/Or61_24552656.jpg,Or61
1291,495.005221,495.043221,2,14850156,14851296,1140,audio/Or61_14850156.jpg,Or61
1292,616.029417,616.036417,2,18480882,18481092,210,audio/Or61_18480882.jpg,Or61
1293,15049.888966,15050.076966,1,451496668,451502308,5640,audio/Ti81_451496668.jpg,Ti81
1294,579.92771,579.98871,1,17397831,17399661,1830,audio/Or61_17397831.jpg,Or61
1295,15032.130832,15032.142563,1,450963924,450964276,352,audio/Ti81_450963924.jpg,Ti81
1296,15249.729074,15249.952074,1,457491872,457498562,6690,audio/Ti81_457491872.jpg,Ti81
1297,14770.046756,14770.220588,1,443101402,443106617,5215,audio/Ti81_443101402.jpg,Ti81
1298,1957.010779,1957.089779,1,58710323,58712693,2370,audio/Bl122_58710323.jpg,Bl122
1299,2121.904183,2121.924183,1,63657125,63657725,600,audio/Bl122_63657125.jpg,Bl122
1300,15209.381962,15209.43258,1,456281458,456282977,1519,audio/Ti81_456281458.jpg,Ti81
1301,9166.556583,9166.570583,1,274996697,274997117,420,audio/Li145_274996697.jpg,Li145
1302,15287.152439,15287.530439,1,458614573,458625913,11340,audio/Ti81_458614573.jpg,Ti81
1303,1947.284779,1947.287779,2,58418543,58418633,90,audio/Bl122_58418543.jpg,Bl122
1304,2077.217823,2077.220823,2,62316534,62316624,90,audio/Bl122_62316534.jpg,Bl122
1305,2140.503183,2140.588183,2,64215095,64217645,2550,audio/Bl122_64215095.jpg,Bl122
1306,704.949271,704.954271,2,21148478,21148628,150,audio/Or61_21148478.jpg,Or61
1307,472.652221,472.655221,2,14179566,14179656,90,audio/Or61_14179566.jpg,Or61
1308,514.531221,514.547221,1,15435936,15436416,480,audio/Or61_15435936.jpg,Or61
1309,15304.941373,15305.135373,1,459148241,459154061,5820,audio/Ti81_459148241.jpg,Ti81
1310,1991.351779,1991.609779,1,59740553,59748293,7740,audio/Bl122_59740553.jpg,Bl122
1311,2226.727183,2226.732183,2,66801815,66801965,150,audio/Bl122_66801815.jpg,Bl122
1312,1805.10305,1805.12605,1,54153091,54153781,690,audio/Bl122_54153091.jpg,Bl122
1313,1952.292779,1952.296779,2,58568783,58568903,120,audio/Bl122_58568783.jpg,Bl122
1314,2173.971183,2173.981183,2,65219135,65219435,300,audio/Bl122_65219135.jpg,Bl122
1315,3467.269147,3467.347359,1,104018074,104020420,2346,audio/Ti81_104018074.jpg,Ti81
1316,2201.172183,2201.189183,2,66035165,66035675,510,audio/Bl122_66035165.jpg,Bl122
1317,789.222827,789.233827,2,23676684,23677014,330,audio/Or61_23676684.jpg,Or61
1318,2132.010183,2132.030183,2,63960305,63960905,600,audio/Bl122_63960305.jpg,Bl122
1319,2038.716469,2038.720469,2,61161494,61161614,120,audio/Bl122_61161494.jpg,Bl122
1320,409.867602,409.971602,1,12296028,12299148,3120,audio/Or61_12296028.jpg,Or61
1321,2075.071823,2075.164823,1,62252154,62254944,2790,audio/Bl122_62252154.jpg,Bl122
1322,2059.198469,2059.231469,1,61775954,61776944,990,audio/Bl122_61775954.jpg,Bl122
1323,275.760667,275.830667,1,8272820,8274920,2100,audio/Or61_8272820.jpg,Or61
1324,181.392971,181.435971,1,5441789,5443079,1290,audio/Or61_5441789.jpg,Or61
1325,2187.889183,2187.914183,1,65636675,65637425,750,audio/Bl122_65636675.jpg,Bl122
1326,2124.269183,2124.282183,2,63728075,63728465,390,audio/Bl122_63728075.jpg,Bl122
1327,15286.275439,15286.430439,1,458588263,458592913,4650,audio/Ti81_458588263.jpg,Ti81
1328,815.923882,815.975882,1,24477716,24479276,1560,audio/Or61_24477716.jpg,Or61
1329,2206.785183,2207.048183,1,66203555,66211445,7890,audio/Bl122_66203555.jpg,Bl122
1330,632.160417,632.162417,2,18964812,18964872,60,audio/Or61_18964812.jpg,Or61
1331,3.509816,3.517816,2,105294,105534,240,audio/Or61_105294.jpg,Or61
1332,631.704417,631.745417,1,18951132,18952362,1230,audio/Or61_18951132.jpg,Or61
1333,638.155417,638.210417,1,19144662,19146312,1650,audio/Or61_19144662.jpg,Or61
1334,2157.357183,2157.431183,2,64720715,64722935,2220,audio/Bl122_64720715.jpg,Bl122
1335,764.647271,764.666271,1,22939418,22939988,570,audio/Or61_22939418.jpg,Or61
1336,2055.774469,2055.779469,2,61673234,61673384,150,audio/Bl122_61673234.jpg,Bl122
1337,1963.235779,1963.239779,2,58897073,58897193,120,audio/Bl122_58897073.jpg,Bl122
1338,484.365221,484.368221,2,14530956,14531046,90,audio/Or61_14530956.jpg,Or61
1339,501.644221,501.662221,2,15049326,15049866,540,audio/Or61_15049326.jpg,Or61
1340,925.642411,925.675209,1,27769272,27770256,984,audio/Ti81_27769272.jpg,Ti81
1341,213.286857,213.299857,1,6398605,6398995,390,audio/Or61_6398605.jpg,Or61
1342,626.521417,626.530417,2,18795642,18795912,270,audio/Or61_18795642.jpg,Or61
1343,2047.062469,2047.090469,1,61411874,61412714,840,audio/Bl122_61411874.jpg,Bl122
1344,482.061221,482.076221,2,14461836,14462286,450,audio/Or61_14461836.jpg,Or61
1345,2161.454183,2161.479183,2,64843625,64844375,750,audio/Bl122_64843625.jpg,Bl122
1346,1974.198779,1974.221779,1,59225963,59226653,690,audio/Bl122_59225963.jpg,Bl122
1347,2084.645961,2084.679961,1,62539378,62540398,1020,audio/Bl122_62539378.jpg,Bl122
1348,9607.670345,9607.835851,1,288230110,288235075,4965,audio/Ti81_288230110.jpg,Ti81
1349,1952.275779,1952.283779,2,58568273,58568513,240,audio/Bl122_58568273.jpg,Bl122
1350,1990.086779,1990.092779,2,59702603,59702783,180,audio/Bl122_59702603.jpg,Bl122
1351,1799.617115,1799.655115,1,53988513,53989653,1140,audio/Bl122_53988513.jpg,Bl122
1352,2054.888469,2054.894469,2,61646654,61646834,180,audio/Bl122_61646654.jpg,Bl122
1353,1808.662926,1808.674926,2,54259887,54260247,360,audio/Bl122_54259887.jpg,Bl122
1354,2124.989183,2125.162183,1,63749675,63754865,5190,audio/Bl122_63749675.jpg,Bl122
1355,2039.238815,2039.251815,1,61177164,61177554,390,audio/Li145_61177164.jpg,Li145
1356,636.498417,636.515417,2,19094952,19095462,510,audio/Or61_19094952.jpg,Or61
1357,15159.590257,15159.608257,1,454787707,454788247,540,audio/Ti81_454787707.jpg,Ti81
1358,1774.976974,1775.149974,1,53249309,53254499,5190,audio/Bl122_53249309.jpg,Bl122
1359,483.745221,483.753221,2,14512356,14512596,240,audio/Or61_14512356.jpg,Or61
1360,711.227271,711.289271,1,21336818,21338678,1860,audio/Or61_21336818.jpg,Or61
1361,7547.479781,7547.481781,2,226424393,226424453,60,audio/Li145_226424393.jpg,Li145
1362,2184.510183,2184.586183,1,65535305,65537585,2280,audio/Bl122_65535305.jpg,Bl122
1363,15329.349625,15329.423625,1,459880488,459882708,2220,audio/Ti81_459880488.jpg,Ti81
1364,1951.266779,1951.271779,2,58538003,58538153,150,audio/Bl122_58538003.jpg,Bl122
1365,2209.281183,2209.284183,2,66278435,66278525,90,audio/Bl122_66278435.jpg,Bl122
1366,2126.931183,2126.937183,2,63807935,63808115,180,audio/Bl122_63807935.jpg,Bl122
1367,2223.719183,2223.826183,1,66711575,66714785,3210,audio/Bl122_66711575.jpg,Bl122
1368,2216.440183,2216.465183,1,66493205,66493955,750,audio/Bl122_66493205.jpg,Bl122
1369,1938.194779,1938.284779,2,58145843,58148543,2700,audio/Bl122_58145843.jpg,Bl122
1370,14943.075266,14943.244935,1,448292257,448297348,5091,audio/Ti81_448292257.jpg,Ti81
1371,2146.484183,2146.623183,1,64394525,64398695,4170,audio/Bl122_64394525.jpg,Bl122
1372,604.958417,605.030417,1,18148752,18150912,2160,audio/Or61_18148752.jpg,Or61
1373,1961.092779,1961.099779,2,58832783,58832993,210,audio/Bl122_58832783.jpg,Bl122
1374,787.689827,787.765827,1,23630694,23632974,2280,audio/Or61_23630694.jpg,Or61
1375,728.273271,728.347271,1,21848198,21850418,2220,audio/Or61_21848198.jpg,Or61
1376,14777.192021,14777.410761,1,443315760,443322322,6562,audio/Ti81_443315760.jpg,Ti81
1377,5872.987637,5873.001637,1,176189629,176190049,420,audio/Li145_176189629.jpg,Li145
1378,15069.552682,15069.614682,1,452086580,452088440,1860,audio/Ti81_452086580.jpg,Ti81
1379,797.914827,797.941827,1,23937444,23938254,810,audio/Or61_23937444.jpg,Or61
1380,15326.497488,15326.651488,1,459794924,459799544,4620,audio/Ti81_459794924.jpg,Ti81
1381,15214.70258,15214.74058,1,456441077,456442217,1140,audio/Ti81_456441077.jpg,Ti81
1382,15231.061443,15231.151443,1,456931843,456934543,2700,audio/Ti81_456931843.jpg,Ti81
1383,3451.789296,3451.802668,1,103553678,103554080,402,audio/Ti81_103553678.jpg,Ti81
1384,15076.676682,15076.976682,1,452300300,452309300,9000,audio/Ti81_452300300.jpg,Ti81
1385,2004.912779,2005.028779,1,60147383,60150863,3480,audio/Bl122_60147383.jpg,Bl122
1386,2046.494469,2046.504469,2,61394834,61395134,300,audio/Bl122_61394834.jpg,Bl122
1387,626.321417,626.477417,1,18789642,18794322,4680,audio/Or61_18789642.jpg,Or61
1388,530.299416,530.316416,2,15908982,15909492,510,audio/Or61_15908982.jpg,Or61
1389,607.989417,607.999417,2,18239682,18239982,300,audio/Or61_18239682.jpg,Or61
1390,5841.179404,5841.185404,1,175235382,175235562,180,audio/Li145_175235382.jpg,Li145
1391,2116.875183,2116.892183,2,63506255,63506765,510,audio/Bl122_63506255.jpg,Bl122
1392,2201.842183,2201.982183,1,66055265,66059465,4200,audio/Bl122_66055265.jpg,Bl122
1393,5764.18372,5764.31172,1,172925511,172929351,3840,audio/Li145_172925511.jpg,Li145
1394,15061.981966,15062.336966,1,451859458,451870108,10650,audio/Ti81_451859458.jpg,Ti81
1395,3420.872989,3420.903264,1,102626189,102627097,908,audio/Ti81_102626189.jpg,Ti81
1396,1771.289657,1771.295657,2,53138689,53138869,180,audio/Bl122_53138689.jpg,Bl122
1397,15110.444256,15110.533256,1,453313327,453315997,2670,audio/Ti81_453313327.jpg,Ti81
1398,496.020221,496.071221,1,14880606,14882136,1530,audio/Or61_14880606.jpg,Or61
1399,4464.859248,4464.914248,1,133945777,133947427,1650,audio/Li145_133945777.jpg,Li145
1400,2201.158183,2201.162183,2,66034745,66034865,120,audio/Bl122_66034745.jpg,Bl122
1401,2124.219183,2124.225183,2,63726575,63726755,180,audio/Bl122_63726575.jpg,Bl122
1402,1942.576779,1942.730779,1,58277303,58281923,4620,audio/Bl122_58277303.jpg,Bl122
1403,15303.525373,15303.604373,1,459105761,459108131,2370,audio/Ti81_459105761.jpg,Ti81
1404,530.523416,530.539416,2,15915702,15916182,480,audio/Or61_15915702.jpg,Or61
1405,2216.274183,2216.294183,1,66488225,66488825,600,audio/Bl122_66488225.jpg,Bl122
1406,2171.814183,2171.972183,1,65154425,65159165,4740,audio/Bl122_65154425.jpg,Bl122
1407,712.711271,712.774271,1,21381338,21383228,1890,audio/Or61_21381338.jpg,Or61
1408,3451.211287,3451.423972,1,103536338,103542719,6381,audio/Ti81_103536338.jpg,Ti81
1409,710.943271,711.016271,1,21328298,21330488,2190,audio/Or61_21328298.jpg,Or61
1410,719.339271,719.550271,1,21580178,21586508,6330,audio/Or61_21580178.jpg,Or61
1411,15258.581114,15258.597114,2,457757433,457757913,480,audio/Ti81_457757433.jpg,Ti81
1412,3415.527601,3415.750245,1,102465828,102472507,6679,audio/Ti81_102465828.jpg,Ti81
1413,2192.964183,2192.974183,2,65788925,65789225,300,audio/Bl122_65788925.jpg,Bl122
1414,15228.791443,15229.229443,1,456863743,456876883,13140,audio/Ti81_456863743.jpg,Ti81
1415,2169.760183,2169.764183,2,65092805,65092925,120,audio/Bl122_65092805.jpg,Bl122
1416,2001.747779,2001.755779,2,60052433,60052673,240,audio/Bl122_60052433.jpg,Bl122
1417,396.424529,396.483529,1,11892735,11894505,1770,audio/Or61_11892735.jpg,Or61
1418,542.776416,542.815416,1,16283292,16284462,1170,audio/Or61_16283292.jpg,Or61
1419,613.048417,613.378417,1,18391452,18401352,9900,audio/Or61_18391452.jpg,Or61
1420,15125.023981,15125.057981,1,453750719,453751739,1020,audio/Ti81_453750719.jpg,Ti81
1421,747.942271,747.972271,2,22438268,22439168,900,audio/Or61_22438268.jpg,Or61
1422,813.379882,813.407882,1,24401396,24402236,840,audio/Or61_24401396.jpg,Or61
1423,2091.657961,2091.766961,1,62749738,62753008,3270,audio/Bl122_62749738.jpg,Bl122
1424,2134.160183,2134.163183,2,64024805,64024895,90,audio/Bl122_64024805.jpg,Bl122
1425,183.284971,183.302971,1,5498549,5499089,540,audio/Or61_5498549.jpg,Or61
1426,3543.432153,3543.605354,1,106302964,106308160,5196,audio/Ti81_106302964.jpg,Ti81
1427,15029.205842,15029.342334,1,450876175,450880270,4095,audio/Ti81_450876175.jpg,Ti81
1428,756.935271,757.010271,1,22708058,22710308,2250,audio/Or61_22708058.jpg,Or61
1429,543.981416,544.013416,1,16319442,16320402,960,audio/Or61_16319442.jpg,Or61
1430,758.043271,758.376271,1,22741298,22751288,9990,audio/Or61_22741298.jpg,Or61
1431,728.478271,728.495271,1,21854348,21854858,510,audio/Or61_21854348.jpg,Or61
1432,1081.595675,1081.647675,1,32447870,32449430,1560,audio/Li145_32447870.jpg,Li145
1433,1939.417779,1939.424779,2,58182533,58182743,210,audio/Bl122_58182533.jpg,Bl122
1434,9180.662829,9180.681829,1,275419884,275420454,570,audio/Li145_275419884.jpg,Li145
1435,711.393271,711.395271,2,21341798,21341858,60,audio/Or61_21341798.jpg,Or61
1436,235.945781,236.001781,1,7078373,7080053,1680,audio/Or61_7078373.jpg,Or61
1437,3580.528097,3580.748097,1,107415842,107422442,6600,audio/Li145_107415842.jpg,Li145
1438,403.559692,403.586692,2,12106790,12107600,810,audio/Or61_12106790.jpg,Or61
1439,2058.382469,2058.439469,1,61751474,61753184,1710,audio/Bl122_61751474.jpg,Bl122
1440,15223.757443,15223.789443,1,456712723,456713683,960,audio/Ti81_456712723.jpg,Ti81
1441,771.434271,771.453271,2,23143028,23143598,570,audio/Or61_23143028.jpg,Or61
1442,391.191161,391.215161,2,11735734,11736454,720,audio/Or61_11735734.jpg,Or61
1443,15078.481682,15078.662682,1,452354450,452359880,5430,audio/Ti81_452354450.jpg,Ti81
1444,2146.880183,2146.883183,2,64406405,64406495,90,audio/Bl122_64406405.jpg,Bl122
1445,15097.342823,15097.365823,1,452920284,452920974,690,audio/Ti81_452920284.jpg,Ti81
1446,2083.783961,2083.816961,2,62513518,62514508,990,audio/Bl122_62513518.jpg,Bl122
1447,2048.087469,2048.100469,1,61442624,61443014,390,audio/Bl122_61442624.jpg,Bl122
1448,1972.557779,1972.580779,2,59176733,59177423,690,audio/Bl122_59176733.jpg,Bl122
1449,472.190221,472.217221,2,14165706,14166516,810,audio/Or61_14165706.jpg,Or61
1450,2052.977469,2052.984469,2,61589324,61589534,210,audio/Bl122_61589324.jpg,Bl122
1451,565.277416,565.290416,1,16958322,16958712,390,audio/Or61_16958322.jpg,Or61
1452,3426.397759,3426.548379,1,102791932,102796451,4519,audio/Ti81_102791932.jpg,Ti81
1453,705.049271,705.121271,1,21151478,21153638,2160,audio/Or61_21151478.jpg,Or61
1454,6338.807837,6338.826837,1,190164235,190164805,570,audio/Li145_190164235.jpg,Li145
1455,766.973271,767.100271,1,23009198,23013008,3810,audio/Or61_23009198.jpg,Or61
1456,626.619417,626.625417,2,18798582,18798762,180,audio/Or61_18798582.jpg,Or61
1457,2139.761183,2139.767183,2,64192835,64193015,180,audio/Bl122_64192835.jpg,Bl122
1458,766.081271,766.090271,1,22982438,22982708,270,audio/Or61_22982438.jpg,Or61
1459,15216.19458,15216.21658,1,456485837,456486497,660,audio/Ti81_456485837.jpg,Ti81
1460,1981.572779,1981.581779,2,59447183,59447453,270,audio/Bl122_59447183.jpg,Bl122
1461,1814.861379,1814.961379,2,54445841,54448841,3000,audio/Bl122_54445841.jpg,Bl122
1462,2190.915183,2191.022183,1,65727455,65730665,3210,audio/Bl122_65727455.jpg,Bl122
1463,531.428416,531.455416,2,15942852,15943662,810,audio/Or61_15942852.jpg,Or61
1464,762.504271,762.533271,1,22875128,22875998,870,audio/Or61_22875128.jpg,Or61
1465,730.449271,730.473271,1,21913478,21914198,720,audio/Or61_21913478.jpg,Or61
1466,527.492416,527.588416,1,15824772,15827652,2880,audio/Or61_15824772.jpg,Or61
1467,486.616221,486.909221,1,14598486,14607276,8790,audio/Or61_14598486.jpg,Or61
1468,2122.697183,2122.746183,1,63680915,63682385,1470,audio/Bl122_63680915.jpg,Bl122
1469,6949.548842,6949.551842,2,208486465,208486555,90,audio/Li145_208486465.jpg,Li145
1470,1796.426115,1796.524115,1,53892783,53895723,2940,audio/Bl122_53892783.jpg,Bl122
1471,2191.765183,2191.768183,2,65752955,65753045,90,audio/Bl122_65752955.jpg,Bl122
1472,2093.123961,2093.126961,2,62793718,62793808,90,audio/Bl122_62793718.jpg,Bl122
1473,481.748221,481.849221,1,14452446,14455476,3030,audio/Or61_14452446.jpg,Or61
1474,1995.038779,1995.228779,1,59851163,59856863,5700,audio/Bl122_59851163.jpg,Bl122
1475,15034.941027,15035.096819,1,451048230,451052904,4674,audio/Ti81_451048230.jpg,Ti81
1476,1998.883779,1998.892779,2,59966513,59966783,270,audio/Bl122_59966513.jpg,Bl122
1477,15083.6089,15083.6619,1,452508267,452509857,1590,audio/Ti81_452508267.jpg,Ti81
1478,15162.531257,15162.762257,1,454875937,454882867,6930,audio/Ti81_454875937.jpg,Ti81
1479,2054.020469,2054.038469,2,61620614,61621154,540,audio/Bl122_61620614.jpg,Bl122
1480,2190.275183,2190.623183,1,65708255,65718695,10440,audio/Bl122_65708255.jpg,Bl122
1481,15107.093256,15107.169256,1,453212797,453215077,2280,audio/Ti81_453212797.jpg,Ti81
1482,15214.89458,15214.95058,1,456446837,456448517,1680,audio/Ti81_456446837.jpg,Ti81
1483,497.220221,497.248221,1,14916606,14917446,840,audio/Or61_14916606.jpg,Or61
1484,9165.105583,9165.123583,1,274953167,274953707,540,audio/Li145_274953167.jpg,Li145
1485,2052.666469,2052.748469,1,61579994,61582454,2460,audio/Bl122_61579994.jpg,Bl122
1486,2112.752183,2112.856183,1,63382565,63385685,3120,audio/Bl122_63382565.jpg,Bl122
1487,2060.136469,2060.264469,1,61804094,61807934,3840,audio/Bl122_61804094.jpg,Bl122
1488,15215.02458,15215.07658,1,456450737,456452297,1560,audio/Ti81_456450737.jpg,Ti81
1489,494.694221,494.717221,2,14840826,14841516,690,audio/Or61_14840826.jpg,Or61
1490,610.958417,610.974417,1,18328752,18329232,480,audio/Or61_18328752.jpg,Or61
1491,754.577271,754.606271,2,22637318,22638188,870,audio/Or61_22637318.jpg,Or61
1492,6534.740621,6534.897621,1,196042218,196046928,4710,audio/Li145_196042218.jpg,Li145
1493,2054.922469,2054.971469,1,61647674,61649144,1470,audio/Bl122_61647674.jpg,Bl122
1494,15225.262443,15225.399443,1,456757873,456761983,4110,audio/Ti81_456757873.jpg,Ti81
1495,5841.968404,5842.065404,1,175259052,175261962,2910,audio/Li145_175259052.jpg,Li145
1496,716.604271,716.636271,1,21498128,21499088,960,audio/Or61_21498128.jpg,Or61
1497,15303.691373,15303.714373,1,459110741,459111431,690,audio/Ti81_459110741.jpg,Ti81
1498,14902.548261,14902.827584,1,447076447,447084827,8380,audio/Ti81_447076447.jpg,Ti81
1499,15220.533443,15220.634443,1,456616003,456619033,3030,audio/Ti81_456616003.jpg,Ti81
1500,1800.989115,1801.024115,1,54029673,54030723,1050,audio/Bl122_54029673.jpg,Bl122
1501,79.231806,79.413806,1,2376954,2382414,5460,audio/Bl122_2376954.jpg,Bl122
1502,2052.758469,2052.941469,1,61582754,61588244,5490,audio/Bl122_61582754.jpg,Bl122
1503,792.633827,792.804827,1,23779014,23784144,5130,audio/Or61_23779014.jpg,Or61
1504,2119.980183,2119.986183,2,63599405,63599585,180,audio/Bl122_63599405.jpg,Bl122
1505,9537.136343,9537.149343,1,286114090,286114480,390,audio/Li145_286114090.jpg,Li145
1506,7550.840715,7550.851715,1,226525221,226525551,330,audio/Li145_226525221.jpg,Li145
1507,1974.745779,1974.763779,2,59242373,59242913,540,audio/Bl122_59242373.jpg,Bl122
1508,104.490362,104.677362,1,3134710,3140320,5610,audio/Bl122_3134710.jpg,Bl122
1509,15347.146971,15347.362888,1,460414409,460420886,6477,audio/Ti81_460414409.jpg,Ti81
1510,2148.548183,2148.586183,2,64456445,64457585,1140,audio/Bl122_64456445.jpg,Bl122
1511,2056.948469,2056.964469,1,61708454,61708934,480,audio/Bl122_61708454.jpg,Bl122
1512,613.926417,613.957417,1,18417792,18418722,930,audio/Or61_18417792.jpg,Or61
1513,91.537253,91.783253,1,2746117,2753497,7380,audio/Bl122_2746117.jpg,Bl122
1514,3544.274316,3544.321117,1,106328229,106329633,1404,audio/Ti81_106328229.jpg,Ti81
1515,2136.735183,2136.740183,2,64102055,64102205,150,audio/Bl122_64102055.jpg,Bl122
1516,1991.769779,1991.774779,2,59753093,59753243,150,audio/Bl122_59753093.jpg,Bl122
1517,2202.883183,2202.886183,2,66086495,66086585,90,audio/Bl122_66086495.jpg,Bl122
1518,747.300271,747.314271,1,22419008,22419428,420,audio/Or61_22419008.jpg,Or61
1519,3646.264803,3646.474803,1,109387944,109394244,6300,audio/Li145_109387944.jpg,Li145
1520,470.274221,470.325221,1,14108226,14109756,1530,audio/Or61_14108226.jpg,Or61
1521,5835.013068,5835.203068,1,175050392,175056092,5700,audio/Li145_175050392.jpg,Li145
1522,1937.725779,1937.730779,2,58131773,58131923,150,audio/Bl122_58131773.jpg,Bl122
1523,1783.449323,1783.463323,1,53503479,53503899,420,audio/Bl122_53503479.jpg,Bl122
1524,2134.660183,2134.696183,1,64039805,64040885,1080,audio/Bl122_64039805.jpg,Bl122
1525,2178.857183,2178.869183,2,65365715,65366075,360,audio/Bl122_65365715.jpg,Bl122
1526,1996.673779,1996.886779,1,59900213,59906603,6390,audio/Bl122_59900213.jpg,Bl122
1527,15117.309981,15117.338981,1,453519299,453520169,870,audio/Ti81_453519299.jpg,Ti81
1528,2045.685469,2046.163469,1,61370564,61384904,14340,audio/Bl122_61370564.jpg,Bl122
1529,746.641271,746.654271,1,22399238,22399628,390,audio/Or61_22399238.jpg,Or61
1530,2038.161469,2038.200469,2,61144844,61146014,1170,audio/Bl122_61144844.jpg,Bl122
1531,1957.411779,1957.537779,1,58722353,58726133,3780,audio/Bl122_58722353.jpg,Bl122
1532,2049.534469,2049.561469,1,61486034,61486844,810,audio/Bl122_61486034.jpg,Bl122
1533,15326.711488,15326.799488,1,459801344,459803984,2640,audio/Ti81_459801344.jpg,Ti81
1534,730.599271,730.644271,1,21917978,21919328,1350,audio/Or61_21917978.jpg,Or61
1535,2096.029961,2096.044961,2,62880898,62881348,450,audio/Bl122_62880898.jpg,Bl122
1536,9046.188911,9046.195911,1,271385667,271385877,210,audio/Li145_271385667.jpg,Li145
1537,396.490529,396.729529,1,11894715,11901885,7170,audio/Or61_11894715.jpg,Or61
1538,14942.761946,14942.793956,1,448282858,448283818,960,audio/Ti81_448282858.jpg,Ti81
1539,2049.158469,2049.163469,2,61474754,61474904,150,audio/Bl122_61474754.jpg,Bl122
1540,2113.554183,2113.747183,1,63406625,63412415,5790,audio/Bl122_63406625.jpg,Bl122
1541,2181.689183,2181.694183,2,65450675,65450825,150,audio/Bl122_65450675.jpg,Bl122
1542,1977.760779,1977.783779,2,59332823,59333513,690,audio/Bl122_59332823.jpg,Bl122
1543,630.167417,630.220417,1,18905022,18906612,1590,audio/Or61_18905022.jpg,Or61
1544,15059.837966,15059.873966,1,451795138,451796218,1080,audio/Ti81_451795138.jpg,Ti81
1545,2170.497183,2170.511183,2,65114915,65115335,420,audio/Bl122_65114915.jpg,Bl122
1546,536.510416,536.533416,1,16095312,16096002,690,audio/Or61_16095312.jpg,Or61
1547,15308.678373,15308.746373,1,459260351,459262391,2040,audio/Ti81_459260351.jpg,Ti81
1548,1791.121115,1791.191115,1,53733633,53735733,2100,audio/Bl122_53733633.jpg,Bl122
1549,806.834882,807.059882,1,24205046,24211796,6750,audio/Or61_24205046.jpg,Or61
1550,15303.613373,15303.644373,1,459108401,459109331,930,audio/Ti81_459108401.jpg,Ti81
1551,1942.445779,1942.477779,1,58273373,58274333,960,audio/Bl122_58273373.jpg,Bl122
1552,2083.878961,2083.897961,1,62516368,62516938,570,audio/Bl122_62516368.jpg,Bl122
1553,15090.4169,15090.5039,1,452712507,452715117,2610,audio/Ti81_452712507.jpg,Ti81
1554,487.436221,487.440221,2,14623086,14623206,120,audio/Or61_14623086.jpg,Or61
1555,1944.317779,1944.363779,1,58329533,58330913,1380,audio/Bl122_58329533.jpg,Bl122
1556,8999.746445,8999.781445,1,269992393,269993443,1050,audio/Li145_269992393.jpg,Li145
1557,602.048417,602.193417,1,18061452,18065802,4350,audio/Or61_18061452.jpg,Or61
1558,568.655467,568.698467,1,17059664,17060954,1290,audio/Or61_17059664.jpg,Or61
1559,2039.563815,2039.583815,1,61186914,61187514,600,audio/Li145_61186914.jpg,Li145
1560,814.697882,814.798882,1,24440936,24443966,3030,audio/Or61_24440936.jpg,Or61
1561,1998.035779,1998.042779,2,59941073,59941283,210,audio/Bl122_59941073.jpg,Bl122
1562,626.532417,626.551417,2,18795972,18796542,570,audio/Or61_18795972.jpg,Or61
1563,15296.841664,15297.015664,1,458905249,458910469,5220,audio/Ti81_458905249.jpg,Ti81
1564,208.561642,208.829642,1,6256849,6264889,8040,audio/Or61_6256849.jpg,Or61
1565,2208.039183,2208.053183,2,66241175,66241595,420,audio/Bl122_66241175.jpg,Bl122
1566,563.242416,563.250416,2,16897272,16897512,240,audio/Or61_16897272.jpg,Or61
1567,2067.306469,2067.352469,1,62019194,62020574,1380,audio/Bl122_62019194.jpg,Bl122
1568,2006.150779,2006.235779,2,60184523,60187073,2550,audio/Bl122_60184523.jpg,Bl122
1569,5887.752515,5887.771515,1,176632575,176633145,570,audio/Li145_176632575.jpg,Li145
1570,710.153271,710.299271,1,21304598,21308978,4380,audio/Or61_21304598.jpg,Or61
1571,1956.283779,1956.341779,1,58688513,58690253,1740,audio/Bl122_58688513.jpg,Bl122
1572,2165.048183,2165.081183,2,64951445,64952435,990,audio/Bl122_64951445.jpg,Bl122
1573,2125.291183,2125.297183,2,63758735,63758915,180,audio/Bl122_63758735.jpg,Bl122
1574,2008.478779,2008.483779,2,60254363,60254513,150,audio/Bl122_60254363.jpg,Bl122
1575,2210.563183,2210.682183,2,66316895,66320465,3570,audio/Bl122_66316895.jpg,Bl122
1576,2202.836183,2202.839183,2,66085085,66085175,90,audio/Bl122_66085085.jpg,Bl122
1577,2129.975183,2129.988183,2,63899255,63899645,390,audio/Bl122_63899255.jpg,Bl122
1578,2112.357183,2112.378183,1,63370715,63371345,630,audio/Bl122_63370715.jpg,Bl122
1579,541.600416,541.628416,1,16248012,16248852,840,audio/Or61_16248012.jpg,Or61
1580,568.464467,568.467467,2,17053934,17054024,90,audio/Or61_17053934.jpg,Or61
1581,2217.173183,2217.183183,2,66515195,66515495,300,audio/Bl122_66515195.jpg,Bl122
1582,15033.662014,15033.737955,1,451009860,451012138,2278,audio/Ti81_451009860.jpg,Ti81
1583,580.55471,580.62671,1,17416641,17418801,2160,audio/Or61_17416641.jpg,Or61
1584,2003.582779,2003.588779,2,60107483,60107663,180,audio/Bl122_60107483.jpg,Bl122
1585,497.770221,497.890221,1,14933106,14936706,3600,audio/Or61_14933106.jpg,Or61
1586,475.709221,475.751221,2,14271276,14272536,1260,audio/Or61_14271276.jpg,Or61
1587,15217.73458,15217.82458,1,456532037,456534737,2700,audio/Ti81_456532037.jpg,Ti81
1588,541.515416,541.545416,1,16245462,16246362,900,audio/Or61_16245462.jpg,Or61
1589,919.640172,919.80984,1,27589205,27594295,5090,audio/Ti81_27589205.jpg,Ti81
1590,3415.966848,3416.019065,1,102479005,102480571,1566,audio/Ti81_102479005.jpg,Ti81
1591,401.796692,401.959692,1,12053900,12058790,4890,audio/Or61_12053900.jpg,Or61
1592,2083.708961,2083.750961,2,62511268,62512528,1260,audio/Bl122_62511268.jpg,Bl122
1593,923.138629,923.377805,1,27694158,27701334,7176,audio/Ti81_27694158.jpg,Ti81
1594,2083.482961,2083.493961,2,62504488,62504818,330,audio/Bl122_62504488.jpg,Bl122
1595,15328.899625,15328.954625,1,459866988,459868638,1650,audio/Ti81_459866988.jpg,Ti81
1596,2151.662183,2151.670183,2,64549865,64550105,240,audio/Bl122_64549865.jpg,Bl122
1597,3452.050422,3452.086248,1,103561512,103562587,1075,audio/Ti81_103561512.jpg,Ti81
1598,1979.243779,1979.248779,2,59377313,59377463,150,audio/Bl122_59377313.jpg,Bl122
1599,2052.374469,2052.414469,1,61571234,61572434,1200,audio/Bl122_61571234.jpg,Bl122
1600,15204.69758,15204.73458,1,456140927,456142037,1110,audio/Ti81_456140927.jpg,Ti81
1601,5843.549404,5843.604404,1,175306482,175308132,1650,audio/Li145_175306482.jpg,Li145
1602,15148.120716,15148.246716,1,454443621,454447401,3780,audio/Ti81_454443621.jpg,Ti81
1603,2202.143183,2202.168183,2,66064295,66065045,750,audio/Bl122_66064295.jpg,Bl122
1604,470.831221,470.852221,2,14124936,14125566,630,audio/Or61_14124936.jpg,Or61
1605,2060.050469,2060.080469,1,61801514,61802414,900,audio/Bl122_61801514.jpg,Bl122
1606,6301.400561,6301.643561,1,189042016,189049306,7290,audio/Li145_189042016.jpg,Li145
1607,15211.32458,15211.61458,1,456339737,456348437,8700,audio/Ti81_456339737.jpg,Ti81
1608,762.475271,762.502271,1,22874258,22875068,810,audio/Or61_22874258.jpg,Or61
1609,2170.802183,2170.883183,2,65124065,65126495,2430,audio/Bl122_65124065.jpg,Bl122
1610,744.632271,744.717271,1,22338968,22341518,2550,audio/Or61_22338968.jpg,Or61
1611,2165.097183,2165.115183,2,64952915,64953455,540,audio/Bl122_64952915.jpg,Bl122
1612,616.656417,616.743417,1,18499692,18502302,2610,audio/Or61_18499692.jpg,Or61
1613,3413.199039,3413.374132,1,102395971,102401223,5252,audio/Ti81_102395971.jpg,Ti81
1614,2068.051469,2068.128469,1,62041544,62043854,2310,audio/Bl122_62041544.jpg,Bl122
1615,2141.005183,2141.050183,2,64230155,64231505,1350,audio/Bl122_64230155.jpg,Bl122
1616,607.232417,607.238417,2,18216972,18217152,180,audio/Or61_18216972.jpg,Or61
1617,2168.749183,2168.915183,1,65062475,65067455,4980,audio/Bl122_65062475.jpg,Bl122
1618,385.644161,385.767161,1,11569324,11573014,3690,audio/Or61_11569324.jpg,Or61
1619,2134.868183,2134.871183,2,64046045,64046135,90,audio/Bl122_64046045.jpg,Bl122
1620,482.784221,482.800221,2,14483526,14484006,480,audio/Or61_14483526.jpg,Or61
1621,1800.031115,1800.057115,1,54000933,54001713,780,audio/Bl122_54000933.jpg,Bl122
1622,7546.053781,7546.071781,1,226381613,226382153,540,audio/Li145_226381613.jpg,Li145
1623,9134.766751,9134.773751,1,274043002,274043212,210,audio/Li145_274043002.jpg,Li145
1624,2114.337183,2114.389183,1,63430115,63431675,1560,audio/Bl122_63430115.jpg,Bl122
1625,1794.433115,1794.527115,1,53832993,53835813,2820,audio/Bl122_53832993.jpg,Bl122
1626,1801.146115,1801.151115,2,54034383,54034533,150,audio/Bl122_54034383.jpg,Bl122
1627,1782.056323,1782.121323,1,53461689,53463639,1950,audio/Bl122_53461689.jpg,Bl122
1628,491.055221,491.060221,2,14731656,14731806,150,audio/Or61_14731656.jpg,Or61
1629,2010.868959,2010.950959,1,60326068,60328528,2460,audio/Bl122_60326068.jpg,Bl122
1630,15343.439971,15343.477971,1,460303199,460304339,1140,audio/Ti81_460303199.jpg,Ti81
1631,2209.288183,2209.294183,2,66278645,66278825,180,audio/Bl122_66278645.jpg,Bl122
1632,2056.889469,2056.897469,1,61706684,61706924,240,audio/Bl122_61706684.jpg,Bl122
1633,2120.551183,2120.566183,1,63616535,63616985,450,audio/Bl122_63616535.jpg,Bl122
1634,761.179271,761.255271,1,22835378,22837658,2280,audio/Or61_22835378.jpg,Or61
1635,1808.910926,1808.960926,1,54267327,54268827,1500,audio/Bl122_54267327.jpg,Bl122
1636,2092.076961,2092.104961,2,62762308,62763148,840,audio/Bl122_62762308.jpg,Bl122
1637,15041.459589,15041.568581,1,451243787,451247057,3270,audio/Ti81_451243787.jpg,Ti81
1638,2233.808183,2233.919183,1,67014245,67017575,3330,audio/Bl122_67014245.jpg,Bl122
1639,2111.477183,2111.525183,1,63344315,63345755,1440,audio/Bl122_63344315.jpg,Bl122
1640,495.740221,495.787221,2,14872206,14873616,1410,audio/Or61_14872206.jpg,Or61
1641,2007.349779,2007.360779,2,60220493,60220823,330,audio/Bl122_60220493.jpg,Bl122
1642,607.245417,607.278417,1,18217362,18218352,990,audio/Or61_18217362.jpg,Or61
1643,3421.488842,3421.741655,1,102644665,102652249,7584,audio/Ti81_102644665.jpg,Ti81
1644,2040.683815,2040.695815,1,61220514,61220874,360,audio/Li145_61220514.jpg,Li145
1645,2051.242469,2051.325469,1,61537274,61539764,2490,audio/Bl122_61537274.jpg,Bl122
1646,2130.200183,2130.202183,2,63906005,63906065,60,audio/Bl122_63906005.jpg,Bl122
1647,2159.529183,2159.534183,2,64785875,64786025,150,audio/Bl122_64785875.jpg,Bl122
1648,1939.448779,1939.495779,2,58183463,58184873,1410,audio/Bl122_58183463.jpg,Bl122
1649,2170.310183,2170.313183,2,65109305,65109395,90,audio/Bl122_65109305.jpg,Bl122
1650,389.926161,390.115161,1,11697784,11703454,5670,audio/Or61_11697784.jpg,Or61
1651,1968.095779,1968.101779,2,59042873,59043053,180,audio/Bl122_59042873.jpg,Bl122
1652,1808.107926,1808.147926,1,54243237,54244437,1200,audio/Bl122_54243237.jpg,Bl122
1653,2192.694183,2192.751183,1,65780825,65782535,1710,audio/Bl122_65780825.jpg,Bl122
1654,2059.012469,2059.023469,2,61770374,61770704,330,audio/Bl122_61770374.jpg,Bl122
1655,2100.886961,2100.891961,2,63026608,63026758,150,audio/Bl122_63026608.jpg,Bl122
1656,1790.120115,1790.275115,1,53703603,53708253,4650,audio/Bl122_53703603.jpg,Bl122
1657,2142.492183,2142.737183,1,64274765,64282115,7350,audio/Bl122_64274765.jpg,Bl122
1658,2006.558779,2006.649779,2,60196763,60199493,2730,audio/Bl122_60196763.jpg,Bl122
1659,3446.128476,3446.163734,1,103383854,103384912,1058,audio/Ti81_103383854.jpg,Ti81
1660,494.378221,494.409221,2,14831346,14832276,930,audio/Or61_14831346.jpg,Or61
1661,2058.583469,2058.596469,1,61757504,61757894,390,audio/Bl122_61757504.jpg,Bl122
1662,8083.828803,8083.849803,1,242514864,242515494,630,audio/Li145_242514864.jpg,Li145
1663,481.456221,481.729221,1,14443686,14451876,8190,audio/Or61_14443686.jpg,Or61
1664,1949.090779,1949.133779,2,58472723,58474013,1290,audio/Bl122_58472723.jpg,Bl122
1665,702.601271,702.612271,2,21078038,21078368,330,audio/Or61_21078038.jpg,Or61
1666,2205.465183,2205.721183,1,66163955,66171635,7680,audio/Bl122_66163955.jpg,Bl122
1667,612.299417,612.562417,1,18368982,18376872,7890,audio/Or61_18368982.jpg,Or61
1668,2058.923469,2058.931469,2,61767704,61767944,240,audio/Bl122_61767704.jpg,Bl122
1669,8083.000803,8083.058803,1,242490024,242491764,1740,audio/Li145_242490024.jpg,Li145
1670,412.251165,412.436165,1,12367534,12373084,5550,audio/Or61_12367534.jpg,Or61
1671,15047.544235,15047.555359,1,451426327,451426660,333,audio/Ti81_451426327.jpg,Ti81
1672,15138.667989,15138.744989,1,454160039,454162349,2310,audio/Ti81_454160039.jpg,Ti81
1673,1960.677779,1960.680779,2,58820333,58820423,90,audio/Bl122_58820333.jpg,Bl122
1674,754.051271,754.074271,1,22621538,22622228,690,audio/Or61_22621538.jpg,Or61
1675,15135.275989,15135.473989,1,454058279,454064219,5940,audio/Ti81_454058279.jpg,Ti81
1676,15036.30973,15036.351359,1,451089291,451090540,1249,audio/Ti81_451089291.jpg,Ti81
1677,2085.008961,2085.031961,1,62550268,62550958,690,audio/Bl122_62550268.jpg,Bl122
1678,187.448971,187.470971,1,5623469,5624129,660,audio/Or61_5623469.jpg,Or61
1679,767.206271,767.376271,1,23016188,23021288,5100,audio/Or61_23016188.jpg,Or61
1680,2093.780961,2093.789961,2,62813428,62813698,270,audio/Bl122_62813428.jpg,Bl122
1681,2178.238183,2178.449183,1,65347145,65353475,6330,audio/Bl122_65347145.jpg,Bl122
1682,771.617271,771.636271,2,23148518,23149088,570,audio/Or61_23148518.jpg,Or61
1683,2005.840779,2005.998779,1,60175223,60179963,4740,audio/Bl122_60175223.jpg,Bl122
1684,223.141983,223.356983,1,6694259,6700709,6450,audio/Or61_6694259.jpg,Or61
1685,3411.034216,3411.193919,1,102331026,102335817,4791,audio/Ti81_102331026.jpg,Ti81
1686,15089.7479,15089.8349,1,452692437,452695047,2610,audio/Ti81_452692437.jpg,Ti81
1687,2056.903469,2056.912469,1,61707104,61707374,270,audio/Bl122_61707104.jpg,Bl122
1688,1793.919115,1793.959115,1,53817573,53818773,1200,audio/Bl122_53817573.jpg,Bl122
1689,482.148221,482.175221,1,14464446,14465256,810,audio/Or61_14464446.jpg,Or61
1690,602.758417,602.761417,2,18082752,18082842,90,audio/Or61_18082752.jpg,Or61
1691,1943.141779,1943.231779,1,58294253,58296953,2700,audio/Bl122_58294253.jpg,Bl122
1692,1949.282779,1949.288779,2,58478483,58478663,180,audio/Bl122_58478483.jpg,Bl122
1693,564.090416,564.112416,2,16922712,16923372,660,audio/Or61_16922712.jpg,Or61
1694,762.996271,762.999271,2,22889888,22889978,90,audio/Or61_22889888.jpg,Or61
1695,441.651265,441.692265,1,13249537,13250767,1230,audio/Or61_13249537.jpg,Or61
1696,15103.336256,15103.533256,1,453100087,453105997,5910,audio/Ti81_453100087.jpg,Ti81
1697,2062.944469,2062.971469,2,61888334,61889144,810,audio/Bl122_61888334.jpg,Bl122
1698,1949.306779,1949.325779,1,58479203,58479773,570,audio/Bl122_58479203.jpg,Bl122
1699,527.991416,528.039416,2,15839742,15841182,1440,audio/Or61_15839742.jpg,Or61
1700,294.076896,294.130896,1,8822306,8823926,1620,audio/Or61_8822306.jpg,Or61
1701,3448.125206,3448.173143,1,103443756,103445194,1438,audio/Ti81_103443756.jpg,Ti81
1702,6334.561902,6334.566902,1,190036857,190037007,150,audio/Li145_190036857.jpg,Li145
1703,2117.012183,2117.078183,1,63510365,63512345,1980,audio/Bl122_63510365.jpg,Bl122
1704,546.299416,546.318416,1,16388982,16389552,570,audio/Or61_16388982.jpg,Or61
1705,2094.636961,2094.683961,1,62839108,62840518,1410,audio/Bl122_62839108.jpg,Bl122
1706,2178.812183,2178.852183,2,65364365,65365565,1200,audio/Bl122_65364365.jpg,Bl122
1707,3628.518671,3628.549671,1,108855560,108856490,930,audio/Li145_108855560.jpg,Li145
1708,533.329552,533.509552,1,15999886,16005286,5400,audio/Li145_15999886.jpg,Li145
1709,15315.034428,15315.101428,1,459451032,459453042,2010,audio/Ti81_459451032.jpg,Ti81
1710,542.067416,542.122416,1,16262022,16263672,1650,audio/Or61_16262022.jpg,Or61
1711,2161.969183,2161.982183,2,64859075,64859465,390,audio/Bl122_64859075.jpg,Bl122
1712,1938.292779,1938.302779,2,58148783,58149083,300,audio/Bl122_58148783.jpg,Bl122
1713,15051.652966,15051.838966,1,451549588,451555168,5580,audio/Ti81_451549588.jpg,Ti81
1714,3469.13153,3469.601179,1,104073945,104088035,14090,audio/Ti81_104073945.jpg,Ti81
1715,1934.675613,1934.691613,2,58040268,58040748,480,audio/Bl122_58040268.jpg,Bl122
1716,500.400221,500.423221,1,15012006,15012696,690,audio/Or61_15012006.jpg,Or61
1717,2132.114183,2132.127183,2,63963425,63963815,390,audio/Bl122_63963425.jpg,Bl122
1718,2107.323377,2107.331377,1,63219701,63219941,240,audio/Bl122_63219701.jpg,Bl122
1719,2165.713183,2165.996183,1,64971395,64979885,8490,audio/Bl122_64971395.jpg,Bl122
1720,2191.666183,2191.669183,2,65749985,65750075,90,audio/Bl122_65749985.jpg,Bl122
1721,15040.324006,15040.505659,1,451209720,451215169,5449,audio/Ti81_451209720.jpg,Ti81
1722,760.573271,760.652271,1,22817198,22819568,2370,audio/Or61_22817198.jpg,Or61
1723,15165.534257,15165.603257,1,454966027,454968097,2070,audio/Ti81_454966027.jpg,Ti81
1724,621.741417,621.795417,1,18652242,18653862,1620,audio/Or61_18652242.jpg,Or61
1725,2159.316183,2159.353183,1,64779485,64780595,1110,audio/Bl122_64779485.jpg,Bl122
1726,1967.508779,1967.528779,1,59025263,59025863,600,audio/Bl122_59025263.jpg,Bl122
1727,2059.994469,2060.004469,1,61799834,61800134,300,audio/Bl122_61799834.jpg,Bl122
1728,766.457271,766.520271,1,22993718,22995608,1890,audio/Or61_22993718.jpg,Or61
1729,2199.578183,2199.584183,2,65987345,65987525,180,audio/Bl122_65987345.jpg,Bl122
1730,328.796967,329.009967,1,9863909,9870299,6390,audio/Or61_9863909.jpg,Or61
1731,15150.656716,15150.872716,1,454519701,454526181,6480,audio/Ti81_454519701.jpg,Ti81
1732,805.180882,805.227882,1,24155426,24156836,1410,audio/Or61_24155426.jpg,Or61
1733,714.436271,714.453271,1,21433088,21433598,510,audio/Or61_21433088.jpg,Or61
1734,197.157012,197.177012,1,5914710,5915310,600,audio/Or61_5914710.jpg,Or61
1735,186.344971,186.352971,2,5590349,5590589,240,audio/Or61_5590349.jpg,Or61
1736,2207.609183,2207.617183,2,66228275,66228515,240,audio/Bl122_66228275.jpg,Bl122
1737,456.229826,456.293826,1,13686894,13688814,1920,audio/Or61_13686894.jpg,Or61
1738,728.499271,728.514271,1,21854978,21855428,450,audio/Or61_21854978.jpg,Or61
1739,2232.725183,2232.728183,2,66981755,66981845,90,audio/Bl122_66981755.jpg,Bl122
1740,2189.049183,2189.078183,2,65671475,65672345,870,audio/Bl122_65671475.jpg,Bl122
1741,1800.334115,1800.498115,2,54010023,54014943,4920,audio/Bl122_54010023.jpg,Bl122
1742,531.680416,531.701416,1,15950412,15951042,630,audio/Or61_15950412.jpg,Or61
1743,15218.67158,15218.72858,1,456560147,456561857,1710,audio/Ti81_456560147.jpg,Ti81
1744,8829.694654,8829.711654,1,264890839,264891349,510,audio/Li145_264890839.jpg,Li145
1745,537.752416,537.807416,1,16132572,16134222,1650,audio/Or61_16132572.jpg,Or61
1746,1939.668779,1939.695779,2,58190063,58190873,810,audio/Bl122_58190063.jpg,Bl122
1747,7550.989715,7551.000715,1,226529691,226530021,330,audio/Li145_226529691.jpg,Li145
1748,6333.987902,6334.010902,1,190019637,190020327,690,audio/Li145_190019637.jpg,Li145
1749,14771.689705,14771.854202,1,443150691,443155626,4935,audio/Ti81_443150691.jpg,Ti81
1750,1955.871779,1955.924779,1,58676153,58677743,1590,audio/Bl122_58676153.jpg,Bl122
1751,1765.649264,1765.883264,1,52969477,52976497,7020,audio/Bl122_52969477.jpg,Bl122
1752,546.354416,546.385416,1,16390632,16391562,930,audio/Or61_16390632.jpg,Or61
1753,2071.112469,2071.117469,2,62133374,62133524,150,audio/Bl122_62133374.jpg,Bl122
1754,2063.472469,2063.624469,1,61904174,61908734,4560,audio/Bl122_61904174.jpg,Bl122
1755,541.338416,541.362416,1,16240152,16240872,720,audio/Or61_16240152.jpg,Or61
1756,565.252416,565.271416,1,16957572,16958142,570,audio/Or61_16957572.jpg,Or61
1757,618.840417,618.875417,1,18565212,18566262,1050,audio/Or61_18565212.jpg,Or61
1758,15029.052194,15029.104419,1,450871565,450873132,1567,audio/Ti81_450871565.jpg,Ti81
1759,471.620221,471.629221,2,14148606,14148876,270,audio/Or61_14148606.jpg,Or61
1760,535.352416,535.435416,1,16060572,16063062,2490,audio/Or61_16060572.jpg,Or61
1761,15239.910874,15240.078874,1,457197326,457202366,5040,audio/Ti81_457197326.jpg,Ti81
1762,7566.314558,7566.321558,2,226989436,226989646,210,audio/Li145_226989436.jpg,Li145
1763,15089.6589,15089.734781,1,452689767,452692043,2276,audio/Ti81_452689767.jpg,Ti81
1764,612.859417,612.862417,2,18385782,18385872,90,audio/Or61_18385782.jpg,Or61
1765,6332.547902,6332.556902,2,189976437,189976707,270,audio/Li145_189976437.jpg,Li145
1766,2208.958183,2209.244183,1,66268745,66277325,8580,audio/Bl122_66268745.jpg,Bl122
1767,2065.443469,2065.736469,1,61963304,61972094,8790,audio/Bl122_61963304.jpg,Bl122
1768,506.336221,506.423221,1,15190086,15192696,2610,audio/Or61_15190086.jpg,Or61
1769,3419.485363,3419.51917,1,102584560,102585575,1015,audio/Ti81_102584560.jpg,Ti81
1770,614.390417,614.417417,2,18431712,18432522,810,audio/Or61_18431712.jpg,Or61
1771,2184.199183,2184.205183,2,65525975,65526155,180,audio/Bl122_65525975.jpg,Bl122
1772,5705.934085,5705.987085,1,171178022,171179612,1590,audio/Li145_171178022.jpg,Li145
1773,2138.789183,2138.797183,2,64163675,64163915,240,audio/Bl122_64163675.jpg,Bl122
1774,2035.210469,2035.231469,2,61056314,61056944,630,audio/Bl122_61056314.jpg,Bl122
1775,1943.872779,1943.876779,2,58316183,58316303,120,audio/Bl122_58316183.jpg,Bl122
1776,2107.882377,2107.930377,1,63236471,63237911,1440,audio/Bl122_63236471.jpg,Bl122
1777,1972.148779,1972.165779,2,59164463,59164973,510,audio/Bl122_59164463.jpg,Bl122
1778,2139.164183,2139.181183,2,64174925,64175435,510,audio/Bl122_64174925.jpg,Bl122
1779,1942.181779,1942.220779,1,58265453,58266623,1170,audio/Bl122_58265453.jpg,Bl122
1780,3466.281157,3466.349845,1,103988434,103990495,2061,audio/Ti81_103988434.jpg,Ti81
1781,1960.374779,1960.408779,1,58811243,58812263,1020,audio/Bl122_58811243.jpg,Bl122
1782,1944.587779,1944.597779,1,58337633,58337933,300,audio/Bl122_58337633.jpg,Bl122
1783,2198.943183,2198.968183,1,65968295,65969045,750,audio/Bl122_65968295.jpg,Bl122
1784,2185.808183,2185.813183,2,65574245,65574395,150,audio/Bl122_65574245.jpg,Bl122
1785,1944.411779,1944.431779,1,58332353,58332953,600,audio/Bl122_58332353.jpg,Bl122
1786,748.768271,748.854271,1,22463048,22465628,2580,audio/Or61_22463048.jpg,Or61
1787,1967.864779,1967.901779,1,59035943,59037053,1110,audio/Bl122_59035943.jpg,Bl122
1788,479.239221,479.269221,1,14377176,14378076,900,audio/Or61_14377176.jpg,Or61
1789,2115.116183,2115.234183,1,63453485,63457025,3540,audio/Bl122_63453485.jpg,Bl122
1790,528.576416,528.587416,2,15857292,15857622,330,audio/Or61_15857292.jpg,Or61
1791,2159.355183,2159.395183,1,64780655,64781855,1200,audio/Bl122_64780655.jpg,Bl122
1792,495.447221,495.721221,1,14863416,14871636,8220,audio/Or61_14863416.jpg,Or61
1793,603.016417,603.026417,2,18090492,18090792,300,audio/Or61_18090492.jpg,Or61
1794,2195.351183,2195.356183,2,65860535,65860685,150,audio/Bl122_65860535.jpg,Bl122
1795,1992.165779,1992.205779,1,59764973,59766173,1200,audio/Bl122_59764973.jpg,Bl122
1796,1957.615779,1957.620779,2,58728473,58728623,150,audio/Bl122_58728473.jpg,Bl122
1797,2089.979961,2089.987961,1,62699398,62699638,240,audio/Bl122_62699398.jpg,Bl122
1798,15079.302682,15079.336682,1,452379080,452380100,1020,audio/Ti81_452379080.jpg,Ti81
1799,2008.728779,2008.813779,1,60261863,60264413,2550,audio/Bl122_60261863.jpg,Bl122
1800,1793.106115,1793.109115,2,53793183,53793273,90,audio/Bl122_53793183.jpg,Bl122
1801,493.676221,493.697221,1,14810286,14810916,630,audio/Or61_14810286.jpg,Or61
1802,14900.273816,14900.526238,1,447008214,447015787,7573,audio/Ti81_447008214.jpg,Ti81
1803,1782.600323,1782.685323,1,53478009,53480559,2550,audio/Bl122_53478009.jpg,Bl122
1804,1768.232657,1768.288657,1,53046979,53048659,1680,audio/Bl122_53046979.jpg,Bl122
1805,2055.627469,2055.700469,1,61668824,61671014,2190,audio/Bl122_61668824.jpg,Bl122
1806,1998.051779,1998.056779,2,59941553,59941703,150,audio/Bl122_59941553.jpg,Bl122
1807,2053.886469,2053.922469,2,61616594,61617674,1080,audio/Bl122_61616594.jpg,Bl122
1808,3424.007005,3424.065538,1,102720210,102721966,1756,audio/Ti81_102720210.jpg,Ti81
1809,1959.177779,1959.192779,1,58775333,58775783,450,audio/Bl122_58775333.jpg,Bl122
1810,609.742417,609.748417,2,18292272,18292452,180,audio/Or61_18292272.jpg,Or61
1811,6949.554842,6949.557842,2,208486645,208486735,90,audio/Li145_208486645.jpg,Li145
1812,620.723417,620.902417,1,18621702,18627072,5370,audio/Or61_18621702.jpg,Or61
1813,495.294221,495.430221,1,14858826,14862906,4080,audio/Or61_14858826.jpg,Or61
1814,2199.097183,2199.123183,2,65972915,65973695,780,audio/Bl122_65972915.jpg,Bl122
1815,14767.400743,14767.574007,1,443022022,443027220,5198,audio/Ti81_443022022.jpg,Ti81
1816,2092.503961,2092.555961,1,62775118,62776678,1560,audio/Bl122_62775118.jpg,Bl122
1817,2082.552961,2082.560961,2,62476588,62476828,240,audio/Bl122_62476588.jpg,Bl122
1818,709.875271,709.938271,1,21296258,21298148,1890,audio/Or61_21296258.jpg,Or61
1819,8097.802141,8097.819141,1,242934064,242934574,510,audio/Li145_242934064.jpg,Li145
1820,481.012221,481.069221,2,14430366,14432076,1710,audio/Or61_14430366.jpg,Or61
1821,8740.853692,8740.868692,1,262225610,262226060,450,audio/Li145_262225610.jpg,Li145
1822,389.918161,389.921161,2,11697544,11697634,90,audio/Or61_11697544.jpg,Or61
1823,748.240271,748.393271,1,22447208,22451798,4590,audio/Or61_22447208.jpg,Or61
1824,2055.595469,2055.622469,1,61667864,61668674,810,audio/Bl122_61667864.jpg,Bl122
1825,674.231078,674.236078,2,20226932,20227082,150,audio/Or61_20226932.jpg,Or61
1826,2147.325183,2147.328183,2,64419755,64419845,90,audio/Bl122_64419755.jpg,Bl122
1827,15025.599276,15025.713169,1,450767978,450771395,3417,audio/Ti81_450767978.jpg,Ti81
1828,765.148271,765.238271,1,22954448,22957148,2700,audio/Or61_22954448.jpg,Or61
1829,8829.436654,8829.464654,1,264883099,264883939,840,audio/Li145_264883099.jpg,Li145
1830,558.971416,559.044416,1,16769142,16771332,2190,audio/Or61_16769142.jpg,Or61
1831,555.828416,555.909416,1,16674852,16677282,2430,audio/Or61_16674852.jpg,Or61
1832,734.053271,734.142271,1,22021598,22024268,2670,audio/Or61_22021598.jpg,Or61
1833,803.950882,803.994882,1,24118526,24119846,1320,audio/Or61_24118526.jpg,Or61
1834,609.475417,609.479417,2,18284262,18284382,120,audio/Or61_18284262.jpg,Or61
1835,2182.119183,2182.239183,1,65463575,65467175,3600,audio/Bl122_65463575.jpg,Bl122
1836,1963.550779,1963.560779,2,58906523,58906823,300,audio/Bl122_58906523.jpg,Bl122
1837,766.175271,766.222271,1,22985258,22986668,1410,audio/Or61_22985258.jpg,Or61
1838,754.535271,754.538271,2,22636058,22636148,90,audio/Or61_22636058.jpg,Or61
1839,762.038271,762.115271,1,22861148,22863458,2310,audio/Or61_22861148.jpg,Or61
1840,1769.013657,1769.034657,2,53070409,53071039,630,audio/Bl122_53070409.jpg,Bl122
1841,15278.294439,15278.521439,1,458348833,458355643,6810,audio/Ti81_458348833.jpg,Ti81
1842,3.535816,3.540816,2,106074,106224,150,audio/Or61_106074.jpg,Or61
1843,803.899882,803.933882,1,24116996,24118016,1020,audio/Or61_24116996.jpg,Or61
1844,501.475221,501.479221,2,15044256,15044376,120,audio/Or61_15044256.jpg,Or61
1845,1950.873779,1950.889779,2,58526213,58526693,480,audio/Bl122_58526213.jpg,Bl122
1846,15267.026214,15267.232358,1,458010786,458016970,6184,audio/Ti81_458010786.jpg,Ti81
1847,2200.866183,2201.136183,1,66025985,66034085,8100,audio/Bl122_66025985.jpg,Bl122
1848,616.019417,616.026417,2,18480582,18480792,210,audio/Or61_18480582.jpg,Or61
1849,1953.702779,1953.745779,1,58611083,58612373,1290,audio/Bl122_58611083.jpg,Bl122
1850,510.382221,510.469221,1,15311466,15314076,2610,audio/Or61_15311466.jpg,Or61
1851,3539.476158,3539.586159,1,106184284,106187584,3300,audio/Ti81_106184284.jpg,Ti81
1852,626.071417,626.116417,1,18782142,18783492,1350,audio/Or61_18782142.jpg,Or61
1853,2100.910961,2101.036961,1,63027328,63031108,3780,audio/Bl122_63027328.jpg,Bl122
1854,1958.430779,1958.478779,2,58752923,58754363,1440,audio/Bl122_58752923.jpg,Bl122
1855,528.900416,528.905416,2,15867012,15867162,150,audio/Or61_15867012.jpg,Or61
1856,2150.224183,2150.301183,2,64506725,64509035,2310,audio/Bl122_64506725.jpg,Bl122
1857,453.892219,454.048219,1,13616766,13621446,4680,audio/Or61_13616766.jpg,Or61
1858,1966.623779,1966.665779,2,58998713,58999973,1260,audio/Bl122_58998713.jpg,Bl122
1859,2195.180183,2195.189183,2,65855405,65855675,270,audio/Bl122_65855405.jpg,Bl122
1860,15164.911257,15164.954257,1,454947337,454948627,1290,audio/Ti81_454947337.jpg,Ti81
1861,2232.135183,2232.288183,1,66964055,66968645,4590,audio/Bl122_66964055.jpg,Bl122
1862,15047.720966,15047.762966,1,451431628,451432888,1260,audio/Ti81_451431628.jpg,Ti81
1863,7552.240715,7552.360715,1,226567221,226570821,3600,audio/Li145_226567221.jpg,Li145
1864,631.752417,631.771417,1,18952572,18953142,570,audio/Or61_18952572.jpg,Or61
1865,1815.260379,1815.327379,1,54457811,54459821,2010,audio/Bl122_54457811.jpg,Bl122
1866,2095.152961,2095.162961,1,62854588,62854888,300,audio/Bl122_62854588.jpg,Bl122
1867,15164.313257,15164.361257,1,454929397,454930837,1440,audio/Ti81_454929397.jpg,Ti81
1868,545.270416,545.344416,1,16358112,16360332,2220,audio/Or61_16358112.jpg,Or61
1869,1808.053926,1808.104926,1,54241617,54243147,1530,audio/Bl122_54241617.jpg,Bl122
1870,2085.036961,2085.041961,1,62551108,62551258,150,audio/Bl122_62551108.jpg,Bl122
1871,729.776271,729.791271,1,21893288,21893738,450,audio/Or61_21893288.jpg,Or61
1872,2175.530183,2175.556183,2,65265905,65266685,780,audio/Bl122_65265905.jpg,Bl122
1873,637.834417,637.887417,1,19135032,19136622,1590,audio/Or61_19135032.jpg,Or61
1874,492.783221,492.786221,2,14783496,14783586,90,audio/Or61_14783496.jpg,Or61
1875,620.249417,620.270417,2,18607482,18608112,630,audio/Or61_18607482.jpg,Or61
1876,2231.232183,2231.235183,2,66936965,66937055,90,audio/Bl122_66936965.jpg,Bl122
1877,398.063529,398.111529,1,11941905,11943345,1440,audio/Or61_11941905.jpg,Or61
1878,15177.506145,15177.603145,1,455325184,455328094,2910,audio/Ti81_455325184.jpg,Ti81
1879,9167.618583,9167.723583,1,275028557,275031707,3150,audio/Li145_275028557.jpg,Li145
1880,2040.709815,2040.719815,1,61221294,61221594,300,audio/Li145_61221294.jpg,Li145
1881,2202.015183,2202.095183,2,66060455,66062855,2400,audio/Bl122_66060455.jpg,Bl122
1882,1976.277779,1976.283779,2,59288333,59288513,180,audio/Bl122_59288333.jpg,Bl122
1883,810.198882,810.295882,1,24305966,24308876,2910,audio/Or61_24305966.jpg,Or61
1884,6439.474463,6439.644321,1,193184233,193189329,5096,audio/Ti81_193184233.jpg,Ti81
1885,264.977507,264.980507,2,7949325,7949415,90,audio/Or61_7949325.jpg,Or61
1886,553.263416,553.402416,1,16597902,16602072,4170,audio/Or61_16597902.jpg,Or61
1887,15096.776823,15096.794117,1,452903304,452903823,519,audio/Ti81_452903304.jpg,Ti81
1888,490.404221,490.424221,1,14712126,14712726,600,audio/Or61_14712126.jpg,Or61
1889,1939.364779,1939.368779,2,58180943,58181063,120,audio/Bl122_58180943.jpg,Bl122
1890,15087.7849,15088.0409,1,452633547,452641227,7680,audio/Ti81_452633547.jpg,Ti81
1891,549.715416,549.776416,1,16491462,16493292,1830,audio/Or61_16491462.jpg,Or61
1892,754.374271,754.434271,1,22631228,22633028,1800,audio/Or61_22631228.jpg,Or61
1893,2231.794183,2231.885183,1,66953825,66956555,2730,audio/Bl122_66953825.jpg,Bl122
1894,488.515221,488.530221,2,14655456,14655906,450,audio/Or61_14655456.jpg,Or61
1895,536.545416,536.565416,1,16096362,16096962,600,audio/Or61_16096362.jpg,Or61
1896,789.755827,789.770827,2,23692674,23693124,450,audio/Or61_23692674.jpg,Or61
1897,609.794417,610.036417,1,18293832,18301092,7260,audio/Or61_18293832.jpg,Or61
1898,2142.022183,2142.029183,2,64260665,64260875,210,audio/Bl122_64260665.jpg,Bl122
1899,6420.005061,6420.213205,1,192600151,192606396,6245,audio/Ti81_192600151.jpg,Ti81
1900,2059.402469,2059.452469,2,61782074,61783574,1500,audio/Bl122_61782074.jpg,Bl122
1901,711.964271,712.112271,1,21358928,21363368,4440,audio/Or61_21358928.jpg,Or61
1902,543.305416,543.308416,2,16299162,16299252,90,audio/Or61_16299162.jpg,Or61
1903,15243.835874,15243.907874,1,457315076,457317236,2160,audio/Ti81_457315076.jpg,Ti81
1904,716.716271,716.724271,1,21501488,21501728,240,audio/Or61_21501488.jpg,Or61
1905,759.274271,759.280271,2,22778228,22778408,180,audio/Or61_22778228.jpg,Or61
1906,793.478827,793.482827,2,23804364,23804484,120,audio/Or61_23804364.jpg,Or61
1907,612.050417,612.071417,1,18361512,18362142,630,audio/Or61_18361512.jpg,Or61
1908,2043.028469,2043.187469,1,61290854,61295624,4770,audio/Bl122_61290854.jpg,Bl122
1909,1979.862779,1979.885779,1,59395883,59396573,690,audio/Bl122_59395883.jpg,Bl122
1910,15097.865823,15097.910823,1,452935974,452937324,1350,audio/Ti81_452935974.jpg,Ti81
1911,2149.035183,2149.059183,2,64471055,64471775,720,audio/Bl122_64471055.jpg,Bl122
1912,2084.684961,2084.738961,1,62540548,62542168,1620,audio/Bl122_62540548.jpg,Bl122
1913,3427.958712,3428.187796,1,102838761,102845633,6872,audio/Ti81_102838761.jpg,Ti81
1914,792.543827,792.586827,1,23776314,23777604,1290,audio/Or61_23776314.jpg,Or61
1915,2147.142183,2147.313183,1,64414265,64419395,5130,audio/Bl122_64414265.jpg,Bl122
1916,184.212971,184.235971,1,5526389,5527079,690,audio/Or61_5526389.jpg,Or61
1917,209.285642,209.417642,1,6278569,6282529,3960,audio/Or61_6278569.jpg,Or61
1918,15346.168971,15346.500971,1,460385069,460395029,9960,audio/Ti81_460385069.jpg,Ti81
1919,1985.431779,1985.440779,2,59562953,59563223,270,audio/Bl122_59562953.jpg,Bl122
1920,619.899417,620.129417,1,18596982,18603882,6900,audio/Or61_18596982.jpg,Or61
1921,2049.802469,2049.897469,1,61494074,61496924,2850,audio/Bl122_61494074.jpg,Bl122
1922,1783.564323,1783.753323,1,53506929,53512599,5670,audio/Bl122_53506929.jpg,Bl122
1923,7548.091781,7548.099781,1,226442753,226442993,240,audio/Li145_226442753.jpg,Li145
1924,1947.290779,1947.307779,2,58418723,58419233,510,audio/Bl122_58418723.jpg,Bl122
1925,1960.291779,1960.309779,2,58808753,58809293,540,audio/Bl122_58808753.jpg,Bl122
1926,2151.269183,2151.275183,2,64538075,64538255,180,audio/Bl122_64538075.jpg,Bl122
1927,1808.202926,1808.326926,1,54246087,54249807,3720,audio/Bl122_54246087.jpg,Bl122
1928,790.538827,790.546827,2,23716164,23716404,240,audio/Or61_23716164.jpg,Or61
1929,8097.167141,8097.202141,1,242915014,242916064,1050,audio/Li145_242915014.jpg,Li145
1930,550.667416,550.743416,1,16520022,16522302,2280,audio/Or61_16520022.jpg,Or61
1931,1983.171779,1983.205779,1,59495153,59496173,1020,audio/Bl122_59495153.jpg,Bl122
1932,470.825221,470.829221,2,14124756,14124876,120,audio/Or61_14124756.jpg,Or61
1933,720.695271,720.760271,1,21620858,21622808,1950,audio/Or61_21620858.jpg,Or61
1934,1944.599779,1944.614779,1,58337993,58338443,450,audio/Bl122_58337993.jpg,Bl122
1935,2046.761469,2046.779469,1,61402844,61403384,540,audio/Bl122_61402844.jpg,Bl122
1936,1975.170779,1975.175779,2,59255123,59255273,150,audio/Bl122_59255123.jpg,Bl122
1937,15297.892039,15297.90468,1,458936761,458937140,379,audio/Ti81_458936761.jpg,Ti81
1938,8829.193654,8829.250654,1,264875809,264877519,1710,audio/Li145_264875809.jpg,Li145
1939,5968.374227,5968.381227,1,179051226,179051436,210,audio/Li145_179051226.jpg,Li145
1940,2052.065469,2052.096469,1,61561964,61562894,930,audio/Bl122_61561964.jpg,Bl122
1941,399.447529,399.455529,2,11983425,11983665,240,audio/Or61_11983425.jpg,Or61
1942,2177.976183,2178.058183,2,65339285,65341745,2460,audio/Bl122_65339285.jpg,Bl122
1943,2054.509469,2054.515469,2,61635284,61635464,180,audio/Bl122_61635284.jpg,Bl122
1944,2004.476779,2004.483779,2,60134303,60134513,210,audio/Bl122_60134303.jpg,Bl122
1945,474.512221,474.542221,1,14235366,14236266,900,audio/Or61_14235366.jpg,Or61
1946,2218.762183,2218.799183,2,66562865,66563975,1110,audio/Bl122_66562865.jpg,Bl122
1947,15079.520682,15079.696682,1,452385620,452390900,5280,audio/Ti81_452385620.jpg,Ti81
1948,3624.581464,3624.771464,1,108737443,108743143,5700,audio/Li145_108737443.jpg,Li145
1949,751.675271,751.724271,1,22550258,22551728,1470,audio/Or61_22550258.jpg,Or61
1950,7555.684715,7555.689715,1,226670541,226670691,150,audio/Li145_226670541.jpg,Li145
1951,610.238417,610.262417,1,18307152,18307872,720,audio/Or61_18307152.jpg,Or61
1952,15109.207256,15109.419614,1,453276217,453282588,6371,audio/Ti81_453276217.jpg,Ti81
1953,15212.73058,15213.04358,1,456381917,456391307,9390,audio/Ti81_456381917.jpg,Ti81
1954,2219.116183,2219.121183,2,66573485,66573635,150,audio/Bl122_66573485.jpg,Bl122
1955,528.508416,528.573416,2,15855252,15857202,1950,audio/Or61_15855252.jpg,Or61
1956,748.160271,748.172271,1,22444808,22445168,360,audio/Or61_22444808.jpg,Or61
1957,1801.547115,1801.663115,1,54046413,54049893,3480,audio/Bl122_54046413.jpg,Bl122
1958,485.858221,485.924221,2,14575746,14577726,1980,audio/Or61_14575746.jpg,Or61
1959,15044.276091,15044.307313,1,451328282,451329219,937,audio/Ti81_451328282.jpg,Ti81
1960,2197.796183,2197.995183,1,65933885,65939855,5970,audio/Bl122_65933885.jpg,Bl122
1961,555.454416,555.721416,1,16663632,16671642,8010,audio/Or61_16663632.jpg,Or61
1962,496.818221,496.862221,2,14904546,14905866,1320,audio/Or61_14904546.jpg,Or61
1963,15028.348289,15028.371753,1,450850448,450851152,704,audio/Ti81_450850448.jpg,Ti81
1964,483.468221,483.488221,2,14504046,14504646,600,audio/Or61_14504046.jpg,Or61
1965,2217.024183,2217.044183,2,66510725,66511325,600,audio/Bl122_66510725.jpg,Bl122
1966,2145.519183,2145.629183,1,64365575,64368875,3300,audio/Bl122_64365575.jpg,Bl122
1967,1997.268779,1997.298779,1,59918063,59918963,900,audio/Bl122_59918063.jpg,Bl122
1968,2040.277815,2040.287815,1,61208334,61208634,300,audio/Li145_61208334.jpg,Li145
1969,2081.244287,2081.269287,1,62437328,62438078,750,audio/Bl122_62437328.jpg,Bl122
1970,8111.065849,8111.418849,1,243331975,243342565,10590,audio/Li145_243331975.jpg,Li145
1971,2201.825183,2201.837183,2,66054755,66055115,360,audio/Bl122_66054755.jpg,Bl122
1972,15287.997439,15288.273439,1,458639923,458648203,8280,audio/Ti81_458639923.jpg,Ti81
1973,2082.214961,2082.266961,1,62466448,62468008,1560,audio/Bl122_62466448.jpg,Bl122
1974,754.718271,754.757271,1,22641548,22642718,1170,audio/Or61_22641548.jpg,Or61
1975,773.126271,773.157271,1,23193788,23194718,930,audio/Or61_23193788.jpg,Or61
1976,2220.783183,2220.791183,2,66623495,66623735,240,audio/Bl122_66623495.jpg,Bl122
1977,1954.299779,1954.302779,2,58628993,58629083,90,audio/Bl122_58628993.jpg,Bl122
1978,1769.117657,1769.143657,1,53073529,53074309,780,audio/Bl122_53073529.jpg,Bl122
1979,7568.383558,7568.503558,1,227051506,227055106,3600,audio/Li145_227051506.jpg,Li145
1980,1970.979779,1970.983779,2,59129393,59129513,120,audio/Bl122_59129393.jpg,Bl122
1981,293.871896,294.073896,1,8816156,8822216,6060,audio/Or61_8816156.jpg,Or61
1982,15279.011439,15279.274439,1,458370343,458378233,7890,audio/Ti81_458370343.jpg,Ti81
1983,2211.001183,2211.038183,2,66330035,66331145,1110,audio/Bl122_66330035.jpg,Bl122
1984,517.367221,517.373221,2,15521016,15521196,180,audio/Or61_15521016.jpg,Or61
1985,540.764416,540.783416,1,16222932,16223502,570,audio/Or61_16222932.jpg,Or61
1986,385.856161,385.865161,2,11575684,11575954,270,audio/Or61_11575684.jpg,Or61
1987,2137.736183,2137.784183,1,64132085,64133525,1440,audio/Bl122_64132085.jpg,Bl122
1988,493.509221,493.601221,1,14805276,14808036,2760,audio/Or61_14805276.jpg,Or61
1989,633.101417,633.109417,2,18993042,18993282,240,audio/Or61_18993042.jpg,Or61
1990,15251.848074,15251.977074,1,457555442,457559312,3870,audio/Ti81_457555442.jpg,Ti81
1991,798.592827,798.606827,2,23957784,23958204,420,audio/Or61_23957784.jpg,Or61
1992,2040.359469,2040.677469,1,61210784,61220324,9540,audio/Bl122_61210784.jpg,Bl122
1993,8084.440803,8084.449803,2,242533224,242533494,270,audio/Li145_242533224.jpg,Li145
1994,534.109416,534.127416,2,16023282,16023822,540,audio/Or61_16023282.jpg,Or61
1995,2005.248779,2005.250779,2,60157463,60157523,60,audio/Bl122_60157463.jpg,Bl122
1996,184.237971,184.265971,1,5527139,5527979,840,audio/Or61_5527139.jpg,Or61
1997,15126.238981,15126.45233,1,453787169,453793569,6400,audio/Ti81_453787169.jpg,Ti81
1998,3447.53597,3447.71838,1,103426079,103431551,5472,audio/Ti81_103426079.jpg,Ti81
1999,815.472882,815.485882,2,24464186,24464576,390,audio/Or61_24464186.jpg,Or61
2000,2223.400183,2223.480183,2,66702005,66704405,2400,audio/Bl122_66702005.jpg,Bl122
2001,2148.588183,2148.978183,1,64457645,64469345,11700,audio/Bl122_64457645.jpg,Bl122
2002,15281.548439,15281.685439,1,458446453,458450563,4110,audio/Ti81_458446453.jpg,Ti81
2003,1789.963115,1789.969115,2,53698893,53699073,180,audio/Bl122_53698893.jpg,Bl122
2004,2059.695469,2059.716469,1,61790864,61791494,630,audio/Bl122_61790864.jpg,Bl122
2005,599.218417,599.282417,1,17976552,17978472,1920,audio/Or61_17976552.jpg,Or61
2006,716.158271,716.169271,1,21484748,21485078,330,audio/Or61_21484748.jpg,Or61
2007,2158.019183,2158.043183,1,64740575,64741295,720,audio/Bl122_64740575.jpg,Bl122
2008,1943.126779,1943.138779,2,58293803,58294163,360,audio/Bl122_58293803.jpg,Bl122
2009,621.611417,621.663417,1,18648342,18649902,1560,audio/Or61_18648342.jpg,Or61
2010,1952.355779,1952.555779,1,58570673,58576673,6000,audio/Bl122_58570673.jpg,Bl122
2011,2048.345469,2048.429469,2,61450364,61452884,2520,audio/Bl122_61450364.jpg,Bl122
2012,15074.180682,15074.343682,1,452225420,452230310,4890,audio/Ti81_452225420.jpg,Ti81
2013,467.02011,467.23111,1,14010603,14016933,6330,audio/Or61_14010603.jpg,Or61
2014,491.157221,491.358221,1,14734716,14740746,6030,audio/Or61_14734716.jpg,Or61
2015,2087.086961,2087.113961,2,62612608,62613418,810,audio/Bl122_62612608.jpg,Bl122
2016,2145.967183,2145.971183,2,64379015,64379135,120,audio/Bl122_64379015.jpg,Bl122
2017,1808.676926,1808.700926,2,54260307,54261027,720,audio/Bl122_54260307.jpg,Bl122
2018,1944.756779,1945.044779,1,58342703,58351343,8640,audio/Bl122_58342703.jpg,Bl122
2019,1486.492018,1486.505018,1,44594760,44595150,390,audio/Li145_44594760.jpg,Li145
2020,2133.456183,2133.461183,2,64003685,64003835,150,audio/Bl122_64003685.jpg,Bl122
2021,1999.031779,1999.036779,2,59970953,59971103,150,audio/Bl122_59970953.jpg,Bl122
2022,15207.39858,15207.56058,1,456221957,456226817,4860,audio/Ti81_456221957.jpg,Ti81
2023,471.407221,471.422221,2,14142216,14142666,450,audio/Or61_14142216.jpg,Or61
2024,2082.538961,2082.544961,2,62476168,62476348,180,audio/Bl122_62476168.jpg,Bl122
2025,2168.927183,2168.949183,2,65067815,65068475,660,audio/Bl122_65067815.jpg,Bl122
2026,806.186882,806.203882,1,24185606,24186116,510,audio/Or61_24185606.jpg,Or61
2027,1962.638779,1962.687779,1,58879163,58880633,1470,audio/Bl122_58879163.jpg,Bl122
2028,2039.422469,2039.428469,2,61182674,61182854,180,audio/Bl122_61182674.jpg,Bl122
2029,2113.178183,2113.300183,1,63395345,63399005,3660,audio/Bl122_63395345.jpg,Bl122
2030,1959.450779,1959.611779,1,58783523,58788353,4830,audio/Bl122_58783523.jpg,Bl122
2031,2097.523961,2097.527961,2,62925718,62925838,120,audio/Bl122_62925718.jpg,Bl122
2032,2215.483183,2215.527183,2,66464495,66465815,1320,audio/Bl122_66464495.jpg,Bl122
2033,1789.836115,1789.870115,1,53695083,53696103,1020,audio/Bl122_53695083.jpg,Bl122
2034,1977.331779,1977.334779,2,59319953,59320043,90,audio/Bl122_59319953.jpg,Bl122
2035,1971.191779,1971.598779,1,59135753,59147963,12210,audio/Bl122_59135753.jpg,Bl122
2036,2131.783183,2131.961183,1,63953495,63958835,5340,audio/Bl122_63953495.jpg,Bl122
2037,511.888221,512.019221,1,15356646,15360576,3930,audio/Or61_15356646.jpg,Or61
2038,613.775417,613.808417,2,18413262,18414252,990,audio/Or61_18413262.jpg,Or61
2039,2168.680183,2168.739183,1,65060405,65062175,1770,audio/Bl122_65060405.jpg,Bl122
2040,558.051416,558.330416,1,16741542,16749912,8370,audio/Or61_16741542.jpg,Or61
2041,15137.780989,15137.801989,1,454133429,454134059,630,audio/Ti81_454133429.jpg,Ti81
2042,809.265882,809.287882,1,24277976,24278636,660,audio/Or61_24277976.jpg,Or61
2043,627.248417,627.259417,2,18817452,18817782,330,audio/Or61_18817452.jpg,Or61
2044,2179.052183,2179.090183,1,65371565,65372705,1140,audio/Bl122_65371565.jpg,Bl122
2045,15240.080874,15240.108874,1,457202426,457203266,840,audio/Ti81_457202426.jpg,Ti81
2046,713.217271,713.246271,1,21396518,21397388,870,audio/Or61_21396518.jpg,Or61
2047,1951.063779,1951.069779,1,58531913,58532093,180,audio/Bl122_58531913.jpg,Bl122
2048,763.843271,763.868271,1,22915298,22916048,750,audio/Or61_22915298.jpg,Or61
2049,15274.243439,15274.455684,1,458227303,458233670,6367,audio/Ti81_458227303.jpg,Ti81
2050,15240.440874,15240.512874,1,457213226,457215386,2160,audio/Ti81_457213226.jpg,Ti81
2051,214.192857,214.224857,1,6425785,6426745,960,audio/Or61_6425785.jpg,Or61
2052,1952.674779,1952.716779,2,58580243,58581503,1260,audio/Bl122_58580243.jpg,Bl122
2053,3542.060864,3542.208898,1,106261825,106266266,4441,audio/Ti81_106261825.jpg,Ti81
2054,2045.255469,2045.348469,1,61357664,61360454,2790,audio/Bl122_61357664.jpg,Bl122
2055,1979.562779,1979.572779,2,59386883,59387183,300,audio/Bl122_59386883.jpg,Bl122
2056,477.732221,477.864221,1,14331966,14335926,3960,audio/Or61_14331966.jpg,Or61
2057,2050.671469,2050.675469,2,61520144,61520264,120,audio/Bl122_61520144.jpg,Bl122
2058,795.271827,795.362827,1,23858154,23860884,2730,audio/Or61_23858154.jpg,Or61
2059,14762.04293,14762.210202,1,442861287,442866306,5019,audio/Ti81_442861287.jpg,Ti81
2060,613.968417,614.006417,1,18419052,18420192,1140,audio/Or61_18419052.jpg,Or61
2061,14730.580213,14730.823331,1,441917406,441924699,7293,audio/Ti81_441917406.jpg,Ti81
2062,1982.151779,1982.159779,2,59464553,59464793,240,audio/Bl122_59464553.jpg,Bl122
2063,2212.806183,2212.825183,2,66384185,66384755,570,audio/Bl122_66384185.jpg,Bl122
2064,106.878992,107.091992,1,3206369,3212759,6390,audio/Bl122_3206369.jpg,Bl122
2065,15096.525823,15096.543823,1,452895774,452896314,540,audio/Ti81_452895774.jpg,Ti81
2066,738.585271,738.623271,1,22157558,22158698,1140,audio/Or61_22157558.jpg,Or61
2067,637.574417,637.650417,1,19127232,19129512,2280,audio/Or61_19127232.jpg,Or61
2068,2003.675779,2003.693779,1,60110273,60110813,540,audio/Bl122_60110273.jpg,Bl122
2069,2205.392183,2205.401183,2,66161765,66162035,270,audio/Bl122_66161765.jpg,Bl122
2070,2215.232183,2215.381183,1,66456965,66461435,4470,audio/Bl122_66456965.jpg,Bl122
2071,2185.109183,2185.112183,2,65553275,65553365,90,audio/Bl122_65553275.jpg,Bl122
2072,490.167221,490.175221,2,14705016,14705256,240,audio/Or61_14705016.jpg,Or61
2073,754.230271,754.245271,1,22626908,22627358,450,audio/Or61_22626908.jpg,Or61
2074,739.031271,739.066271,1,22170938,22171988,1050,audio/Or61_22170938.jpg,Or61
2075,2043.645469,2043.909469,1,61309364,61317284,7920,audio/Bl122_61309364.jpg,Bl122
2076,2007.683779,2007.686779,2,60230513,60230603,90,audio/Bl122_60230513.jpg,Bl122
2077,2103.196961,2103.275961,1,63095908,63098278,2370,audio/Bl122_63095908.jpg,Bl122
2078,766.733271,766.812271,1,23001998,23004368,2370,audio/Or61_23001998.jpg,Or61
2079,2199.127183,2199.130183,2,65973815,65973905,90,audio/Bl122_65973815.jpg,Bl122
2080,765.648271,765.651271,2,22969448,22969538,90,audio/Or61_22969448.jpg,Or61
2081,526.832416,526.877416,1,15804972,15806322,1350,audio/Or61_15804972.jpg,Or61
2082,2004.381779,2004.421779,2,60131453,60132653,1200,audio/Bl122_60131453.jpg,Bl122
2083,8092.074536,8092.086536,1,242762236,242762596,360,audio/Li145_242762236.jpg,Li145
2084,5873.128637,5873.143637,1,176193859,176194309,450,audio/Li145_176193859.jpg,Li145
2085,704.869271,704.913271,1,21146078,21147398,1320,audio/Or61_21146078.jpg,Or61
2086,2096.047961,2096.050961,2,62881438,62881528,90,audio/Bl122_62881438.jpg,Bl122
2087,732.504271,732.507271,2,21975128,21975218,90,audio/Or61_21975128.jpg,Or61
2088,2099.605961,2099.612961,2,62988178,62988388,210,audio/Bl122_62988178.jpg,Bl122
2089,9537.323343,9537.352343,1,286119700,286120570,870,audio/Li145_286119700.jpg,Li145
2090,2152.424183,2152.428183,2,64572725,64572845,120,audio/Bl122_64572725.jpg,Bl122
2091,184.916971,185.297971,1,5547509,5558939,11430,audio/Or61_5547509.jpg,Or61
2092,2040.862815,2040.873815,1,61225884,61226214,330,audio/Li145_61225884.jpg,Li145
2093,635.958417,636.075417,1,19078752,19082262,3510,audio/Or61_19078752.jpg,Or61
2094,1940.492779,1940.497779,2,58214783,58214933,150,audio/Bl122_58214783.jpg,Bl122
2095,540.867416,540.886416,1,16226022,16226592,570,audio/Or61_16226022.jpg,Or61
2096,1991.334779,1991.340779,2,59740043,59740223,180,audio/Bl122_59740043.jpg,Bl122
2097,545.115416,545.166416,1,16353462,16354992,1530,audio/Or61_16353462.jpg,Or61
2098,605.184417,605.221417,2,18155532,18156642,1110,audio/Or61_18155532.jpg,Or61
2099,2147.369183,2147.468183,1,64421075,64424045,2970,audio/Bl122_64421075.jpg,Bl122
2100,529.161416,529.166416,2,15874842,15874992,150,audio/Or61_15874842.jpg,Or61
2101,1982.401779,1982.633779,1,59472053,59479013,6960,audio/Bl122_59472053.jpg,Bl122
2102,2165.179183,2165.358183,1,64955375,64960745,5370,audio/Bl122_64955375.jpg,Bl122
2103,1962.422779,1962.425779,2,58872683,58872773,90,audio/Bl122_58872683.jpg,Bl122
2104,2107.786377,2107.826377,2,63233591,63234791,1200,audio/Bl122_63233591.jpg,Bl122
2105,5968.457227,5968.470227,1,179053716,179054106,390,audio/Li145_179053716.jpg,Li145
2106,565.991416,566.014416,2,16979742,16980432,690,audio/Or61_16979742.jpg,Or61
2107,793.770827,793.815827,1,23813124,23814474,1350,audio/Or61_23813124.jpg,Or61
2108,748.395271,748.427271,1,22451858,22452818,960,audio/Or61_22451858.jpg,Or61
2109,15055.646966,15055.772966,1,451669408,451673188,3780,audio/Ti81_451669408.jpg,Ti81
2110,1765.640264,1765.645264,2,52969207,52969357,150,audio/Bl122_52969207.jpg,Bl122
2111,527.018086,527.178086,1,15810542,15815342,4800,audio/Li145_15810542.jpg,Li145
2112,546.603416,546.607416,2,16398102,16398222,120,audio/Or61_16398102.jpg,Or61
2113,15049.664966,15049.693966,1,451489948,451490818,870,audio/Ti81_451489948.jpg,Ti81
2114,614.423417,614.448417,2,18432702,18433452,750,audio/Or61_18432702.jpg,Or61
2115,514.555221,514.580221,1,15436656,15437406,750,audio/Or61_15436656.jpg,Or61
2116,482.418221,482.505221,1,14472546,14475156,2610,audio/Or61_14472546.jpg,Or61
2117,2078.094823,2078.102823,2,62342844,62343084,240,audio/Bl122_62342844.jpg,Bl122
2118,736.681271,736.714271,1,22100438,22101428,990,audio/Or61_22100438.jpg,Or61
2119,15224.648443,15224.710443,1,456739453,456741313,1860,audio/Ti81_456739453.jpg,Ti81
2120,1769.589657,1769.595657,2,53087689,53087869,180,audio/Bl122_53087689.jpg,Bl122
2121,2230.914183,2230.925183,2,66927425,66927755,330,audio/Bl122_66927425.jpg,Bl122
2122,9046.063911,9046.083911,1,271381917,271382517,600,audio/Li145_271381917.jpg,Li145
2123,2227.459183,2227.516183,2,66823775,66825485,1710,audio/Bl122_66823775.jpg,Bl122
2124,1795.013115,1795.056115,1,53850393,53851683,1290,audio/Bl122_53850393.jpg,Bl122
2125,15084.3179,15084.3959,1,452529537,452531877,2340,audio/Ti81_452529537.jpg,Ti81
2126,528.666416,528.673416,2,15859992,15860202,210,audio/Or61_15859992.jpg,Or61
2127,2151.438183,2151.477183,2,64543145,64544315,1170,audio/Bl122_64543145.jpg,Bl122
2128,545.607416,545.687416,1,16368222,16370622,2400,audio/Or61_16368222.jpg,Or61
2129,1985.575779,1985.606779,1,59567273,59568203,930,audio/Bl122_59567273.jpg,Bl122
2130,2093.221961,2093.462961,1,62796658,62803888,7230,audio/Bl122_62796658.jpg,Bl122
2131,747.975271,748.032271,1,22439258,22440968,1710,audio/Or61_22439258.jpg,Or61
2132,2156.992183,2157.183183,1,64709765,64715495,5730,audio/Bl122_64709765.jpg,Bl122
2133,213.082857,213.273857,1,6392485,6398215,5730,audio/Or61_6392485.jpg,Or61
2134,635.142417,635.349417,1,19054272,19060482,6210,audio/Or61_19054272.jpg,Or61
2135,14761.073105,14761.290096,1,442832193,442838702,6509,audio/Ti81_442832193.jpg,Ti81
2136,2185.619183,2185.647183,2,65568575,65569415,840,audio/Bl122_65568575.jpg,Bl122
2137,2100.091961,2100.117961,1,63002758,63003538,780,audio/Bl122_63002758.jpg,Bl122
2138,492.798221,492.829221,2,14783946,14784876,930,audio/Or61_14783946.jpg,Or61
2139,541.961416,541.986416,1,16258842,16259592,750,audio/Or61_16258842.jpg,Or61
2140,759.049271,759.179271,1,22771478,22775378,3900,audio/Or61_22771478.jpg,Or61
2141,2183.009183,2183.017183,2,65490275,65490515,240,audio/Bl122_65490275.jpg,Bl122
2142,1800.012115,1800.023115,2,54000363,54000693,330,audio/Bl122_54000363.jpg,Bl122
2143,612.874417,612.938417,1,18386232,18388152,1920,audio/Or61_18386232.jpg,Or61
2144,548.192416,548.520416,1,16445772,16455612,9840,audio/Or61_16445772.jpg,Or61
2145,2092.172961,2092.183961,2,62765188,62765518,330,audio/Bl122_62765188.jpg,Bl122
2146,2213.565183,2213.590183,1,66406955,66407705,750,audio/Bl122_66406955.jpg,Bl122
2147,15205.04158,15205.08058,1,456151247,456152417,1170,audio/Ti81_456151247.jpg,Ti81
2148,390.894161,391.147161,1,11726824,11734414,7590,audio/Or61_11726824.jpg,Or61
2149,398.789529,399.069529,1,11963685,11972085,8400,audio/Or61_11963685.jpg,Or61
2150,501.678221,501.682221,2,15050346,15050466,120,audio/Or61_15050346.jpg,Or61
2151,2110.750183,2110.783183,1,63322505,63323495,990,audio/Bl122_63322505.jpg,Bl122
2152,2132.525183,2132.711183,1,63975755,63981335,5580,audio/Bl122_63975755.jpg,Bl122
2153,725.687271,726.020271,1,21770618,21780608,9990,audio/Or61_21770618.jpg,Or61
2154,2197.444183,2197.455183,2,65923325,65923655,330,audio/Bl122_65923325.jpg,Bl122
2155,2189.958183,2189.964183,2,65698745,65698925,180,audio/Bl122_65698745.jpg,Bl122
2156,502.995221,502.998221,2,15089856,15089946,90,audio/Or61_15089856.jpg,Or61
2157,478.325221,478.402221,1,14349756,14352066,2310,audio/Or61_14349756.jpg,Or61
2158,1770.595657,1770.611657,2,53117869,53118349,480,audio/Bl122_53117869.jpg,Bl122
2159,15105.373256,15105.515256,1,453161197,453165457,4260,audio/Ti81_453161197.jpg,Ti81
2160,1944.151779,1944.251779,2,58324553,58327553,3000,audio/Bl122_58324553.jpg,Bl122
2161,8889.837716,8889.847716,1,266695131,266695431,300,audio/Li145_266695131.jpg,Li145
2162,2210.202183,2210.543183,1,66306065,66316295,10230,audio/Bl122_66306065.jpg,Bl122
2163,2164.362183,2164.365183,2,64930865,64930955,90,audio/Bl122_64930865.jpg,Bl122
2164,182.089971,182.289971,1,5462699,5468699,6000,audio/Or61_5462699.jpg,Or61
2165,2173.405183,2173.443183,2,65202155,65203295,1140,audio/Bl122_65202155.jpg,Bl122
2166,565.915416,565.917416,2,16977462,16977522,60,audio/Or61_16977462.jpg,Or61
2167,15048.904966,15049.149032,1,451467148,451474470,7322,audio/Ti81_451467148.jpg,Ti81
2168,2140.879183,2140.935183,1,64226375,64228055,1680,audio/Bl122_64226375.jpg,Bl122
2169,528.934416,528.938416,2,15868032,15868152,120,audio/Or61_15868032.jpg,Or61
2170,1798.697115,1798.894115,1,53960913,53966823,5910,audio/Bl122_53960913.jpg,Bl122
2171,1970.573779,1970.583779,2,59117213,59117513,300,audio/Bl122_59117213.jpg,Bl122
2172,2042.049469,2042.063469,2,61261484,61261904,420,audio/Bl122_61261484.jpg,Bl122
2173,744.413271,744.501271,1,22332398,22335038,2640,audio/Or61_22332398.jpg,Or61
2174,1986.679779,1986.724779,1,59600393,59601743,1350,audio/Bl122_59600393.jpg,Bl122
2175,1972.263779,1972.272779,2,59167913,59168183,270,audio/Bl122_59167913.jpg,Bl122
2176,2138.333183,2138.396183,2,64149995,64151885,1890,audio/Bl122_64149995.jpg,Bl122
2177,2065.292469,2065.380469,1,61958774,61961414,2640,audio/Bl122_61958774.jpg,Bl122
2178,2148.980183,2149.031183,2,64469405,64470935,1530,audio/Bl122_64469405.jpg,Bl122
2179,7531.159966,7531.161966,1,225934798,225934858,60,audio/Li145_225934798.jpg,Li145
2180,2067.744469,2067.756469,2,62032334,62032694,360,audio/Bl122_62032334.jpg,Bl122
2181,819.435882,819.495882,1,24583076,24584876,1800,audio/Or61_24583076.jpg,Or61
2182,2054.724469,2054.729469,2,61641734,61641884,150,audio/Bl122_61641734.jpg,Bl122
2183,6956.493877,6956.518877,1,208694816,208695566,750,audio/Li145_208694816.jpg,Li145
2184,2092.727961,2092.765961,1,62781838,62782978,1140,audio/Bl122_62781838.jpg,Bl122
2185,2130.696183,2130.786183,1,63920885,63923585,2700,audio/Bl122_63920885.jpg,Bl122
2186,8889.734716,8889.756716,1,266692041,266692701,660,audio/Li145_266692041.jpg,Li145
2187,2042.568469,2042.575469,2,61277054,61277264,210,audio/Bl122_61277054.jpg,Bl122
2188,817.104882,817.113882,2,24513146,24513416,270,audio/Or61_24513146.jpg,Or61
2189,491.063221,491.100221,2,14731896,14733006,1110,audio/Or61_14731896.jpg,Or61
2190,2217.073183,2217.081183,2,66512195,66512435,240,audio/Bl122_66512195.jpg,Bl122
2191,2153.146183,2153.152183,2,64594385,64594565,180,audio/Bl122_64594385.jpg,Bl122
2192,721.859271,721.884271,1,21655778,21656528,750,audio/Or61_21655778.jpg,Or61
2193,743.971271,744.187271,1,22319138,22325618,6480,audio/Or61_22319138.jpg,Or61
2194,2210.071183,2210.088183,2,66302135,66302645,510,audio/Bl122_66302135.jpg,Bl122
2195,2198.298183,2198.317183,2,65948945,65949515,570,audio/Bl122_65948945.jpg,Bl122
2196,2216.944183,2216.970183,1,66508325,66509105,780,audio/Bl122_66508325.jpg,Bl122
2197,15036.028421,15036.039648,1,451080852,451081189,337,audio/Ti81_451080852.jpg,Ti81
2198,1747.146531,1747.362531,1,52414395,52420875,6480,audio/Bl122_52414395.jpg,Bl122
2199,488.263221,488.278221,2,14647896,14648346,450,audio/Or61_14647896.jpg,Or61
2200,457.286931,457.450931,1,13718607,13723527,4920,audio/Or61_13718607.jpg,Or61
2201,1996.958779,1996.988779,2,59908763,59909663,900,audio/Bl122_59908763.jpg,Bl122
2202,1784.56643,1784.62043,1,53536992,53538612,1620,audio/Bl122_53536992.jpg,Bl122
2203,611.717417,611.736417,2,18351522,18352092,570,audio/Or61_18351522.jpg,Or61
2204,15346.000971,15346.065971,1,460380029,460381979,1950,audio/Ti81_460380029.jpg,Ti81
2205,2198.104183,2198.108183,2,65943125,65943245,120,audio/Bl122_65943125.jpg,Bl122
2206,504.983221,505.031221,1,15149496,15150936,1440,audio/Or61_15149496.jpg,Or61
2207,537.095416,537.156416,1,16112862,16114692,1830,audio/Or61_16112862.jpg,Or61
2208,2059.513469,2059.516469,2,61785404,61785494,90,audio/Bl122_61785404.jpg,Bl122
2209,733.922271,733.931271,1,22017668,22017938,270,audio/Or61_22017668.jpg,Or61
2210,1955.671779,1955.869779,1,58670153,58676093,5940,audio/Bl122_58670153.jpg,Bl122
2211,537.630416,537.643416,1,16128912,16129302,390,audio/Or61_16128912.jpg,Or61
2212,2049.417469,2049.445469,1,61482524,61483364,840,audio/Bl122_61482524.jpg,Bl122
2213,5840.290404,5840.300404,2,175208712,175209012,300,audio/Li145_175208712.jpg,Li145
2214,472.130221,472.147221,2,14163906,14164416,510,audio/Or61_14163906.jpg,Or61
2215,15273.773439,15273.892439,1,458213203,458216773,3570,audio/Ti81_458213203.jpg,Ti81
2216,5835.225068,5835.257068,1,175056752,175057712,960,audio/Li145_175056752.jpg,Li145
2217,2140.430183,2140.436183,2,64212905,64213085,180,audio/Bl122_64212905.jpg,Bl122
2218,504.319221,504.330221,2,15129576,15129906,330,audio/Or61_15129576.jpg,Or61
2219,5968.540227,5968.546227,1,179056206,179056386,180,audio/Li145_179056206.jpg,Li145
2220,8740.975692,8741.002692,1,262229270,262230080,810,audio/Li145_262229270.jpg,Li145
2221,1972.234779,1972.249779,2,59167043,59167493,450,audio/Bl122_59167043.jpg,Bl122
2222,608.730417,608.927417,1,18261912,18267822,5910,audio/Or61_18261912.jpg,Or61
2223,1984.725779,1984.740779,2,59541773,59542223,450,audio/Bl122_59541773.jpg,Bl122
2224,2145.711183,2145.763183,2,64371335,64372895,1560,audio/Bl122_64371335.jpg,Bl122
2225,2216.629183,2216.632183,2,66498875,66498965,90,audio/Bl122_66498875.jpg,Bl122
2226,1972.276779,1972.537779,1,59168303,59176133,7830,audio/Bl122_59168303.jpg,Bl122
2227,1974.223779,1974.239779,1,59226713,59227193,480,audio/Bl122_59226713.jpg,Bl122
2228,1486.378018,1486.384018,2,44591340,44591520,180,audio/Li145_44591340.jpg,Li145
2229,4906.010385,4906.027385,1,147180311,147180821,510,audio/Li145_147180311.jpg,Li145
2230,2012.375959,2012.396959,2,60371278,60371908,630,audio/Bl122_60371278.jpg,Bl122
2231,2008.954779,2009.114779,1,60268643,60273443,4800,audio/Bl122_60268643.jpg,Bl122
2232,552.533416,552.592416,1,16576002,16577772,1770,audio/Or61_16576002.jpg,Or61
2233,9172.504804,9172.506804,2,275175144,275175204,60,audio/Li145_275175144.jpg,Li145
2234,614.299417,614.323417,1,18428982,18429702,720,audio/Or61_18428982.jpg,Or61
2235,483.581221,483.597221,2,14507436,14507916,480,audio/Or61_14507436.jpg,Or61
2236,577.23771,577.27571,1,17317131,17318271,1140,audio/Or61_17317131.jpg,Or61
2237,505.229221,505.235221,2,15156876,15157056,180,audio/Or61_15156876.jpg,Or61
2238,6949.043842,6949.113842,1,208471315,208473415,2100,audio/Li145_208471315.jpg,Li145
2239,443.84566,443.85766,2,13315369,13315729,360,audio/Or61_13315369.jpg,Or61
2240,2071.687469,2071.758469,1,62150624,62152754,2130,audio/Bl122_62150624.jpg,Bl122
2241,14901.436899,14901.459889,1,447043106,447043796,690,audio/Ti81_447043106.jpg,Ti81
2242,1945.550779,1945.661779,2,58366523,58369853,3330,audio/Bl122_58366523.jpg,Bl122
2243,15090.5069,15090.5369,1,452715207,452716107,900,audio/Ti81_452715207.jpg,Ti81
2244,8740.613692,8740.619692,1,262218410,262218590,180,audio/Li145_262218410.jpg,Li145
2245,1943.334779,1943.741779,1,58300043,58312253,12210,audio/Bl122_58300043.jpg,Bl122
2246,2008.486779,2008.553779,1,60254603,60256613,2010,audio/Bl122_60254603.jpg,Bl122
2247,2199.367183,2199.397183,1,65981015,65981915,900,audio/Bl122_65981015.jpg,Bl122
2248,814.803882,815.014882,1,24444116,24450446,6330,audio/Or61_24444116.jpg,Or61
2249,15158.470257,15158.712257,1,454754107,454761367,7260,audio/Ti81_454754107.jpg,Ti81
2250,2214.075183,2214.102183,2,66422255,66423065,810,audio/Bl122_66422255.jpg,Bl122
2251,1775.178974,1775.209974,1,53255369,53256299,930,audio/Bl122_53255369.jpg,Bl122
2252,506.860221,506.963221,1,15205806,15208896,3090,audio/Or61_15205806.jpg,Or61
2253,15033.489317,15033.556933,1,451004679,451006707,2028,audio/Ti81_451004679.jpg,Ti81
2254,2062.914469,2062.922469,2,61887434,61887674,240,audio/Bl122_61887434.jpg,Bl122
2255,529.016416,529.029416,2,15870492,15870882,390,audio/Or61_15870492.jpg,Or61
2256,2140.819183,2140.842183,1,64224575,64225265,690,audio/Bl122_64224575.jpg,Bl122
2257,5.203509,5.376509,1,156105,161295,5190,audio/Or61_156105.jpg,Or61
2258,727.787271,727.855271,1,21833618,21835658,2040,audio/Or61_21833618.jpg,Or61
2259,1785.97943,1786.03443,2,53579382,53581032,1650,audio/Bl122_53579382.jpg,Bl122
2260,2216.202183,2216.272183,1,66486065,66488165,2100,audio/Bl122_66486065.jpg,Bl122
2261,15025.400089,15025.415169,1,450762002,450762455,453,audio/Ti81_450762002.jpg,Ti81
2262,2037.705469,2037.716469,2,61131164,61131494,330,audio/Bl122_61131164.jpg,Bl122
2263,15086.876359,15087.1089,1,452606290,452613267,6977,audio/Ti81_452606290.jpg,Ti81
2264,403.339692,403.519692,1,12100190,12105590,5400,audio/Or61_12100190.jpg,Or61
2265,8084.400803,8084.425803,1,242532024,242532774,750,audio/Li145_242532024.jpg,Li145
2266,507.658221,507.662221,2,15229746,15229866,120,audio/Or61_15229746.jpg,Or61
2267,544.053416,544.124416,1,16321602,16323732,2130,audio/Or61_16321602.jpg,Or61
2268,2115.251183,2115.354183,1,63457535,63460625,3090,audio/Bl122_63457535.jpg,Bl122
2269,15329.706625,15329.745625,1,459891198,459892368,1170,audio/Ti81_459891198.jpg,Ti81
2270,6954.820285,6954.863285,1,208644608,208645898,1290,audio/Li145_208644608.jpg,Li145
2271,704.316271,704.331271,1,21129488,21129938,450,audio/Or61_21129488.jpg,Or61
2272,1972.177779,1972.218779,2,59165333,59166563,1230,audio/Bl122_59165333.jpg,Bl122
2273,2125.909183,2125.954183,2,63777275,63778625,1350,audio/Bl122_63777275.jpg,Bl122
2274,6300.592561,6300.691561,1,189017776,189020746,2970,audio/Li145_189017776.jpg,Li145
2275,1945.979779,1946.114779,1,58379393,58383443,4050,audio/Bl122_58379393.jpg,Bl122
2276,2117.266183,2117.550183,1,63517985,63526505,8520,audio/Bl122_63517985.jpg,Bl122
2277,3413.391288,3413.415256,1,102401738,102402457,719,audio/Ti81_102401738.jpg,Ti81
2278,1971.690779,1971.715779,2,59150723,59151473,750,audio/Bl122_59150723.jpg,Bl122
2279,743.405271,743.531271,1,22302158,22305938,3780,audio/Or61_22302158.jpg,Or61
2280,1994.285779,1994.289779,2,59828573,59828693,120,audio/Bl122_59828573.jpg,Bl122
2281,1787.257115,1787.270115,1,53617713,53618103,390,audio/Bl122_53617713.jpg,Bl122
2282,2039.430469,2039.482469,1,61182914,61184474,1560,audio/Bl122_61182914.jpg,Bl122
2283,2176.904183,2176.930183,2,65307125,65307905,780,audio/Bl122_65307125.jpg,Bl122
2284,496.262221,496.515221,1,14887866,14895456,7590,audio/Or61_14887866.jpg,Or61
2285,2130.508183,2130.515183,2,63915245,63915455,210,audio/Bl122_63915245.jpg,Bl122
2286,539.628416,540.098416,1,16188852,16202952,14100,audio/Or61_16188852.jpg,Or61
2287,557.492416,557.725416,1,16724772,16731762,6990,audio/Or61_16724772.jpg,Or61
2288,2194.087183,2194.414183,1,65822615,65832425,9810,audio/Bl122_65822615.jpg,Bl122
2289,702.407271,702.534271,1,21072218,21076028,3810,audio/Or61_21072218.jpg,Or61
2290,494.414221,494.628221,1,14832426,14838846,6420,audio/Or61_14832426.jpg,Or61
2291,2211.094183,2211.156183,2,66332825,66334685,1860,audio/Bl122_66332825.jpg,Bl122
2292,1988.870779,1988.874779,2,59666123,59666243,120,audio/Bl122_59666123.jpg,Bl122
2293,495.860221,495.893221,1,14875806,14876796,990,audio/Or61_14875806.jpg,Or61
2294,3540.826192,3541.04796,1,106224785,106231438,6653,audio/Ti81_106224785.jpg,Ti81
2295,1952.586779,1952.589779,2,58577603,58577693,90,audio/Bl122_58577603.jpg,Bl122
2296,15216.38058,15216.49758,1,456491417,456494927,3510,audio/Ti81_456491417.jpg,Ti81
2297,2054.820469,2054.843469,1,61644614,61645304,690,audio/Bl122_61644614.jpg,Bl122
2298,673.129078,673.299078,1,20193872,20198972,5100,audio/Or61_20193872.jpg,Or61
2299,2014.020959,2014.032959,2,60420628,60420988,360,audio/Bl122_60420628.jpg,Bl122
2300,2049.171469,2049.183469,2,61475144,61475504,360,audio/Bl122_61475144.jpg,Bl122
2301,15049.702966,15049.719966,1,451491088,451491598,510,audio/Ti81_451491088.jpg,Ti81
2302,15117.348981,15117.364981,1,453520469,453520949,480,audio/Ti81_453520469.jpg,Ti81
2303,2054.300469,2054.305469,2,61629014,61629164,150,audio/Bl122_61629014.jpg,Bl122
2304,770.533271,770.620271,1,23115998,23118608,2610,audio/Or61_23115998.jpg,Or61
2305,2163.407183,2163.484183,2,64902215,64904525,2310,audio/Bl122_64902215.jpg,Bl122
2306,493.071221,493.110221,2,14792136,14793306,1170,audio/Or61_14792136.jpg,Or61
2307,501.736221,501.747221,2,15052086,15052416,330,audio/Or61_15052086.jpg,Or61
2308,15094.343823,15094.379823,1,452830314,452831394,1080,audio/Ti81_452830314.jpg,Ti81
2309,6338.341837,6338.423837,1,190150255,190152715,2460,audio/Li145_190150255.jpg,Li145
2310,1987.156779,1987.193779,2,59614703,59615813,1110,audio/Bl122_59614703.jpg,Bl122
2311,14731.321268,14731.452967,1,441939638,441943589,3951,audio/Ti81_441939638.jpg,Ti81
2312,2178.452183,2178.466183,2,65353565,65353985,420,audio/Bl122_65353565.jpg,Bl122
2313,15050.216966,15050.387966,1,451506508,451511638,5130,audio/Ti81_451506508.jpg,Ti81
2314,2013.923959,2013.929959,2,60417718,60417898,180,audio/Bl122_60417718.jpg,Bl122
2315,15304.124373,15304.142373,1,459123731,459124271,540,audio/Ti81_459123731.jpg,Ti81
2316,1801.156115,1801.208115,2,54034683,54036243,1560,audio/Bl122_54034683.jpg,Bl122
2317,1959.336779,1959.360779,1,58780103,58780823,720,audio/Bl122_58780103.jpg,Bl122
2318,2217.253183,2217.648183,1,66517595,66529445,11850,audio/Bl122_66517595.jpg,Bl122
2319,626.806417,626.814417,2,18804192,18804432,240,audio/Or61_18804192.jpg,Or61
2320,506.155221,506.319221,1,15184656,15189576,4920,audio/Or61_15184656.jpg,Or61
2321,746.832271,746.857271,1,22404968,22405718,750,audio/Or61_22404968.jpg,Or61
2322,1955.080779,1955.087779,2,58652423,58652633,210,audio/Bl122_58652423.jpg,Bl122
2323,488.538221,488.545221,2,14656146,14656356,210,audio/Or61_14656146.jpg,Or61
2324,2194.908183,2195.055183,1,65847245,65851655,4410,audio/Bl122_65847245.jpg,Bl122
2325,2177.685183,2177.690183,2,65330555,65330705,150,audio/Bl122_65330555.jpg,Bl122
2326,403.258692,403.271692,2,12097760,12098150,390,audio/Or61_12097760.jpg,Or61
2327,7553.266715,7553.282715,1,226598001,226598481,480,audio/Li145_226598001.jpg,Li145
2328,543.442416,543.475416,1,16303272,16304262,990,audio/Or61_16303272.jpg,Or61
2329,5872.830637,5872.835637,1,176184919,176185069,150,audio/Li145_176184919.jpg,Li145
2330,2093.799961,2093.903961,1,62813998,62817118,3120,audio/Bl122_62813998.jpg,Bl122
2331,15025.205947,15025.266169,1,450756178,450757985,1807,audio/Ti81_450756178.jpg,Ti81
2332,2192.230183,2192.255183,2,65766905,65767655,750,audio/Bl122_65766905.jpg,Bl122
2333,2231.584183,2231.606183,1,66947525,66948185,660,audio/Bl122_66947525.jpg,Bl122
2334,1961.026779,1961.032779,2,58830803,58830983,180,audio/Bl122_58830803.jpg,Bl122
2335,482.829221,483.023221,1,14484876,14490696,5820,audio/Or61_14484876.jpg,Or61
2336,580.69771,581.09371,1,17420931,17432811,11880,audio/Or61_17420931.jpg,Or61
2337,563.299416,563.321416,2,16898982,16899642,660,audio/Or61_16898982.jpg,Or61
2338,15237.788874,15237.846874,1,457133666,457135406,1740,audio/Ti81_457133666.jpg,Ti81
2339,488.057221,488.061221,2,14641716,14641836,120,audio/Or61_14641716.jpg,Or61
2340,15032.203745,15032.260007,1,450966112,450967800,1688,audio/Ti81_450966112.jpg,Ti81
2341,15240.186874,15240.255874,1,457205606,457207676,2070,audio/Ti81_457205606.jpg,Ti81
2342,7563.217654,7563.219654,2,226896529,226896589,60,audio/Li145_226896529.jpg,Li145
2343,15036.620811,15036.632164,1,451098624,451098964,340,audio/Ti81_451098624.jpg,Ti81
2344,9164.960583,9164.962583,2,274948817,274948877,60,audio/Li145_274948817.jpg,Li145
2345,2173.955183,2173.967183,2,65218655,65219015,360,audio/Bl122_65218655.jpg,Bl122
2346,483.027221,483.047221,1,14490816,14491416,600,audio/Or61_14490816.jpg,Or61
2347,2066.663469,2066.695469,2,61999904,62000864,960,audio/Bl122_61999904.jpg,Bl122
2348,15097.367823,15097.386823,1,452921034,452921604,570,audio/Ti81_452921034.jpg,Ti81
2349,2160.459183,2160.495183,1,64813775,64814855,1080,audio/Bl122_64813775.jpg,Bl122
2350,791.937827,792.066827,1,23758134,23762004,3870,audio/Or61_23758134.jpg,Or61
2351,2159.746183,2159.779183,1,64792385,64793375,990,audio/Bl122_64792385.jpg,Bl122
2352,15204.54758,15204.68158,1,456136427,456140447,4020,audio/Ti81_456136427.jpg,Ti81
2353,812.384882,812.455882,1,24371546,24373676,2130,audio/Or61_24371546.jpg,Or61
2354,1956.354779,1956.395779,2,58690643,58691873,1230,audio/Bl122_58690643.jpg,Bl122
2355,2207.773183,2208.031183,1,66233195,66240935,7740,audio/Bl122_66233195.jpg,Bl122
2356,7552.547715,7552.550715,2,226576431,226576521,90,audio/Li145_226576431.jpg,Li145
2357,2054.041469,2054.106469,2,61621244,61623194,1950,audio/Bl122_61621244.jpg,Bl122
2358,3447.195245,3447.420797,1,103415857,103422623,6766,audio/Ti81_103415857.jpg,Ti81
2359,559.417416,559.488416,1,16782522,16784652,2130,audio/Or61_16782522.jpg,Or61
2360,5967.929227,5967.951227,1,179037876,179038536,660,audio/Li145_179037876.jpg,Li145
2361,720.326271,720.330271,2,21609788,21609908,120,audio/Or61_21609788.jpg,Or61
2362,9166.456583,9166.473583,1,274993697,274994207,510,audio/Li145_274993697.jpg,Li145
2363,15077.336824,15077.628682,1,452320104,452328860,8756,audio/Ti81_452320104.jpg,Ti81
2364,2136.651183,2136.677183,2,64099535,64100315,780,audio/Bl122_64099535.jpg,Bl122
2365,15025.507567,15025.521191,1,450765227,450765635,408,audio/Ti81_450765227.jpg,Ti81
2366,15328.626625,15328.652625,1,459858798,459859578,780,audio/Ti81_459858798.jpg,Ti81
2367,2128.831183,2129.066183,1,63864935,63871985,7050,audio/Bl122_63864935.jpg,Bl122
2368,8889.106716,8889.109716,1,266673201,266673291,90,audio/Li145_266673201.jpg,Li145
2369,15277.934439,15278.176439,1,458338033,458345293,7260,audio/Ti81_458338033.jpg,Ti81
2370,9165.390583,9165.510583,1,274961717,274965317,3600,audio/Li145_274961717.jpg,Li145
2371,9134.782751,9134.786751,1,274043482,274043602,120,audio/Li145_274043482.jpg,Li145
2372,1954.848779,1954.913779,1,58645463,58647413,1950,audio/Bl122_58645463.jpg,Bl122
2373,2224.442183,2224.447183,2,66733265,66733415,150,audio/Bl122_66733265.jpg,Bl122
2374,2223.845183,2223.849183,2,66715355,66715475,120,audio/Bl122_66715355.jpg,Bl122
2375,5911.120207,5911.122207,2,177333606,177333666,60,audio/Li145_177333606.jpg,Li145
2376,15304.258373,15304.274373,1,459127751,459128231,480,audio/Ti81_459127751.jpg,Ti81
2377,14900.032495,14900.061005,1,447000974,447001830,856,audio/Ti81_447000974.jpg,Ti81
2378,541.073416,541.097416,1,16232202,16232922,720,audio/Or61_16232202.jpg,Or61
2379,2219.895183,2219.905183,2,66596855,66597155,300,audio/Bl122_66596855.jpg,Bl122
2380,8864.611987,8864.659987,1,265938359,265939799,1440,audio/Li145_265938359.jpg,Li145
2381,2155.815183,2155.820183,2,64674455,64674605,150,audio/Bl122_64674455.jpg,Bl122
2382,2191.190183,2191.218183,2,65735705,65736545,840,audio/Bl122_65735705.jpg,Bl122
2383,15258.117114,15258.312114,1,457743513,457749363,5850,audio/Ti81_457743513.jpg,Ti81
2384,627.183417,627.190417,2,18815502,18815712,210,audio/Or61_18815502.jpg,Or61
2385,1938.017779,1938.092779,1,58140533,58142783,2250,audio/Bl122_58140533.jpg,Bl122
2386,15032.317152,15032.322702,1,450969514,450969681,167,audio/Ti81_450969514.jpg,Ti81
2387,15043.493849,15043.556166,1,451304815,451306684,1869,audio/Ti81_451304815.jpg,Ti81
2388,8091.000536,8091.057536,1,242730016,242731726,1710,audio/Li145_242730016.jpg,Li145
2389,15204.89958,15204.97258,1,456146987,456149177,2190,audio/Ti81_456146987.jpg,Ti81
2390,794.890827,794.922827,1,23846724,23847684,960,audio/Or61_23846724.jpg,Or61
2391,763.001271,763.080271,1,22890038,22892408,2370,audio/Or61_22890038.jpg,Or61
2392,15237.703874,15237.784874,1,457131116,457133546,2430,audio/Ti81_457131116.jpg,Ti81
2393,2175.656183,2175.703183,1,65269685,65271095,1410,audio/Bl122_65269685.jpg,Bl122
2394,1773.668974,1773.701974,1,53210069,53211059,990,audio/Bl122_53210069.jpg,Bl122
2395,6289.462659,6289.483659,1,188683879,188684509,630,audio/Li145_188683879.jpg,Li145
2396,201.035012,201.057012,2,6031050,6031710,660,audio/Or61_6031050.jpg,Or61
2397,512.978221,513.107221,1,15389346,15393216,3870,audio/Or61_15389346.jpg,Or61
2398,610.175417,610.217417,1,18305262,18306522,1260,audio/Or61_18305262.jpg,Or61
2399,2132.343183,2132.371183,1,63970295,63971135,840,audio/Bl122_63970295.jpg,Bl122
2400,210.999765,211.002765,2,6329992,6330082,90,audio/Or61_6329992.jpg,Or61
2401,749.819271,749.917271,1,22494578,22497518,2940,audio/Or61_22494578.jpg,Or61
2402,15164.380257,15164.409257,1,454931407,454932277,870,audio/Ti81_454931407.jpg,Ti81
2403,4.33915,4.35315,1,130174,130594,420,audio/Or61_130174.jpg,Or61
2404,1983.930779,1984.236779,1,59517923,59527103,9180,audio/Bl122_59517923.jpg,Bl122
2405,792.611827,792.627827,1,23778354,23778834,480,audio/Or61_23778354.jpg,Or61
2406,2211.573183,2211.595183,2,66347195,66347855,660,audio/Bl122_66347195.jpg,Bl122
2407,674.243078,674.246078,2,20227292,20227382,90,audio/Or61_20227292.jpg,Or61
2408,122.213451,122.495451,1,3666403,3674863,8460,audio/Or61_3666403.jpg,Or61
2409,744.996271,745.067271,1,22349888,22352018,2130,audio/Or61_22349888.jpg,Or61
2410,3415.842971,3415.862145,1,102475289,102475864,575,audio/Ti81_102475289.jpg,Ti81
2411,5970.351227,5970.364227,1,179110536,179110926,390,audio/Li145_179110536.jpg,Li145
2412,2212.833183,2212.836183,2,66384995,66385085,90,audio/Bl122_66384995.jpg,Bl122
2413,15124.337981,15124.453981,1,453730139,453733619,3480,audio/Ti81_453730139.jpg,Ti81
2414,813.484882,813.516882,1,24404546,24405506,960,audio/Or61_24404546.jpg,Or61
2415,568.385467,568.410467,1,17051564,17052314,750,audio/Or61_17051564.jpg,Or61
2416,743.652271,743.671271,1,22309568,22310138,570,audio/Or61_22309568.jpg,Or61
2417,565.599416,565.641416,2,16967982,16969242,1260,audio/Or61_16967982.jpg,Or61
2418,14889.298956,14889.356732,1,446678968,446680701,1733,audio/Ti81_446678968.jpg,Ti81
2419,625.518417,625.655417,1,18765552,18769662,4110,audio/Or61_18765552.jpg,Or61
2420,2157.579183,2157.590183,2,64727375,64727705,330,audio/Bl122_64727375.jpg,Bl122
2421,5834.853068,5834.897068,1,175045592,175046912,1320,audio/Li145_175045592.jpg,Li145
2422,748.856271,748.877271,1,22465688,22466318,630,audio/Or61_22465688.jpg,Or61
2423,3466.864212,3466.935864,1,104005926,104008075,2149,audio/Ti81_104005926.jpg,Ti81
2424,580.22171,580.22471,2,17406651,17406741,90,audio/Or61_17406651.jpg,Or61
2425,15272.258439,15272.287439,1,458167753,458168623,870,audio/Ti81_458167753.jpg,Ti81
2426,499.763221,499.774221,2,14992896,14993226,330,audio/Or61_14992896.jpg,Or61
2427,2156.809183,2156.812183,2,64704275,64704365,90,audio/Bl122_64704275.jpg,Bl122
2428,15341.783971,15341.856971,1,460253519,460255709,2190,audio/Ti81_460253519.jpg,Ti81
2429,2082.890961,2082.998961,1,62486728,62489968,3240,audio/Bl122_62486728.jpg,Bl122
2430,483.052221,483.090221,2,14491566,14492706,1140,audio/Or61_14491566.jpg,Or61
2431,705.126271,705.173271,1,21153788,21155198,1410,audio/Or61_21153788.jpg,Or61
2432,2005.424779,2005.428779,1,60162743,60162863,120,audio/Bl122_60162743.jpg,Bl122
2433,3450.15215,3450.322954,1,103504564,103509688,5124,audio/Ti81_103504564.jpg,Ti81
2434,705.801271,705.845271,1,21174038,21175358,1320,audio/Or61_21174038.jpg,Or61
2435,15078.038682,15078.232682,1,452341160,452346980,5820,audio/Ti81_452341160.jpg,Ti81
2436,15297.648664,15297.751664,1,458929459,458932549,3090,audio/Ti81_458929459.jpg,Ti81
2437,1787.999115,1788.007115,2,53639973,53640213,240,audio/Bl122_53639973.jpg,Bl122
2438,1980.347779,1980.355779,2,59410433,59410673,240,audio/Bl122_59410433.jpg,Bl122
2439,2036.777469,2036.879469,1,61103324,61106384,3060,audio/Bl122_61103324.jpg,Bl122
2440,15205.52858,15205.83558,1,456165857,456175067,9210,audio/Ti81_456165857.jpg,Ti81
2441,704.664271,704.781271,1,21139928,21143438,3510,audio/Or61_21139928.jpg,Or61
2442,490.061221,490.164221,2,14701836,14704926,3090,audio/Or61_14701836.jpg,Or61
2443,15240.303874,15240.384874,1,457209116,457211546,2430,audio/Ti81_457209116.jpg,Ti81
2444,2048.437469,2048.440469,2,61453124,61453214,90,audio/Bl122_61453124.jpg,Bl122
2445,1789.947115,1789.953115,2,53698413,53698593,180,audio/Bl122_53698413.jpg,Bl122
2446,2228.649183,2228.679183,2,66859475,66860375,900,audio/Bl122_66859475.jpg,Bl122
2447,2214.392183,2214.424183,1,66431765,66432725,960,audio/Bl122_66431765.jpg,Bl122
2448,557.361416,557.402416,1,16720842,16722072,1230,audio/Or61_16720842.jpg,Or61
2449,2157.705183,2158.014183,1,64731155,64740425,9270,audio/Bl122_64731155.jpg,Bl122
2450,1946.816779,1946.821779,2,58404503,58404653,150,audio/Bl122_58404503.jpg,Bl122
2451,1985.489779,1985.524779,2,59564693,59565743,1050,audio/Bl122_59564693.jpg,Bl122
2452,1793.087115,1793.091115,2,53792613,53792733,120,audio/Bl122_53792613.jpg,Bl122
2453,2118.556183,2118.741183,1,63556685,63562235,5550,audio/Bl122_63556685.jpg,Bl122
2454,1978.544779,1978.552779,2,59356343,59356583,240,audio/Bl122_59356343.jpg,Bl122
2455,811.485882,811.495882,1,24344576,24344876,300,audio/Or61_24344576.jpg,Or61
2456,15259.702114,15259.729114,1,457791063,457791873,810,audio/Ti81_457791063.jpg,Ti81
2457,736.799271,736.812271,1,22103978,22104368,390,audio/Or61_22103978.jpg,Or61
2458,2089.845961,2089.964961,1,62695378,62698948,3570,audio/Bl122_62695378.jpg,Bl122
2459,187.519971,187.549971,1,5625599,5626499,900,audio/Or61_5625599.jpg,Or61
2460,2148.448183,2148.491183,2,64453445,64454735,1290,audio/Bl122_64453445.jpg,Bl122
2461,2007.101779,2007.243779,1,60213053,60217313,4260,audio/Bl122_60213053.jpg,Bl122
2462,297.502379,297.714379,1,8925071,8931431,6360,audio/Or61_8925071.jpg,Or61
2463,503.594221,503.602221,2,15107826,15108066,240,audio/Or61_15107826.jpg,Or61
2464,7569.879558,7569.914558,1,227096386,227097436,1050,audio/Li145_227096386.jpg,Li145
2465,2013.485959,2013.505959,2,60404578,60405178,600,audio/Bl122_60404578.jpg,Bl122
2466,181.084971,181.201971,1,5432549,5436059,3510,audio/Or61_5432549.jpg,Or61
2467,2169.420183,2169.423183,2,65082605,65082695,90,audio/Bl122_65082605.jpg,Bl122
2468,3439.113963,3439.351373,1,103173418,103180541,7123,audio/Ti81_103173418.jpg,Ti81
2469,499.791221,500.057221,1,14993736,15001716,7980,audio/Or61_14993736.jpg,Or61
2470,606.069417,606.083417,2,18182082,18182502,420,audio/Or61_18182082.jpg,Or61
2471,1808.191926,1808.199926,2,54245757,54245997,240,audio/Bl122_54245757.jpg,Bl122
2472,565.743416,565.751416,2,16972302,16972542,240,audio/Or61_16972302.jpg,Or61
2473,1992.329779,1992.381779,1,59769893,59771453,1560,audio/Bl122_59769893.jpg,Bl122
2474,2176.158183,2176.166183,2,65284745,65284985,240,audio/Bl122_65284745.jpg,Bl122
2475,8091.705536,8091.727536,1,242751166,242751826,660,audio/Li145_242751166.jpg,Li145
2476,1801.261115,1801.264115,2,54037833,54037923,90,audio/Bl122_54037833.jpg,Bl122
2477,2125.688183,2125.743183,2,63770645,63772295,1650,audio/Bl122_63770645.jpg,Bl122
2478,789.649827,789.653827,2,23689494,23689614,120,audio/Or61_23689494.jpg,Or61
2479,536.735416,536.770416,1,16102062,16103112,1050,audio/Or61_16102062.jpg,Or61
2480,15108.350256,15108.406256,1,453250507,453252187,1680,audio/Ti81_453250507.jpg,Ti81
2481,9045.882911,9045.888911,1,271376487,271376667,180,audio/Li145_271376487.jpg,Li145
2482,1996.575779,1996.593779,2,59897273,59897813,540,audio/Bl122_59897273.jpg,Bl122
2483,14899.207236,14899.365047,1,446976217,446980951,4734,audio/Ti81_446976217.jpg,Ti81
2484,6957.039877,6957.057877,1,208711196,208711736,540,audio/Li145_208711196.jpg,Li145
2485,15055.473966,15055.489966,2,451664218,451664698,480,audio/Ti81_451664218.jpg,Ti81
2486,701.482271,701.529271,1,21044468,21045878,1410,audio/Or61_21044468.jpg,Or61
2487,2173.984183,2173.987183,2,65219525,65219615,90,audio/Bl122_65219525.jpg,Bl122
2488,2039.105815,2039.116815,1,61173174,61173504,330,audio/Li145_61173174.jpg,Li145
2489,612.074417,612.103417,1,18362232,18363102,870,audio/Or61_18362232.jpg,Or61
2490,593.030457,593.357457,1,17790913,17800723,9810,audio/Or61_17790913.jpg,Or61
2491,842.348268,842.564738,1,25270448,25276942,6494,audio/Ti81_25270448.jpg,Ti81
2492,3427.708182,3427.879239,1,102831245,102836377,5132,audio/Ti81_102831245.jpg,Ti81
2493,719.828271,719.849271,1,21594848,21595478,630,audio/Or61_21594848.jpg,Or61
2494,8097.752141,8097.766141,1,242932564,242932984,420,audio/Li145_242932564.jpg,Li145
2495,1956.681779,1956.691779,2,58700453,58700753,300,audio/Bl122_58700453.jpg,Bl122
2496,7546.883781,7546.978781,1,226406513,226409363,2850,audio/Li145_226406513.jpg,Li145
2497,6289.542659,6289.602659,1,188686279,188688079,1800,audio/Li145_188686279.jpg,Li145
2498,15127.809981,15127.877981,1,453834299,453836339,2040,audio/Ti81_453834299.jpg,Ti81
2499,454.201219,454.268219,1,13626036,13628046,2010,audio/Or61_13626036.jpg,Or61
2500,488.363221,488.367221,2,14650896,14651016,120,audio/Or61_14650896.jpg,Or61
2501,2085.050961,2085.054961,1,62551528,62551648,120,audio/Bl122_62551528.jpg,Bl122
2502,15151.044716,15151.222708,1,454531341,454536681,5340,audio/Ti81_454531341.jpg,Ti81
2503,787.535827,787.538827,1,23626074,23626164,90,audio/Or61_23626074.jpg,Or61
2504,2164.386183,2164.441183,1,64931585,64933235,1650,audio/Bl122_64931585.jpg,Bl122
2505,15262.306358,15262.330358,1,457869190,457869910,720,audio/Ti81_457869190.jpg,Ti81
2506,792.595827,792.609827,1,23777874,23778294,420,audio/Or61_23777874.jpg,Or61
2507,15062.985966,15063.149966,1,451889578,451894498,4920,audio/Ti81_451889578.jpg,Ti81
2508,2136.615183,2136.620183,2,64098455,64098605,150,audio/Bl122_64098455.jpg,Bl122
2509,2040.006469,2040.152469,1,61200194,61204574,4380,audio/Bl122_61200194.jpg,Bl122
2510,15263.982358,15264.012358,1,457919470,457920370,900,audio/Ti81_457919470.jpg,Ti81
2511,746.186271,746.193271,2,22385588,22385798,210,audio/Or61_22385588.jpg,Or61
2512,926.188883,926.358426,1,27785666,27790752,5086,audio/Ti81_27785666.jpg,Ti81
2513,1984.374779,1984.393779,2,59531243,59531813,570,audio/Bl122_59531243.jpg,Bl122
2514,2172.266183,2172.643183,1,65167985,65179295,11310,audio/Bl122_65167985.jpg,Bl122
2515,2055.973469,2055.977469,2,61679204,61679324,120,audio/Bl122_61679204.jpg,Bl122
2516,611.796417,611.824417,1,18353892,18354732,840,audio/Or61_18353892.jpg,Or61
2517,15335.82001,15335.88401,1,460074600,460076520,1920,audio/Ti81_460074600.jpg,Ti81
2518,386.431161,386.503161,1,11592934,11595094,2160,audio/Or61_11592934.jpg,Or61
2519,1999.217779,1999.652779,1,59976533,59989583,13050,audio/Bl122_59976533.jpg,Bl122
2520,564.193416,564.285416,1,16925802,16928562,2760,audio/Or61_16925802.jpg,Or61
2521,492.876221,493.066221,1,14786286,14791986,5700,audio/Or61_14786286.jpg,Or61
2522,605.951417,606.016417,1,18178542,18180492,1950,audio/Or61_18178542.jpg,Or61
2523,15039.815126,15039.971928,1,451194453,451199157,4704,audio/Ti81_451194453.jpg,Ti81
2524,550.093416,550.109416,2,16502802,16503282,480,audio/Or61_16502802.jpg,Or61
2525,2200.769183,2200.783183,2,66023075,66023495,420,audio/Bl122_66023075.jpg,Bl122
2526,1942.497779,1942.502779,2,58274933,58275083,150,audio/Bl122_58274933.jpg,Bl122
2527,709.005271,709.160271,1,21270158,21274808,4650,audio/Or61_21270158.jpg,Or61
2528,2158.505183,2158.534183,2,64755155,64756025,870,audio/Bl122_64755155.jpg,Bl122
2529,2189.084183,2189.096183,2,65672525,65672885,360,audio/Bl122_65672525.jpg,Bl122
2530,1953.465779,1953.638779,1,58603973,58609163,5190,audio/Bl122_58603973.jpg,Bl122
2531,2165.445183,2165.449183,2,64963355,64963475,120,audio/Bl122_64963355.jpg,Bl122
2532,2008.817779,2008.862779,1,60264533,60265883,1350,audio/Bl122_60264533.jpg,Bl122
2533,1787.112115,1787.132115,1,53613363,53613963,600,audio/Bl122_53613363.jpg,Bl122
2534,2055.058469,2055.062469,2,61651754,61651874,120,audio/Bl122_61651754.jpg,Bl122
2535,2189.234183,2189.307183,1,65677025,65679215,2190,audio/Bl122_65677025.jpg,Bl122
2536,563.206416,563.232416,1,16896192,16896972,780,audio/Or61_16896192.jpg,Or61
2537,2122.813183,2122.821183,2,63684395,63684635,240,audio/Bl122_63684395.jpg,Bl122
2538,2006.073779,2006.147779,2,60182213,60184433,2220,audio/Bl122_60182213.jpg,Bl122
2539,2200.118183,2200.348183,1,66003545,66010445,6900,audio/Bl122_66003545.jpg,Bl122
2540,2176.934183,2177.038183,2,65308025,65311145,3120,audio/Bl122_65308025.jpg,Bl122
2541,2086.117961,2086.121961,2,62583538,62583658,120,audio/Bl122_62583538.jpg,Bl122
2542,1948.730779,1948.927779,1,58461923,58467833,5910,audio/Bl122_58461923.jpg,Bl122
2543,6426.260227,6426.280663,1,192787806,192788419,613,audio/Ti81_192787806.jpg,Ti81
2544,15288.681439,15289.021439,1,458660443,458670643,10200,audio/Ti81_458660443.jpg,Ti81
2545,1979.895779,1979.909779,2,59396873,59397293,420,audio/Bl122_59396873.jpg,Bl122
2546,1965.781779,1965.788779,2,58973453,58973663,210,audio/Bl122_58973453.jpg,Bl122
2547,716.947271,717.001271,1,21508418,21510038,1620,audio/Or61_21508418.jpg,Or61
2548,391.642161,391.659161,1,11749264,11749774,510,audio/Or61_11749264.jpg,Or61
2549,2055.203469,2055.235469,1,61656104,61657064,960,audio/Bl122_61656104.jpg,Bl122
2550,2198.348183,2198.619183,1,65950445,65958575,8130,audio/Bl122_65950445.jpg,Bl122
2551,2057.352469,2057.358469,2,61720574,61720754,180,audio/Bl122_61720574.jpg,Bl122
2552,541.160416,541.192416,1,16234812,16235772,960,audio/Or61_16234812.jpg,Or61
2553,531.344416,531.384416,2,15940332,15941532,1200,audio/Or61_15940332.jpg,Or61
2554,7491.329261,7491.356261,1,224739877,224740687,810,audio/Li145_224739877.jpg,Li145
2555,2224.070183,2224.082183,2,66722105,66722465,360,audio/Bl122_66722105.jpg,Bl122
2556,15305.609373,15305.700373,1,459168281,459171011,2730,audio/Ti81_459168281.jpg,Ti81
2557,1782.193323,1782.504323,1,53465799,53475129,9330,audio/Bl122_53465799.jpg,Bl122
2558,2085.904961,2085.943961,1,62577148,62578318,1170,audio/Bl122_62577148.jpg,Bl122
2559,625.776417,625.818417,1,18773292,18774552,1260,audio/Or61_18773292.jpg,Or61
2560,2041.939469,2041.945469,2,61258184,61258364,180,audio/Bl122_61258184.jpg,Bl122
2561,472.988221,473.168221,1,14189646,14195046,5400,audio/Or61_14189646.jpg,Or61
2562,423.921593,423.925593,2,12717647,12717767,120,audio/Or61_12717647.jpg,Or61
2563,6953.463285,6953.505285,1,208603898,208605158,1260,audio/Li145_208603898.jpg,Li145
2564,2120.001183,2120.006183,2,63600035,63600185,150,audio/Bl122_63600035.jpg,Bl122
2565,1935.141613,1935.144613,2,58054248,58054338,90,audio/Bl122_58054248.jpg,Bl122
2566,529.919416,529.926416,2,15897582,15897792,210,audio/Or61_15897582.jpg,Or61
2567,626.818417,627.006417,1,18804552,18810192,5640,audio/Or61_18804552.jpg,Or61
2568,934.557277,934.710673,1,28036718,28041320,4602,audio/Ti81_28036718.jpg,Ti81
2569,2198.118183,2198.207183,1,65943545,65946215,2670,audio/Bl122_65943545.jpg,Bl122
2570,2191.418183,2191.652183,1,65742545,65749565,7020,audio/Bl122_65742545.jpg,Bl122
2571,2220.629183,2220.708183,1,66618875,66621245,2370,audio/Bl122_66618875.jpg,Bl122
2572,1966.265779,1966.268779,2,58987973,58988063,90,audio/Bl122_58987973.jpg,Bl122
2573,1969.399779,1969.420779,2,59081993,59082623,630,audio/Bl122_59081993.jpg,Bl122
2574,391.444161,391.636161,1,11743324,11749084,5760,audio/Or61_11743324.jpg,Or61
2575,6956.993877,6957.003877,1,208709816,208710116,300,audio/Li145_208709816.jpg,Li145
2576,3546.160983,3546.364081,1,106384829,106390922,6093,audio/Ti81_106384829.jpg,Ti81
2577,1812.068013,1812.150013,1,54362040,54364500,2460,audio/Bl122_54362040.jpg,Bl122
2578,2029.437908,2029.586908,1,60883137,60887607,4470,audio/Bl122_60883137.jpg,Bl122
2579,15093.541823,15093.562823,1,452806254,452806884,630,audio/Ti81_452806254.jpg,Ti81
2580,5967.621227,5967.757227,1,179028636,179032716,4080,audio/Li145_179028636.jpg,Li145
2581,766.391271,766.416271,1,22991738,22992488,750,audio/Or61_22991738.jpg,Or61
2582,747.886271,747.905271,1,22436588,22437158,570,audio/Or61_22436588.jpg,Or61
2583,15099.375823,15099.561823,1,452981274,452986854,5580,audio/Ti81_452981274.jpg,Ti81
2584,2092.227961,2092.234961,2,62766838,62767048,210,audio/Bl122_62766838.jpg,Bl122
2585,806.667882,806.740882,1,24200036,24202226,2190,audio/Or61_24200036.jpg,Or61
2586,5720.950018,5721.111018,1,171628500,171633330,4830,audio/Li145_171628500.jpg,Li145
2587,627.109417,627.173417,2,18813282,18815202,1920,audio/Or61_18813282.jpg,Or61
2588,2126.239183,2126.310183,2,63787175,63789305,2130,audio/Bl122_63787175.jpg,Bl122
2589,2208.127183,2208.133183,2,66243815,66243995,180,audio/Bl122_66243815.jpg,Bl122
2590,2202.727183,2202.748183,1,66081815,66082445,630,audio/Bl122_66081815.jpg,Bl122
2591,1770.226657,1770.480657,2,53106799,53114419,7620,audio/Bl122_53106799.jpg,Bl122
2592,2215.473183,2215.477183,2,66464195,66464315,120,audio/Bl122_66464195.jpg,Bl122
2593,15120.298981,15120.552981,1,453608969,453616589,7620,audio/Ti81_453608969.jpg,Ti81
2594,15069.004682,15069.236682,1,452070140,452077100,6960,audio/Ti81_452070140.jpg,Ti81
2595,9175.636719,9175.880719,1,275269101,275276421,7320,audio/Li145_275269101.jpg,Li145
2596,2013.757959,2013.762959,2,60412738,60412888,150,audio/Bl122_60412738.jpg,Bl122
2597,2072.588469,2072.592469,2,62177654,62177774,120,audio/Bl122_62177654.jpg,Bl122
2598,2194.738183,2194.745183,2,65842145,65842355,210,audio/Bl122_65842145.jpg,Bl122
2599,8111.660849,8111.802849,1,243349825,243354085,4260,audio/Li145_243349825.jpg,Li145
2600,214.227857,214.509857,1,6426835,6435295,8460,audio/Or61_6426835.jpg,Or61
2601,712.197271,712.213271,1,21365918,21366398,480,audio/Or61_21365918.jpg,Or61
2602,2138.320183,2138.324183,2,64149605,64149725,120,audio/Bl122_64149605.jpg,Bl122
2603,15231.005443,15231.048443,1,456930163,456931453,1290,audio/Ti81_456930163.jpg,Ti81
2604,2165.645183,2165.650183,2,64969355,64969505,150,audio/Bl122_64969355.jpg,Bl122
2605,2081.342287,2081.345287,2,62440268,62440358,90,audio/Bl122_62440268.jpg,Bl122
2606,1997.058779,1997.120779,2,59911763,59913623,1860,audio/Bl122_59911763.jpg,Bl122
2607,767.484271,767.525271,1,23024528,23025758,1230,audio/Or61_23024528.jpg,Or61
2608,14942.876394,14942.93194,1,448286291,448287958,1667,audio/Ti81_448286291.jpg,Ti81
2609,598.730417,598.737417,2,17961912,17962122,210,audio/Or61_17961912.jpg,Or61
2610,2068.589469,2068.596469,2,62057684,62057894,210,audio/Bl122_62057684.jpg,Bl122
2611,15054.586966,15054.633966,1,451637608,451639018,1410,audio/Ti81_451637608.jpg,Ti81
2612,2107.275377,2107.318377,1,63218261,63219551,1290,audio/Bl122_63218261.jpg,Bl122
2613,15263.690358,15263.748358,1,457910710,457912450,1740,audio/Ti81_457910710.jpg,Ti81
2614,577.90771,577.98071,1,17337231,17339421,2190,audio/Or61_17337231.jpg,Or61
2615,2066.730469,2066.740469,2,62001914,62002214,300,audio/Bl122_62001914.jpg,Bl122
2616,1986.736779,1986.821779,1,59602103,59604653,2550,audio/Bl122_59602103.jpg,Bl122
2617,15164.467257,15164.502257,1,454934017,454935067,1050,audio/Ti81_454934017.jpg,Ti81
2618,636.401417,636.437417,2,19092042,19093122,1080,audio/Or61_19092042.jpg,Or61
2619,2221.166183,2221.170183,2,66634985,66635105,120,audio/Bl122_66634985.jpg,Bl122
2620,1975.264779,1975.285779,2,59257943,59258573,630,audio/Bl122_59257943.jpg,Bl122
2621,766.226271,766.245271,1,22986788,22987358,570,audio/Or61_22986788.jpg,Or61
2622,498.032221,498.224221,1,14940966,14946726,5760,audio/Or61_14940966.jpg,Or61
2623,2145.916183,2145.963183,2,64377485,64378895,1410,audio/Bl122_64377485.jpg,Bl122
2624,2156.146183,2156.152183,2,64684385,64684565,180,audio/Bl122_64684385.jpg,Bl122
2625,15235.593874,15235.619874,1,457067816,457068596,780,audio/Ti81_457067816.jpg,Ti81
2626,2095.996961,2096.000961,2,62879908,62880028,120,audio/Bl122_62879908.jpg,Bl122
2627,2176.274183,2176.285183,2,65288225,65288555,330,audio/Bl122_65288225.jpg,Bl122
2628,1767.090823,1767.094823,2,53012724,53012844,120,audio/Bl122_53012724.jpg,Bl122
2629,497.350221,497.591221,1,14920506,14927736,7230,audio/Or61_14920506.jpg,Or61
2630,2041.767469,2041.937469,2,61253024,61258124,5100,audio/Bl122_61253024.jpg,Bl122
2631,15156.326257,15156.385257,1,454689787,454691557,1770,audio/Ti81_454689787.jpg,Ti81
2632,15048.371966,15048.675966,1,451451158,451460278,9120,audio/Ti81_451451158.jpg,Ti81
2633,1945.150779,1945.255779,2,58354523,58357673,3150,audio/Bl122_58354523.jpg,Bl122
2634,2144.325183,2144.368183,2,64329755,64331045,1290,audio/Bl122_64329755.jpg,Bl122
2635,2084.779961,2084.784961,2,62543398,62543548,150,audio/Bl122_62543398.jpg,Bl122
2636,1975.073779,1975.097779,2,59252213,59252933,720,audio/Bl122_59252213.jpg,Bl122
2637,7531.194966,7531.214966,1,225935848,225936448,600,audio/Li145_225935848.jpg,Li145
2638,2205.905183,2205.908183,2,66177155,66177245,90,audio/Bl122_66177155.jpg,Bl122
2639,2159.118183,2159.127183,2,64773545,64773815,270,audio/Bl122_64773545.jpg,Bl122
2640,1961.050779,1961.059779,2,58831523,58831793,270,audio/Bl122_58831523.jpg,Bl122
2641,2038.990815,2039.003815,1,61169724,61170114,390,audio/Li145_61169724.jpg,Li145
2642,471.772221,471.802221,1,14153166,14154066,900,audio/Or61_14153166.jpg,Or61
2643,2034.305469,2034.364469,1,61029164,61030934,1770,audio/Bl122_61029164.jpg,Bl122
2644,9165.859583,9165.934583,1,274975787,274978037,2250,audio/Li145_274975787.jpg,Li145
2645,6949.388842,6949.394842,1,208481665,208481845,180,audio/Li145_208481665.jpg,Li145
2646,600.417417,600.591417,1,18012522,18017742,5220,audio/Or61_18012522.jpg,Or61
2647,15163.801257,15163.926257,1,454914037,454917787,3750,audio/Ti81_454914037.jpg,Ti81
2648,15304.022373,15304.087373,1,459120671,459122621,1950,audio/Ti81_459120671.jpg,Ti81
2649,496.931221,497.029221,1,14907936,14910876,2940,audio/Or61_14907936.jpg,Or61
2650,1998.716779,1998.794779,1,59961503,59963843,2340,audio/Bl122_59961503.jpg,Bl122
2651,1970.067779,1970.072779,2,59102033,59102183,150,audio/Bl122_59102033.jpg,Bl122
2652,15217.11158,15217.42558,1,456513347,456522767,9420,audio/Ti81_456513347.jpg,Ti81
2653,2142.448183,2142.458183,2,64273445,64273745,300,audio/Bl122_64273445.jpg,Bl122
2654,2142.121183,2142.125183,2,64263635,64263755,120,audio/Bl122_64263635.jpg,Bl122
2655,2136.510183,2136.592183,2,64095305,64097765,2460,audio/Bl122_64095305.jpg,Bl122
2656,605.154417,605.180417,1,18154632,18155412,780,audio/Or61_18154632.jpg,Or61
2657,6302.854561,6302.993561,1,189085636,189089806,4170,audio/Li145_189085636.jpg,Li145
2658,508.677221,508.870221,1,15260316,15266106,5790,audio/Or61_15260316.jpg,Or61
2659,2044.753469,2044.756469,2,61342604,61342694,90,audio/Bl122_61342604.jpg,Bl122
2660,2054.108469,2054.268469,1,61623254,61628054,4800,audio/Bl122_61623254.jpg,Bl122
2661,2098.790961,2098.793961,2,62963728,62963818,90,audio/Bl122_62963728.jpg,Bl122
2662,2118.989183,2119.014183,1,63569675,63570425,750,audio/Bl122_63569675.jpg,Bl122
2663,2191.117183,2191.123183,2,65733515,65733695,180,audio/Bl122_65733515.jpg,Bl122
2664,498.251221,498.312221,1,14947536,14949366,1830,audio/Or61_14947536.jpg,Or61
2665,483.624221,483.640221,2,14508726,14509206,480,audio/Or61_14508726.jpg,Or61
2666,15056.041966,15056.257966,1,451681258,451687738,6480,audio/Ti81_451681258.jpg,Ti81
2667,1947.709779,1947.744779,1,58431293,58432343,1050,audio/Bl122_58431293.jpg,Bl122
2668,2143.691183,2143.695183,2,64310735,64310855,120,audio/Bl122_64310735.jpg,Bl122
2669,489.117221,489.328221,1,14673516,14679846,6330,audio/Or61_14673516.jpg,Or61
2670,764.893271,764.925271,1,22946798,22947758,960,audio/Or61_22946798.jpg,Or61
2671,447.910112,448.119112,1,13437303,13443573,6270,audio/Or61_13437303.jpg,Or61
2672,3427.510382,3427.652288,1,102825311,102829568,4257,audio/Ti81_102825311.jpg,Ti81
2673,1749.407057,1749.618057,1,52482211,52488541,6330,audio/Bl122_52482211.jpg,Bl122
2674,2107.067377,2107.163377,1,63212021,63214901,2880,audio/Bl122_63212021.jpg,Bl122
2675,714.586271,714.652271,1,21437588,21439568,1980,audio/Or61_21437588.jpg,Or61
2676,2192.809183,2192.816183,2,65784275,65784485,210,audio/Bl122_65784275.jpg,Bl122
2677,2207.091183,2207.102183,2,66212735,66213065,330,audio/Bl122_66212735.jpg,Bl122
2678,558.428416,558.459416,1,16752852,16753782,930,audio/Or61_16752852.jpg,Or61
2679,729.649271,729.769271,1,21889478,21893078,3600,audio/Or61_21889478.jpg,Or61
2680,15028.450721,15028.633131,1,450853521,450858993,5472,audio/Ti81_450853521.jpg,Ti81
2681,1991.682779,1991.691779,2,59750483,59750753,270,audio/Bl122_59750483.jpg,Bl122
2682,1958.184779,1958.224779,1,58745543,58746743,1200,audio/Bl122_58745543.jpg,Bl122
2683,536.825416,536.877416,1,16104762,16106322,1560,audio/Or61_16104762.jpg,Or61
2684,15252.341074,15252.364074,1,457570232,457570922,690,audio/Ti81_457570232.jpg,Ti81
2685,1995.886779,1995.922779,1,59876603,59877683,1080,audio/Bl122_59876603.jpg,Bl122
2686,2172.750183,2172.756183,2,65182505,65182685,180,audio/Bl122_65182505.jpg,Bl122
2687,1975.797779,1976.191779,1,59273933,59285753,11820,audio/Bl122_59273933.jpg,Bl122
2688,15307.805373,15307.833373,1,459234161,459235001,840,audio/Ti81_459234161.jpg,Ti81
2689,1979.224779,1979.233779,2,59376743,59377013,270,audio/Bl122_59376743.jpg,Bl122
2690,5764.33172,5764.41672,1,172929951,172932501,2550,audio/Li145_172929951.jpg,Li145
2691,1782.591323,1782.594323,2,53477739,53477829,90,audio/Bl122_53477739.jpg,Bl122
2692,15251.993074,15252.042074,1,457559792,457561262,1470,audio/Ti81_457559792.jpg,Ti81
2693,470.040221,470.223221,1,14101206,14106696,5490,audio/Or61_14101206.jpg,Or61
2694,502.287221,502.297221,2,15068616,15068916,300,audio/Or61_15068616.jpg,Or61
2695,2196.273183,2196.281183,2,65888195,65888435,240,audio/Bl122_65888195.jpg,Bl122
2696,3471.43808,3471.586934,1,104143142,104147608,4466,audio/Ti81_104143142.jpg,Ti81
2697,764.425271,764.436271,1,22932758,22933088,330,audio/Or61_22932758.jpg,Or61
2698,722.690271,722.725271,1,21680708,21681758,1050,audio/Or61_21680708.jpg,Or61
2699,2096.018961,2096.024961,2,62880568,62880748,180,audio/Bl122_62880568.jpg,Bl122
2700,3425.756675,3425.784757,1,102772700,102773542,842,audio/Ti81_102772700.jpg,Ti81
2701,2202.439183,2202.484183,2,66073175,66074525,1350,audio/Bl122_66073175.jpg,Bl122
2702,1970.447779,1970.454779,2,59113433,59113643,210,audio/Bl122_59113433.jpg,Bl122
2703,15285.299439,15285.365439,1,458558983,458560963,1980,audio/Ti81_458558983.jpg,Ti81
2704,3419.398825,3419.417495,1,102581964,102582524,560,audio/Ti81_102581964.jpg,Ti81
2705,805.353882,805.373882,1,24160616,24161216,600,audio/Or61_24160616.jpg,Or61
2706,410.036602,410.162602,1,12301098,12304878,3780,audio/Or61_12301098.jpg,Or61
2707,5841.553404,5841.584404,1,175246602,175247532,930,audio/Li145_175246602.jpg,Li145
2708,2095.596961,2095.599961,2,62867908,62867998,90,audio/Bl122_62867908.jpg,Bl122
2709,2172.829183,2172.951183,1,65184875,65188535,3660,audio/Bl122_65184875.jpg,Bl122
2710,612.117417,612.238417,1,18363522,18367152,3630,audio/Or61_18363522.jpg,Or61
2711,1997.017779,1997.044779,2,59910533,59911343,810,audio/Bl122_59910533.jpg,Bl122
2712,720.293271,720.311271,1,21608798,21609338,540,audio/Or61_21608798.jpg,Or61
2713,3415.870219,3415.945403,1,102476106,102478362,2256,audio/Ti81_102476106.jpg,Ti81
2714,5968.821227,5968.829227,1,179064636,179064876,240,audio/Li145_179064636.jpg,Li145
2715,15028.752971,15028.808981,1,450862589,450864269,1680,audio/Ti81_450862589.jpg,Ti81
2716,9536.781343,9536.802343,1,286103440,286104070,630,audio/Li145_286103440.jpg,Li145
2717,2185.116183,2185.204183,2,65553485,65556125,2640,audio/Bl122_65553485.jpg,Bl122
2718,2071.240469,2071.407469,1,62137214,62142224,5010,audio/Bl122_62137214.jpg,Bl122
2719,934.092801,934.260578,1,28022784,28027817,5033,audio/Ti81_28022784.jpg,Ti81
2720,15123.949981,15123.970981,1,453718499,453719129,630,audio/Ti81_453718499.jpg,Ti81
2721,2150.584183,2150.988183,1,64517525,64529645,12120,audio/Bl122_64517525.jpg,Bl122
2722,2157.436183,2157.465183,2,64723085,64723955,870,audio/Bl122_64723085.jpg,Bl122
2723,755.223271,755.281271,1,22656698,22658438,1740,audio/Or61_22656698.jpg,Or61
2724,2176.172183,2176.192183,2,65285165,65285765,600,audio/Bl122_65285165.jpg,Bl122
2725,15340.268971,15340.332971,1,460208069,460209989,1920,audio/Ti81_460208069.jpg,Ti81
2726,2177.881183,2177.887183,2,65336435,65336615,180,audio/Bl122_65336435.jpg,Bl122
2727,475.218221,475.279221,1,14256546,14258376,1830,audio/Or61_14256546.jpg,Or61
2728,550.658416,550.665416,2,16519752,16519962,210,audio/Or61_16519752.jpg,Or61
2729,476.822221,476.828221,2,14304666,14304846,180,audio/Or61_14304666.jpg,Or61
2730,3427.364177,3427.399372,1,102820925,102821981,1056,audio/Ti81_102820925.jpg,Ti81
2731,15304.696373,15304.762373,1,459140891,459142871,1980,audio/Ti81_459140891.jpg,Ti81
2732,1789.754115,1789.765115,2,53692623,53692953,330,audio/Bl122_53692623.jpg,Bl122
2733,749.297271,749.351271,1,22478918,22480538,1620,audio/Or61_22478918.jpg,Or61
2734,15047.136966,15047.198966,1,451414108,451415968,1860,audio/Ti81_451414108.jpg,Ti81
2735,803.165882,803.180882,2,24094976,24095426,450,audio/Or61_24094976.jpg,Or61
2736,2006.810779,2006.814779,2,60204323,60204443,120,audio/Bl122_60204323.jpg,Bl122
2737,2140.633183,2140.658183,2,64218995,64219745,750,audio/Bl122_64218995.jpg,Bl122
2738,2226.888183,2226.901183,2,66806645,66807035,390,audio/Bl122_66806645.jpg,Bl122
2739,815.985882,815.992882,2,24479576,24479786,210,audio/Or61_24479576.jpg,Or61
2740,760.967271,761.175271,1,22829018,22835258,6240,audio/Or61_22829018.jpg,Or61
2741,9134.591751,9134.674751,1,274037752,274040242,2490,audio/Li145_274037752.jpg,Li145
2742,15335.90201,15336.03301,1,460077060,460080990,3930,audio/Ti81_460077060.jpg,Ti81
2743,8992.206567,8992.322567,1,269766197,269769677,3480,audio/Li145_269766197.jpg,Li145
2744,2089.031961,2089.188961,1,62670958,62675668,4710,audio/Bl122_62670958.jpg,Bl122
2745,1973.760779,1973.767779,2,59212823,59213033,210,audio/Bl122_59212823.jpg,Bl122
2746,1983.214779,1983.217779,2,59496443,59496533,90,audio/Bl122_59496443.jpg,Bl122
2747,2211.183183,2211.188183,2,66335495,66335645,150,audio/Bl122_66335495.jpg,Bl122
2748,2162.492183,2162.559183,1,64874765,64876775,2010,audio/Bl122_64874765.jpg,Bl122
2749,1957.629779,1957.640779,2,58728893,58729223,330,audio/Bl122_58728893.jpg,Bl122
2750,3466.806941,3466.830153,1,104004208,104004904,696,audio/Ti81_104004208.jpg,Ti81
2751,490.196221,490.398221,1,14705886,14711946,6060,audio/Or61_14705886.jpg,Or61
2752,1982.011779,1982.147779,1,59460353,59464433,4080,audio/Bl122_59460353.jpg,Bl122
2753,1808.573926,1808.604926,2,54257217,54258147,930,audio/Bl122_54257217.jpg,Bl122
2754,1992.388779,1992.399779,1,59771663,59771993,330,audio/Bl122_59771663.jpg,Bl122
2755,2180.408183,2180.426183,2,65412245,65412785,540,audio/Bl122_65412245.jpg,Bl122
2756,4904.104735,4904.270735,1,147123142,147128122,4980,audio/Li145_147123142.jpg,Li145
2757,15211.66558,15211.83858,1,456349967,456355157,5190,audio/Ti81_456349967.jpg,Ti81
2758,15329.891625,15329.946625,1,459896748,459898398,1650,audio/Ti81_459896748.jpg,Ti81
2759,1983.516779,1983.576779,1,59505503,59507303,1800,audio/Bl122_59505503.jpg,Bl122
2760,794.347827,794.376827,1,23830434,23831304,870,audio/Or61_23830434.jpg,Or61
2761,3429.569706,3429.624706,1,102887091,102888741,1650,audio/Ti81_102887091.jpg,Ti81
2762,101.388905,101.434905,1,3041667,3043047,1380,audio/Bl122_3041667.jpg,Bl122
2763,1998.950779,1999.004779,2,59968523,59970143,1620,audio/Bl122_59968523.jpg,Bl122
2764,717.545271,717.735271,1,21526358,21532058,5700,audio/Or61_21526358.jpg,Or61
2765,15297.792664,15297.809664,1,458933779,458934289,510,audio/Ti81_458933779.jpg,Ti81
2766,1486.367018,1486.375018,1,44591010,44591250,240,audio/Li145_44591010.jpg,Li145
2767,2207.176183,2207.188183,2,66215285,66215645,360,audio/Bl122_66215285.jpg,Bl122
2768,469.930221,469.978221,1,14097906,14099346,1440,audio/Or61_14097906.jpg,Or61
2769,2038.240469,2038.253469,2,61147214,61147604,390,audio/Bl122_61147214.jpg,Bl122
2770,1970.143779,1970.159779,2,59104313,59104793,480,audio/Bl122_59104313.jpg,Bl122
2771,15287.833439,15287.895439,1,458635003,458636863,1860,audio/Ti81_458635003.jpg,Ti81
2772,15120.116981,15120.177981,1,453603509,453605339,1830,audio/Ti81_453603509.jpg,Ti81
2773,3646.768803,3646.814803,1,109403064,109404444,1380,audio/Li145_109403064.jpg,Li145
2774,675.785078,675.896078,1,20273552,20276882,3330,audio/Or61_20273552.jpg,Or61
2775,15117.84976,15118.020981,1,453535492,453540629,5137,audio/Ti81_453535492.jpg,Ti81
2776,1959.303779,1959.328779,1,58779113,58779863,750,audio/Bl122_58779113.jpg,Bl122
2777,2162.035183,2162.042183,2,64861055,64861265,210,audio/Bl122_64861055.jpg,Bl122
2778,530.342416,530.363416,2,15910272,15910902,630,audio/Or61_15910272.jpg,Or61
2779,2223.951183,2223.979183,2,66718535,66719375,840,audio/Bl122_66718535.jpg,Bl122
2780,3546.613538,3546.76952,1,106398406,106403085,4679,audio/Ti81_106398406.jpg,Ti81
2781,483.128221,483.141221,2,14493846,14494236,390,audio/Or61_14493846.jpg,Or61
2782,2200.797183,2200.829183,2,66023915,66024875,960,audio/Bl122_66023915.jpg,Bl122
2783,15282.927439,15283.027439,1,458487823,458490823,3000,audio/Ti81_458487823.jpg,Ti81
2784,15280.173439,15280.429439,1,458405203,458412883,7680,audio/Ti81_458405203.jpg,Ti81
2785,811.655882,811.678882,1,24349676,24350366,690,audio/Or61_24349676.jpg,Or61
2786,2206.666183,2206.709183,2,66199985,66201275,1290,audio/Bl122_66199985.jpg,Bl122
2787,762.585271,762.614271,1,22877558,22878428,870,audio/Or61_22877558.jpg,Or61
2788,3411.932893,3412.119953,1,102357986,102363598,5612,audio/Ti81_102357986.jpg,Ti81
2789,5719.941018,5719.965018,1,171598230,171598950,720,audio/Li145_171598230.jpg,Li145
2790,616.589417,616.644417,1,18497682,18499332,1650,audio/Or61_18497682.jpg,Or61
2791,1954.065779,1954.101779,2,58621973,58623053,1080,audio/Bl122_58621973.jpg,Bl122
2792,2052.560469,2052.622469,2,61576814,61578674,1860,audio/Bl122_61576814.jpg,Bl122
2793,183.902971,183.914971,2,5517089,5517449,360,audio/Or61_5517089.jpg,Or61
2794,390.714161,390.719161,2,11721424,11721574,150,audio/Or61_11721424.jpg,Or61
2795,15224.086443,15224.118443,1,456722593,456723553,960,audio/Ti81_456722593.jpg,Ti81
2796,2217.185183,2217.200183,2,66515555,66516005,450,audio/Bl122_66515555.jpg,Bl122
2797,2084.996961,2084.998961,1,62549908,62549968,60,audio/Bl122_62549908.jpg,Bl122
2798,2183.829183,2183.887183,1,65514875,65516615,1740,audio/Bl122_65514875.jpg,Bl122
2799,2064.151469,2064.154469,2,61924544,61924634,90,audio/Bl122_61924544.jpg,Bl122
2800,532.899416,532.904416,2,15986982,15987132,150,audio/Or61_15986982.jpg,Or61
2801,1807.282926,1807.353926,1,54218487,54220617,2130,audio/Bl122_54218487.jpg,Bl122
2802,2084.295961,2084.314961,1,62528878,62529448,570,audio/Bl122_62528878.jpg,Bl122
2803,15074.374682,15074.411682,1,452231240,452232350,1110,audio/Ti81_452231240.jpg,Ti81
2804,15052.372966,15052.475966,1,451571188,451574278,3090,audio/Ti81_451571188.jpg,Ti81
2805,2228.187183,2228.222183,1,66845615,66846665,1050,audio/Bl122_66845615.jpg,Bl122
2806,513.785221,514.141221,1,15413556,15424236,10680,audio/Or61_15413556.jpg,Or61
2807,503.190221,503.198221,2,15095706,15095946,240,audio/Or61_15095706.jpg,Or61
2808,14780.149683,14780.362368,1,443404490,443410871,6381,audio/Ti81_443404490.jpg,Ti81
2809,485.388221,485.416221,1,14561646,14562486,840,audio/Or61_14561646.jpg,Or61
2810,2078.385823,2078.524823,1,62351574,62355744,4170,audio/Bl122_62351574.jpg,Bl122
2811,551.372416,551.446416,1,16541172,16543392,2220,audio/Or61_16541172.jpg,Or61
2812,2039.047469,2039.274469,1,61171424,61178234,6810,audio/Bl122_61171424.jpg,Bl122
2813,15286.436439,15286.553439,1,458593093,458596603,3510,audio/Ti81_458593093.jpg,Ti81
2814,2183.949183,2183.953183,2,65518475,65518595,120,audio/Bl122_65518475.jpg,Bl122
2815,15067.958682,15068.066682,1,452038760,452042000,3240,audio/Ti81_452038760.jpg,Ti81
2816,3409.622243,3409.789263,1,102288667,102293677,5010,audio/Ti81_102288667.jpg,Ti81
2817,504.415221,504.419221,2,15132456,15132576,120,audio/Or61_15132456.jpg,Or61
2818,758.562271,758.645271,1,22756868,22759358,2490,audio/Or61_22756868.jpg,Or61
2819,2144.960183,2145.203183,1,64348805,64356095,7290,audio/Bl122_64348805.jpg,Bl122
2820,485.180221,485.192221,1,14555406,14555766,360,audio/Or61_14555406.jpg,Or61
2821,503.062221,503.069221,2,15091866,15092076,210,audio/Or61_15091866.jpg,Or61
2822,474.783221,474.834221,1,14243496,14245026,1530,audio/Or61_14243496.jpg,Or61
2823,3416.750226,3416.783655,1,102502506,102503509,1003,audio/Ti81_102502506.jpg,Ti81
2824,9047.077911,9047.085911,1,271412337,271412577,240,audio/Li145_271412337.jpg,Li145
2825,406.427692,406.430692,2,12192830,12192920,90,audio/Or61_12192830.jpg,Or61
2826,2060.007469,2060.030469,1,61800224,61800914,690,audio/Bl122_61800224.jpg,Bl122
2827,753.869271,753.917271,1,22616078,22617518,1440,audio/Or61_22616078.jpg,Or61
2828,486.508221,486.566221,2,14595246,14596986,1740,audio/Or61_14595246.jpg,Or61
2829,5969.982227,5969.991227,1,179099466,179099736,270,audio/Li145_179099466.jpg,Li145
2830,2210.055183,2210.065183,2,66301655,66301955,300,audio/Bl122_66301655.jpg,Bl122
2831,2139.476183,2139.518183,2,64184285,64185545,1260,audio/Bl122_64184285.jpg,Bl122
2832,6956.900877,6956.926877,1,208707026,208707806,780,audio/Li145_208707026.jpg,Li145
2833,2011.723959,2011.844959,1,60351718,60355348,3630,audio/Bl122_60351718.jpg,Bl122
2834,530.860416,530.868416,2,15925812,15926052,240,audio/Or61_15925812.jpg,Or61
2835,2013.711959,2013.743959,2,60411358,60412318,960,audio/Bl122_60411358.jpg,Bl122
2836,2144.600183,2144.604183,2,64338005,64338125,120,audio/Bl122_64338005.jpg,Bl122
2837,2116.693183,2116.703183,2,63500795,63501095,300,audio/Bl122_63500795.jpg,Bl122
2838,15151.669716,15151.820716,1,454550091,454554621,4530,audio/Ti81_454550091.jpg,Ti81
2839,1783.137323,1783.161323,1,53494119,53494839,720,audio/Bl122_53494119.jpg,Bl122
2840,14760.051371,14760.316975,1,442801541,442809509,7968,audio/Ti81_442801541.jpg,Ti81
2841,2164.211183,2164.254183,2,64926335,64927625,1290,audio/Bl122_64926335.jpg,Bl122
2842,3429.253493,3429.442151,1,102877604,102883264,5660,audio/Ti81_102877604.jpg,Ti81
2843,15028.701755,15028.735815,1,450861052,450862074,1022,audio/Ti81_450861052.jpg,Ti81
2844,2167.069183,2167.112183,1,65012075,65013365,1290,audio/Bl122_65012075.jpg,Bl122
2845,528.961416,528.972416,2,15868842,15869172,330,audio/Or61_15868842.jpg,Or61
2846,1949.335779,1949.491779,1,58480073,58484753,4680,audio/Bl122_58480073.jpg,Bl122
2847,402.825692,402.872692,1,12084770,12086180,1410,audio/Or61_12084770.jpg,Or61
2848,485.174221,485.176221,2,14555226,14555286,60,audio/Or61_14555226.jpg,Or61
2849,6299.438561,6299.583561,1,188983156,188987506,4350,audio/Li145_188983156.jpg,Li145
2850,15035.877674,15035.905805,1,451076330,451077174,844,audio/Ti81_451076330.jpg,Ti81
2851,8864.118987,8864.136987,1,265923569,265924109,540,audio/Li145_265923569.jpg,Li145
2852,721.887271,721.920271,1,21656618,21657608,990,audio/Or61_21656618.jpg,Or61
2853,2193.213183,2193.442183,1,65796395,65803265,6870,audio/Bl122_65796395.jpg,Bl122
2854,550.484416,550.513416,1,16514532,16515402,870,audio/Or61_16514532.jpg,Or61
2855,488.130221,488.138221,2,14643906,14644146,240,audio/Or61_14643906.jpg,Or61
2856,15209.25555,15209.31958,1,456277666,456279587,1921,audio/Ti81_456277666.jpg,Ti81
2857,1938.360779,1938.423779,2,58150823,58152713,1890,audio/Bl122_58150823.jpg,Bl122
2858,492.493221,492.746221,1,14774796,14782386,7590,audio/Or61_14774796.jpg,Or61
2859,3547.136106,3547.336176,1,106414083,106420085,6002,audio/Ti81_106414083.jpg,Ti81
2860,470.386221,470.517221,1,14111586,14115516,3930,audio/Or61_14111586.jpg,Or61
2861,2164.150183,2164.155183,2,64924505,64924655,150,audio/Bl122_64924505.jpg,Bl122
2862,2173.058183,2173.062183,2,65191745,65191865,120,audio/Bl122_65191745.jpg,Bl122
2863,488.346221,488.349221,2,14650386,14650476,90,audio/Or61_14650386.jpg,Or61
2864,1998.854779,1998.874779,2,59965643,59966243,600,audio/Bl122_59965643.jpg,Bl122
2865,2192.940183,2192.954183,2,65788205,65788625,420,audio/Bl122_65788205.jpg,Bl122
2866,629.937417,630.023417,1,18898122,18900702,2580,audio/Or61_18898122.jpg,Or61
2867,1808.723926,1808.731926,2,54261717,54261957,240,audio/Bl122_54261717.jpg,Bl122
2868,2076.555823,2076.698823,1,62296674,62300964,4290,audio/Bl122_62296674.jpg,Bl122
2869,793.280827,793.296827,2,23798424,23798904,480,audio/Or61_23798424.jpg,Or61
2870,15222.057443,15222.083443,1,456661723,456662503,780,audio/Ti81_456661723.jpg,Ti81
2871,15251.119074,15251.338013,1,457533572,457540140,6568,audio/Ti81_457533572.jpg,Ti81
2872,752.542271,752.553271,2,22576268,22576598,330,audio/Or61_22576268.jpg,Or61
2873,851.561979,851.586073,1,25546859,25547582,723,audio/Ti81_25546859.jpg,Ti81
2874,3621.36153,3621.46653,1,108640845,108643995,3150,audio/Li145_108640845.jpg,Li145
2875,3416.555706,3416.7419,1,102496671,102502257,5586,audio/Ti81_102496671.jpg,Ti81
2876,1795.662115,1795.759115,1,53869863,53872773,2910,audio/Bl122_53869863.jpg,Bl122
2877,1770.658657,1770.667657,2,53119759,53120029,270,audio/Bl122_53119759.jpg,Bl122
2878,846.100812,846.126143,1,25383024,25383784,760,audio/Ti81_25383024.jpg,Ti81
2879,616.072417,616.075417,2,18482172,18482262,90,audio/Or61_18482172.jpg,Or61
2880,9537.249343,9537.260343,1,286117480,286117810,330,audio/Li145_286117480.jpg,Li145
2881,15143.418403,15143.537403,1,454302552,454306122,3570,audio/Ti81_454302552.jpg,Ti81
2882,2131.125183,2131.130183,2,63933755,63933905,150,audio/Bl122_63933755.jpg,Bl122
2883,786.556827,786.568827,1,23596704,23597064,360,audio/Or61_23596704.jpg,Or61
2884,2229.079183,2229.217183,1,66872375,66876515,4140,audio/Bl122_66872375.jpg,Bl122
2885,2219.275183,2219.318183,2,66578255,66579545,1290,audio/Bl122_66578255.jpg,Bl122
2886,614.846417,615.209417,1,18445392,18456282,10890,audio/Or61_18445392.jpg,Or61
2887,568.506467,568.600467,1,17055194,17058014,2820,audio/Or61_17055194.jpg,Or61
2888,2066.787469,2066.955469,1,62003624,62008664,5040,audio/Bl122_62003624.jpg,Bl122
2889,1956.425779,1956.436779,2,58692773,58693103,330,audio/Bl122_58692773.jpg,Bl122
2890,6949.711842,6949.745842,1,208491355,208492375,1020,audio/Li145_208491355.jpg,Li145
2891,1996.993779,1997.009779,2,59909813,59910293,480,audio/Bl122_59909813.jpg,Bl122
2892,2208.494183,2208.527183,2,66254825,66255815,990,audio/Bl122_66254825.jpg,Bl122
2893,2173.391183,2173.399183,2,65201735,65201975,240,audio/Bl122_65201735.jpg,Bl122
2894,814.565882,814.690882,1,24436976,24440726,3750,audio/Or61_24436976.jpg,Or61
2895,15303.877373,15303.933373,1,459116321,459118001,1680,audio/Ti81_459116321.jpg,Ti81
2896,15224.141443,15224.252443,1,456724243,456727573,3330,audio/Ti81_456724243.jpg,Ti81
2897,1792.053115,1792.204115,1,53761593,53766123,4530,audio/Bl122_53761593.jpg,Bl122
2898,2155.786183,2155.812183,2,64673585,64674365,780,audio/Bl122_64673585.jpg,Bl122
2899,712.371271,712.434271,1,21371138,21373028,1890,audio/Or61_21371138.jpg,Or61
2900,771.639271,771.646271,2,23149178,23149388,210,audio/Or61_23149178.jpg,Or61
2901,1974.353779,1974.703779,1,59230613,59241113,10500,audio/Bl122_59230613.jpg,Bl122
2902,14926.58106,14926.733005,1,447797431,447801990,4559,audio/Ti81_447797431.jpg,Ti81
2903,15329.166625,15329.186625,1,459874998,459875598,600,audio/Ti81_459874998.jpg,Ti81
2904,2011.710959,2011.713959,2,60351328,60351418,90,audio/Bl122_60351328.jpg,Bl122
2905,9626.668838,9626.8351,1,288800065,288805053,4988,audio/Ti81_288800065.jpg,Ti81
2906,2066.612469,2066.615469,2,61998374,61998464,90,audio/Bl122_61998374.jpg,Bl122
2907,530.123416,530.138416,2,15903702,15904152,450,audio/Or61_15903702.jpg,Or61
2908,490.758221,490.763221,2,14722746,14722896,150,audio/Or61_14722746.jpg,Or61
2909,15230.855443,15230.982443,1,456925663,456929473,3810,audio/Ti81_456925663.jpg,Ti81
2910,2183.203183,2183.215183,2,65496095,65496455,360,audio/Bl122_65496095.jpg,Bl122
2911,527.609416,527.685416,1,15828282,15830562,2280,audio/Or61_15828282.jpg,Or61
2912,757.345271,757.485271,1,22720358,22724558,4200,audio/Or61_22720358.jpg,Or61
2913,719.796271,719.825271,1,21593888,21594758,870,audio/Or61_21593888.jpg,Or61
2914,9168.025583,9168.097583,1,275040767,275042927,2160,audio/Li145_275040767.jpg,Li145
2915,2213.079183,2213.232183,1,66392375,66396965,4590,audio/Bl122_66392375.jpg,Bl122
2916,5888.294515,5888.328515,1,176648835,176649855,1020,audio/Li145_176648835.jpg,Li145
2917,753.196271,753.203271,2,22595888,22596098,210,audio/Or61_22595888.jpg,Or61
2918,5968.488227,5968.493227,2,179054646,179054796,150,audio/Li145_179054646.jpg,Li145
2919,626.484417,626.499417,1,18794532,18794982,450,audio/Or61_18794532.jpg,Or61
2920,8827.983654,8828.027654,1,264839509,264840829,1320,audio/Li145_264839509.jpg,Li145
2921,1959.639779,1959.645779,2,58789193,58789373,180,audio/Bl122_58789193.jpg,Bl122
2922,1971.047779,1971.083779,1,59131433,59132513,1080,audio/Bl122_59131433.jpg,Bl122
2923,3583.644686,3583.651686,2,107509340,107509550,210,audio/Li145_107509340.jpg,Li145
2924,503.604221,503.613221,2,15108126,15108396,270,audio/Or61_15108126.jpg,Or61
2925,3418.615952,3418.757238,1,102558478,102562717,4239,audio/Ti81_102558478.jpg,Ti81
2926,2168.028183,2168.056183,2,65040845,65041685,840,audio/Bl122_65040845.jpg,Bl122
2927,7568.302558,7568.381558,1,227049076,227051446,2370,audio/Li145_227049076.jpg,Li145
2928,2042.742469,2042.777469,1,61282274,61283324,1050,audio/Bl122_61282274.jpg,Bl122
2929,722.659271,722.685271,1,21679778,21680558,780,audio/Or61_21679778.jpg,Or61
2930,2152.566183,2152.628183,1,64576985,64578845,1860,audio/Bl122_64576985.jpg,Bl122
2931,603.154417,603.201417,1,18094632,18096042,1410,audio/Or61_18094632.jpg,Or61
2932,2208.404183,2208.416183,2,66252125,66252485,360,audio/Bl122_66252125.jpg,Bl122
2933,2187.098183,2187.120183,1,65612945,65613605,660,audio/Bl122_65612945.jpg,Bl122
2934,2216.307183,2216.327183,1,66489215,66489815,600,audio/Bl122_66489215.jpg,Bl122
2935,722.825271,722.840271,1,21684758,21685208,450,audio/Or61_21684758.jpg,Or61
2936,750.000271,750.044271,1,22500008,22501328,1320,audio/Or61_22500008.jpg,Or61
2937,15334.44701,15334.62201,1,460033410,460038660,5250,audio/Ti81_460033410.jpg,Ti81
2938,673.723078,673.811078,1,20211692,20214332,2640,audio/Or61_20211692.jpg,Or61
2939,767.531271,767.535271,2,23025938,23026058,120,audio/Or61_23025938.jpg,Or61
2940,2169.214183,2169.350183,1,65076425,65080505,4080,audio/Bl122_65076425.jpg,Bl122
2941,754.349271,754.364271,2,22630478,22630928,450,audio/Or61_22630478.jpg,Or61
2942,9046.088911,9046.114911,1,271382667,271383447,780,audio/Li145_271382667.jpg,Li145
2943,9537.263343,9537.284343,1,286117900,286118530,630,audio/Li145_286117900.jpg,Li145
2944,15297.856664,15297.883664,1,458935699,458936509,810,audio/Ti81_458935699.jpg,Ti81
2945,15206.99758,15207.17558,1,456209927,456215267,5340,audio/Ti81_456209927.jpg,Ti81
2946,2091.278961,2091.430961,1,62738368,62742928,4560,audio/Bl122_62738368.jpg,Bl122
2947,15318.116428,15318.289428,1,459543492,459548682,5190,audio/Ti81_459543492.jpg,Ti81
2948,1971.822779,1971.845779,2,59154683,59155373,690,audio/Bl122_59154683.jpg,Bl122
2949,1975.625779,1975.637779,2,59268773,59269133,360,audio/Bl122_59268773.jpg,Bl122
2950,760.073271,760.133271,1,22802198,22803998,1800,audio/Or61_22802198.jpg,Or61
2951,538.843416,538.845416,2,16165302,16165362,60,audio/Or61_16165302.jpg,Or61
2952,1987.866779,1987.908779,1,59636003,59637263,1260,audio/Bl122_59636003.jpg,Bl122
2953,587.327057,587.581057,1,17619811,17627431,7620,audio/Or61_17619811.jpg,Or61
2954,201.060012,201.063012,2,6031800,6031890,90,audio/Or61_6031800.jpg,Or61
2955,630.297417,630.334417,1,18908922,18910032,1110,audio/Or61_18908922.jpg,Or61
2956,1794.080115,1794.088115,2,53822403,53822643,240,audio/Bl122_53822403.jpg,Bl122
2957,15110.347256,15110.405256,1,453310417,453312157,1740,audio/Ti81_453310417.jpg,Ti81
2958,2033.467469,2033.500469,2,61004024,61005014,990,audio/Bl122_61004024.jpg,Bl122
2959,1954.541779,1954.572779,1,58636253,58637183,930,audio/Bl122_58636253.jpg,Bl122
2960,2172.962183,2172.968183,2,65188865,65189045,180,audio/Bl122_65188865.jpg,Bl122
2961,1760.519532,1760.685532,1,52815585,52820565,4980,audio/Bl122_52815585.jpg,Bl122
2962,2012.278959,2012.365959,2,60368368,60370978,2610,audio/Bl122_60368368.jpg,Bl122
2963,15120.924598,15121.140981,1,453627737,453634229,6492,audio/Ti81_453627737.jpg,Ti81
2964,15304.395373,15304.412373,1,459131861,459132371,510,audio/Ti81_459131861.jpg,Ti81
2965,3583.447686,3583.481686,1,107503430,107504450,1020,audio/Li145_107503430.jpg,Li145
2966,15264.321358,15264.336358,1,457929640,457930090,450,audio/Ti81_457929640.jpg,Ti81
2967,2107.832377,2107.873377,2,63234971,63236201,1230,audio/Bl122_63234971.jpg,Bl122
2968,503.952221,503.955221,2,15118566,15118656,90,audio/Or61_15118566.jpg,Or61
2969,15042.081498,15042.143169,1,451262444,451264295,1851,audio/Ti81_451262444.jpg,Ti81
2970,487.769221,487.773221,2,14633076,14633196,120,audio/Or61_14633076.jpg,Or61
2971,3421.001912,3421.332167,1,102630057,102639965,9908,audio/Ti81_102630057.jpg,Ti81
2972,1993.918779,1993.942779,1,59817563,59818283,720,audio/Bl122_59817563.jpg,Bl122
2973,1965.392779,1965.406779,2,58961783,58962203,420,audio/Bl122_58961783.jpg,Bl122
2974,2153.684183,2153.781183,1,64610525,64613435,2910,audio/Bl122_64610525.jpg,Bl122
2975,2055.982469,2056.215469,1,61679474,61686464,6990,audio/Bl122_61679474.jpg,Bl122
2976,1960.589779,1960.616779,1,58817693,58818503,810,audio/Bl122_58817693.jpg,Bl122
2977,482.742221,482.779221,2,14482266,14483376,1110,audio/Or61_14482266.jpg,Or61
2978,2201.795183,2201.802183,2,66053855,66054065,210,audio/Bl122_66053855.jpg,Bl122
2979,501.310221,501.312221,2,15039306,15039366,60,audio/Or61_15039306.jpg,Or61
2980,803.363882,803.370882,2,24100916,24101126,210,audio/Or61_24100916.jpg,Or61
2981,636.162417,636.245417,1,19084872,19087362,2490,audio/Or61_19084872.jpg,Or61
2982,1978.563779,1978.568779,2,59356913,59357063,150,audio/Bl122_59356913.jpg,Bl122
2983,809.496882,809.765882,1,24284906,24292976,8070,audio/Or61_24284906.jpg,Or61
2984,2177.095183,2177.113183,2,65312855,65313395,540,audio/Bl122_65312855.jpg,Bl122
2985,2196.757183,2196.760183,2,65902715,65902805,90,audio/Bl122_65902715.jpg,Bl122
2986,5711.841036,5711.845036,2,171355231,171355351,120,audio/Li145_171355231.jpg,Li145
2987,2058.180469,2058.234469,1,61745414,61747034,1620,audio/Bl122_61745414.jpg,Bl122
2988,2228.607183,2228.646183,2,66858215,66859385,1170,audio/Bl122_66858215.jpg,Bl122
2989,3466.683316,3466.701296,1,104000499,104001038,539,audio/Ti81_104000499.jpg,Ti81
2990,797.966827,797.986827,2,23939004,23939604,600,audio/Or61_23939004.jpg,Or61
2991,6333.440902,6333.462902,1,190003227,190003887,660,audio/Li145_190003227.jpg,Li145
2992,811.555882,811.576882,1,24346676,24347306,630,audio/Or61_24346676.jpg,Or61
2993,5968.936227,5968.950227,1,179068086,179068506,420,audio/Li145_179068086.jpg,Li145
2994,2223.851183,2223.857183,2,66715535,66715715,180,audio/Bl122_66715535.jpg,Bl122
2995,752.997271,753.101271,1,22589918,22593038,3120,audio/Or61_22589918.jpg,Or61
2996,2102.107961,2102.131961,1,63063238,63063958,720,audio/Bl122_63063238.jpg,Bl122
2997,2154.366183,2154.388183,2,64630985,64631645,660,audio/Bl122_64630985.jpg,Bl122
2998,2088.713961,2088.870961,1,62661418,62666128,4710,audio/Bl122_62661418.jpg,Bl122
2999,15053.083966,15053.107966,1,451592518,451593238,720,audio/Ti81_451592518.jpg,Ti81
3000,489.859221,489.878221,2,14695776,14696346,570,audio/Or61_14695776.jpg,Or61
3001,2121.036183,2121.257183,1,63631085,63637715,6630,audio/Bl122_63631085.jpg,Bl122
3002,1951.077779,1951.252779,1,58532333,58537583,5250,audio/Bl122_58532333.jpg,Bl122
3003,704.633271,704.660271,1,21138998,21139808,810,audio/Or61_21138998.jpg,Or61
3004,747.668271,747.698271,1,22430048,22430948,900,audio/Or61_22430048.jpg,Or61
3005,622.693417,622.765417,1,18680802,18682962,2160,audio/Or61_18680802.jpg,Or61
3006,2196.229183,2196.240183,2,65886875,65887205,330,audio/Bl122_65886875.jpg,Bl122
3007,1770.895657,1770.910657,1,53126869,53127319,450,audio/Bl122_53126869.jpg,Bl122
3008,441.584265,441.601265,1,13247527,13248037,510,audio/Or61_13247527.jpg,Or61
3009,615.291417,615.300417,2,18458742,18459012,270,audio/Or61_18458742.jpg,Or61
3010,2137.540183,2137.546183,2,64126205,64126385,180,audio/Bl122_64126205.jpg,Bl122
3011,1966.670779,1966.673779,2,59000123,59000213,90,audio/Bl122_59000123.jpg,Bl122
3012,2151.767183,2152.037183,1,64553015,64561115,8100,audio/Bl122_64553015.jpg,Bl122
3013,716.739271,716.769271,1,21502178,21503078,900,audio/Or61_21502178.jpg,Or61
3014,2142.482183,2142.486183,2,64274465,64274585,120,audio/Bl122_64274465.jpg,Bl122
3015,428.321969,428.327969,2,12849659,12849839,180,audio/Or61_12849659.jpg,Or61
3016,4922.423507,4922.425507,2,147672705,147672765,60,audio/Li145_147672705.jpg,Li145
3017,15214.84258,15214.87858,1,456445277,456446357,1080,audio/Ti81_456445277.jpg,Ti81
3018,15051.189966,15051.419966,1,451535698,451542598,6900,audio/Ti81_451535698.jpg,Ti81
3019,482.384221,482.405221,1,14471526,14472156,630,audio/Or61_14471526.jpg,Or61
3020,2212.839183,2212.987183,1,66385175,66389615,4440,audio/Bl122_66385175.jpg,Bl122
3021,3467.648095,3467.702275,1,104029442,104031068,1626,audio/Ti81_104029442.jpg,Ti81
3022,815.996882,816.004882,2,24479906,24480146,240,audio/Or61_24479906.jpg,Or61
3023,2180.334183,2180.340183,2,65410025,65410205,180,audio/Bl122_65410025.jpg,Bl122
3024,2013.645959,2013.650959,2,60409378,60409528,150,audio/Bl122_60409378.jpg,Bl122
3025,2131.143183,2131.355183,1,63934295,63940655,6360,audio/Bl122_63934295.jpg,Bl122
3026,780.962878,780.967878,1,23428886,23429036,150,audio/Or61_23428886.jpg,Or61
3027,406.493692,406.496692,2,12194810,12194900,90,audio/Or61_12194810.jpg,Or61
3028,406.328692,406.380692,2,12189860,12191420,1560,audio/Or61_12189860.jpg,Or61
3029,1978.570779,1978.586779,2,59357123,59357603,480,audio/Bl122_59357123.jpg,Bl122
3030,1943.930779,1944.046779,1,58317923,58321403,3480,audio/Bl122_58317923.jpg,Bl122
3031,614.177417,614.294417,1,18425322,18428832,3510,audio/Or61_18425322.jpg,Or61
3032,7569.174558,7569.194558,1,227075236,227075836,600,audio/Li145_227075236.jpg,Li145
3033,771.117271,771.127271,2,23133518,23133818,300,audio/Or61_23133518.jpg,Or61
3034,15096.804988,15096.828988,1,452904149,452904869,720,audio/Ti81_452904149.jpg,Ti81
3035,2008.628779,2008.645779,1,60258863,60259373,510,audio/Bl122_60258863.jpg,Bl122
3036,2217.780183,2217.930183,1,66533405,66537905,4500,audio/Bl122_66533405.jpg,Bl122
3037,2233.247183,2233.253183,2,66997415,66997595,180,audio/Bl122_66997415.jpg,Bl122
3038,754.102271,754.208271,1,22623068,22626248,3180,audio/Or61_22623068.jpg,Or61
3039,544.015416,544.039416,1,16320462,16321182,720,audio/Or61_16320462.jpg,Or61
3040,526.968416,527.031416,1,15809052,15810942,1890,audio/Or61_15809052.jpg,Or61
3041,747.865271,747.875271,2,22435958,22436258,300,audio/Or61_22435958.jpg,Or61
3042,2067.815469,2067.818469,2,62034464,62034554,90,audio/Bl122_62034464.jpg,Bl122
3043,15072.482682,15072.648213,1,452174480,452179446,4966,audio/Ti81_452174480.jpg,Ti81
3044,749.353271,749.444271,1,22480598,22483328,2730,audio/Or61_22480598.jpg,Or61
3045,797.989827,798.059827,2,23939694,23941794,2100,audio/Or61_23939694.jpg,Or61
3046,1997.132779,1997.143779,2,59913983,59914313,330,audio/Bl122_59913983.jpg,Bl122
3047,2181.649183,2181.679183,1,65449475,65450375,900,audio/Bl122_65449475.jpg,Bl122
3048,2128.421183,2128.462183,1,63852635,63853865,1230,audio/Bl122_63852635.jpg,Bl122
3049,15096.251823,15096.280823,1,452887554,452888424,870,audio/Ti81_452887554.jpg,Ti81
3050,3464.498184,3464.680089,1,103934945,103940402,5457,audio/Ti81_103934945.jpg,Ti81
3051,794.213827,794.234827,1,23826414,23827044,630,audio/Or61_23826414.jpg,Or61
3052,2216.023183,2216.035183,2,66480695,66481055,360,audio/Bl122_66480695.jpg,Bl122
3053,3544.929528,3545.082419,1,106347885,106352472,4587,audio/Ti81_106347885.jpg,Ti81
3054,2170.332183,2170.469183,1,65109965,65114075,4110,audio/Bl122_65109965.jpg,Bl122
3055,2092.163961,2092.169961,2,62764918,62765098,180,audio/Bl122_62764918.jpg,Bl122
3056,714.713271,715.015271,1,21441398,21450458,9060,audio/Or61_21441398.jpg,Or61
3057,396.348529,396.353529,2,11890455,11890605,150,audio/Or61_11890455.jpg,Or61
3058,1951.022779,1951.028779,2,58530683,58530863,180,audio/Bl122_58530683.jpg,Bl122
3059,213.301857,213.334857,1,6399055,6400045,990,audio/Or61_6399055.jpg,Or61
3060,1790.550115,1790.573115,2,53716503,53717193,690,audio/Bl122_53716503.jpg,Bl122
3061,2233.622183,2233.741183,1,67008665,67012235,3570,audio/Bl122_67008665.jpg,Bl122
3062,2000.336779,2000.350779,2,60010103,60010523,420,audio/Bl122_60010103.jpg,Bl122
3063,2231.286183,2231.289183,2,66938585,66938675,90,audio/Bl122_66938585.jpg,Bl122
3064,2226.663183,2226.669183,2,66799895,66800075,180,audio/Bl122_66799895.jpg,Bl122
3065,2231.296183,2231.302183,2,66938885,66939065,180,audio/Bl122_66938885.jpg,Bl122
3066,1808.978926,1809.084926,1,54269367,54272547,3180,audio/Bl122_54269367.jpg,Bl122
3067,15042.381225,15042.447326,1,451271436,451273419,1983,audio/Ti81_451271436.jpg,Ti81
3068,2034.088469,2034.137469,1,61022654,61024124,1470,audio/Bl122_61022654.jpg,Bl122
3069,1770.159657,1770.202657,2,53104789,53106079,1290,audio/Bl122_53104789.jpg,Bl122
3070,2039.855815,2039.872815,1,61195674,61196184,510,audio/Li145_61195674.jpg,Li145
3071,558.034416,558.046416,1,16741032,16741392,360,audio/Or61_16741032.jpg,Or61
3072,2178.489183,2178.784183,1,65354675,65363525,8850,audio/Bl122_65354675.jpg,Bl122
3073,3632.359014,3632.392014,1,108970770,108971760,990,audio/Li145_108970770.jpg,Li145
3074,14902.271114,14902.308454,1,447068133,447069253,1120,audio/Ti81_447068133.jpg,Ti81
3075,1974.036779,1974.060779,2,59221103,59221823,720,audio/Bl122_59221103.jpg,Bl122
3076,8083.224803,8083.240803,2,242496744,242497224,480,audio/Li145_242496744.jpg,Li145
3077,2053.390469,2053.395469,2,61601714,61601864,150,audio/Bl122_61601714.jpg,Bl122
3078,9537.356343,9537.569343,1,286120690,286127080,6390,audio/Li145_286120690.jpg,Li145
3079,15158.000257,15158.152257,1,454740007,454744567,4560,audio/Ti81_454740007.jpg,Ti81
3080,1798.581115,1798.595115,1,53957433,53957853,420,audio/Bl122_53957433.jpg,Bl122
3081,1774.155974,1774.306974,1,53224679,53229209,4530,audio/Bl122_53224679.jpg,Bl122
3082,2203.741183,2203.972183,1,66112235,66119165,6930,audio/Bl122_66112235.jpg,Bl122
3083,7552.555715,7552.748715,1,226576671,226582461,5790,audio/Li145_226576671.jpg,Li145
3084,2215.466183,2215.470183,2,66463985,66464105,120,audio/Bl122_66463985.jpg,Bl122
3085,611.519417,611.526417,2,18345582,18345792,210,audio/Or61_18345582.jpg,Or61
3086,15224.725443,15224.781443,1,456741763,456743443,1680,audio/Ti81_456741763.jpg,Ti81
3087,15297.929664,15297.944664,1,458937889,458938339,450,audio/Ti81_458937889.jpg,Ti81
3088,15068.957682,15069.000682,1,452068730,452070020,1290,audio/Ti81_452068730.jpg,Ti81
3089,200.373012,200.611012,1,6011190,6018330,7140,audio/Or61_6011190.jpg,Or61
3090,530.809416,530.812416,2,15924282,15924372,90,audio/Or61_15924282.jpg,Or61
3091,1988.724779,1988.827779,2,59661743,59664833,3090,audio/Bl122_59661743.jpg,Bl122
3092,9537.225343,9537.241343,1,286116760,286117240,480,audio/Li145_286116760.jpg,Li145
3093,15243.060874,15243.179874,1,457291826,457295396,3570,audio/Ti81_457291826.jpg,Ti81
3094,2154.744183,2154.794183,2,64642325,64643825,1500,audio/Bl122_64642325.jpg,Bl122
3095,470.375221,470.381221,2,14111256,14111436,180,audio/Or61_14111256.jpg,Or61
3096,481.201221,481.213221,2,14436036,14436396,360,audio/Or61_14436036.jpg,Or61
3097,3418.235742,3418.34423,1,102547072,102550326,3254,audio/Ti81_102547072.jpg,Ti81
3098,532.302416,532.334416,1,15969072,15970032,960,audio/Or61_15969072.jpg,Or61
3099,2058.369469,2058.374469,2,61751084,61751234,150,audio/Bl122_61751084.jpg,Bl122
3100,2157.272183,2157.298183,2,64718165,64718945,780,audio/Bl122_64718165.jpg,Bl122
3101,503.127221,503.133221,2,15093816,15093996,180,audio/Or61_15093816.jpg,Or61
3102,1942.222779,1942.257779,1,58266683,58267733,1050,audio/Bl122_58266683.jpg,Bl122
3103,15263.826358,15263.846358,1,457914790,457915390,600,audio/Ti81_457914790.jpg,Ti81
3104,15272.610439,15272.657439,1,458178313,458179723,1410,audio/Ti81_458178313.jpg,Ti81
3105,2189.942183,2189.946183,2,65698265,65698385,120,audio/Bl122_65698265.jpg,Bl122
3106,15136.927989,15136.996989,1,454107839,454109909,2070,audio/Ti81_454107839.jpg,Ti81
3107,724.182271,724.218271,1,21725468,21726548,1080,audio/Or61_21725468.jpg,Or61
3108,2213.337183,2213.376183,2,66400115,66401285,1170,audio/Bl122_66400115.jpg,Bl122
3109,636.377417,636.399417,2,19091322,19091982,660,audio/Or61_19091322.jpg,Or61
3110,2084.209961,2084.226961,2,62526298,62526808,510,audio/Bl122_62526298.jpg,Bl122
3111,5707.472085,5707.482085,1,171224162,171224462,300,audio/Li145_171224162.jpg,Li145
3112,15258.602114,15258.773114,1,457758063,457763193,5130,audio/Ti81_457758063.jpg,Ti81
3113,15116.668981,15116.711981,1,453500069,453501359,1290,audio/Ti81_453500069.jpg,Ti81
3114,792.385827,792.426827,1,23771574,23772804,1230,audio/Or61_23771574.jpg,Or61
3115,15047.276966,15047.318966,1,451418308,451419568,1260,audio/Ti81_451418308.jpg,Ti81
3116,2226.377183,2226.388183,2,66791315,66791645,330,audio/Bl122_66791315.jpg,Bl122
3117,1957.940779,1957.942779,2,58738223,58738283,60,audio/Bl122_58738223.jpg,Bl122
3118,2208.899183,2208.917183,2,66266975,66267515,540,audio/Bl122_66266975.jpg,Bl122
3119,1948.987779,1949.033779,2,58469633,58471013,1380,audio/Bl122_58469633.jpg,Bl122
3120,771.676271,771.687271,2,23150288,23150618,330,audio/Or61_23150288.jpg,Or61
3121,2160.429183,2160.453183,1,64812875,64813595,720,audio/Bl122_64812875.jpg,Bl122
3122,471.854221,471.937221,1,14155626,14158116,2490,audio/Or61_14155626.jpg,Or61
3123,1958.276779,1958.308779,2,58748303,58749263,960,audio/Bl122_58748303.jpg,Bl122
3124,1965.464779,1965.762779,1,58963943,58972883,8940,audio/Bl122_58963943.jpg,Bl122
3125,1807.446926,1807.828926,1,54223407,54234867,11460,audio/Bl122_54223407.jpg,Bl122
3126,1968.499779,1968.745779,1,59054993,59062373,7380,audio/Bl122_59054993.jpg,Bl122
3127,6299.586561,6299.720561,1,188987596,188991616,4020,audio/Li145_188987596.jpg,Li145
3128,3646.822803,3646.850803,1,109404684,109405524,840,audio/Li145_109404684.jpg,Li145
3129,2213.750183,2213.948183,1,66412505,66418445,5940,audio/Bl122_66412505.jpg,Bl122
3130,6357.638589,6357.8046,1,190729157,190734138,4981,audio/Ti81_190729157.jpg,Ti81
3131,493.822221,494.038221,1,14814666,14821146,6480,audio/Or61_14814666.jpg,Or61
3132,498.365221,498.397221,1,14950956,14951916,960,audio/Or61_14950956.jpg,Or61
3133,1945.450779,1945.481779,1,58363523,58364453,930,audio/Bl122_58363523.jpg,Bl122
3134,1955.497779,1955.540779,1,58664933,58666223,1290,audio/Bl122_58664933.jpg,Bl122
3135,15156.456257,15156.513257,1,454693687,454695397,1710,audio/Ti81_454693687.jpg,Ti81
3136,1993.679779,1993.693779,2,59810393,59810813,420,audio/Bl122_59810393.jpg,Bl122
3137,2116.036183,2116.063183,1,63481085,63481895,810,audio/Bl122_63481085.jpg,Bl122
3138,2070.327469,2070.330469,2,62109824,62109914,90,audio/Bl122_62109824.jpg,Bl122
3139,7569.491558,7569.497558,1,227084746,227084926,180,audio/Li145_227084746.jpg,Li145
3140,557.955416,557.961416,2,16738662,16738842,180,audio/Or61_16738662.jpg,Or61
3141,2179.200183,2179.211183,2,65376005,65376335,330,audio/Bl122_65376005.jpg,Bl122
3142,2082.442961,2082.530961,1,62473288,62475928,2640,audio/Bl122_62473288.jpg,Bl122
3143,805.045882,805.083882,1,24151376,24152516,1140,audio/Or61_24151376.jpg,Or61
3144,15334.76801,15334.88901,1,460043040,460046670,3630,audio/Ti81_460043040.jpg,Ti81
3145,5888.371515,5888.444515,1,176651145,176653335,2190,audio/Li145_176651145.jpg,Li145
3146,2201.146183,2201.151183,2,66034385,66034535,150,audio/Bl122_66034385.jpg,Bl122
3147,946.022348,946.190377,1,28380670,28385711,5041,audio/Ti81_28380670.jpg,Ti81
3148,389.380161,389.580161,1,11681404,11687404,6000,audio/Or61_11681404.jpg,Or61
3149,503.047221,503.055221,2,15091416,15091656,240,audio/Or61_15091416.jpg,Or61
3150,2132.963183,2132.969183,2,63988895,63989075,180,audio/Bl122_63988895.jpg,Bl122
3151,538.847416,538.907416,1,16165422,16167222,1800,audio/Or61_16165422.jpg,Or61
3152,1771.349657,1771.380657,1,53140489,53141419,930,audio/Bl122_53140489.jpg,Bl122
3153,2149.354183,2149.401183,2,64480625,64482035,1410,audio/Bl122_64480625.jpg,Bl122
3154,2177.706183,2177.861183,1,65331185,65335835,4650,audio/Bl122_65331185.jpg,Bl122
3155,599.940417,600.000417,1,17998212,18000012,1800,audio/Or61_17998212.jpg,Or61
3156,2233.259183,2233.337183,1,66997775,67000115,2340,audio/Bl122_66997775.jpg,Bl122
3157,15039.198074,15039.220465,1,451175942,451176613,671,audio/Ti81_451175942.jpg,Ti81
3158,2170.923183,2170.949183,2,65127695,65128475,780,audio/Bl122_65127695.jpg,Bl122
3159,5834.927068,5834.956068,1,175047812,175048682,870,audio/Li145_175047812.jpg,Li145
3160,2211.637183,2211.646183,2,66349115,66349385,270,audio/Bl122_66349115.jpg,Bl122
3161,1991.115779,1991.136779,2,59733473,59734103,630,audio/Bl122_59733473.jpg,Bl122
3162,762.555271,762.582271,1,22876658,22877468,810,audio/Or61_22876658.jpg,Or61
3163,2195.777183,2195.820183,1,65873315,65874605,1290,audio/Bl122_65873315.jpg,Bl122
3164,471.738221,471.768221,1,14152146,14153046,900,audio/Or61_14152146.jpg,Or61
3165,3419.819276,3419.833215,1,102594578,102594996,418,audio/Ti81_102594578.jpg,Ti81
3166,2135.454183,2135.657183,1,64063625,64069715,6090,audio/Bl122_64063625.jpg,Bl122
3167,404.347692,404.415692,1,12130430,12132470,2040,audio/Or61_12130430.jpg,Or61
3168,789.979827,789.985827,2,23699394,23699574,180,audio/Or61_23699394.jpg,Or61
3169,529.210416,529.242416,2,15876312,15877272,960,audio/Or61_15876312.jpg,Or61
3170,2006.423779,2006.556779,1,60192713,60196703,3990,audio/Bl122_60192713.jpg,Bl122
3171,2124.563183,2124.569183,2,63736895,63737075,180,audio/Bl122_63736895.jpg,Bl122
3172,1957.092779,1957.186779,1,58712783,58715603,2820,audio/Bl122_58712783.jpg,Bl122
3173,15107.202256,15107.228256,1,453216067,453216847,780,audio/Ti81_453216067.jpg,Ti81
3174,1953.763779,1953.768779,2,58612913,58613063,150,audio/Bl122_58612913.jpg,Bl122
3175,496.097221,496.215221,1,14882916,14886456,3540,audio/Or61_14882916.jpg,Or61
3176,2096.739961,2097.097961,1,62902198,62912938,10740,audio/Bl122_62902198.jpg,Bl122
3177,2038.816469,2038.822469,2,61164494,61164674,180,audio/Bl122_61164494.jpg,Bl122
3178,398.774529,398.787529,2,11963235,11963625,390,audio/Or61_11963235.jpg,Or61
3179,15227.063443,15227.120443,1,456811903,456813613,1710,audio/Ti81_456811903.jpg,Ti81
3180,2130.971183,2130.978183,2,63929135,63929345,210,audio/Bl122_63929135.jpg,Bl122
3181,6334.414902,6334.424902,1,190032447,190032747,300,audio/Li145_190032447.jpg,Li145
3182,768.832271,769.071271,1,23064968,23072138,7170,audio/Or61_23064968.jpg,Or61
3183,390.125161,390.176161,1,11703754,11705284,1530,audio/Or61_11703754.jpg,Or61
3184,2080.540287,2080.575287,1,62416208,62417258,1050,audio/Bl122_62416208.jpg,Bl122
3185,1967.406779,1967.456779,1,59022203,59023703,1500,audio/Bl122_59022203.jpg,Bl122
3186,3429.842603,3429.995999,1,102895278,102899879,4601,audio/Ti81_102895278.jpg,Ti81
3187,545.751416,545.797416,1,16372542,16373922,1380,audio/Or61_16372542.jpg,Or61
3188,2139.555183,2139.673183,1,64186655,64190195,3540,audio/Bl122_64186655.jpg,Bl122
3189,1790.876115,1791.119115,1,53726283,53733573,7290,audio/Bl122_53726283.jpg,Bl122
3190,2002.156779,2002.181779,1,60064703,60065453,750,audio/Bl122_60064703.jpg,Bl122
3191,505.954221,506.085221,1,15178626,15182556,3930,audio/Or61_15178626.jpg,Or61
3192,727.223271,727.262271,1,21816698,21817868,1170,audio/Or61_21816698.jpg,Or61
3193,1971.806779,1971.818779,2,59154203,59154563,360,audio/Bl122_59154203.jpg,Bl122
3194,3466.946209,3466.969861,1,104008386,104009095,709,audio/Ti81_104008386.jpg,Ti81
3195,2152.748183,2152.771183,1,64582445,64583135,690,audio/Bl122_64582445.jpg,Bl122
3196,15072.757682,15072.825682,1,452182730,452184770,2040,audio/Ti81_452182730.jpg,Ti81
3197,14941.006568,14941.155422,1,448230197,448234662,4465,audio/Ti81_448230197.jpg,Ti81
3198,15096.868823,15096.896823,1,452906064,452906904,840,audio/Ti81_452906064.jpg,Ti81
3199,814.027882,814.161882,1,24420836,24424856,4020,audio/Or61_24420836.jpg,Or61
3200,2127.767183,2127.784183,2,63833015,63833525,510,audio/Bl122_63833015.jpg,Bl122
3201,2198.326183,2198.343183,2,65949785,65950295,510,audio/Bl122_65949785.jpg,Bl122
3202,9045.947911,9046.028911,1,271378437,271380867,2430,audio/Li145_271378437.jpg,Li145
3203,762.247271,762.284271,1,22867418,22868528,1110,audio/Or61_22867418.jpg,Or61
3204,1958.574779,1958.590779,2,58757243,58757723,480,audio/Bl122_58757243.jpg,Bl122
3205,15054.148966,15054.317966,1,451624468,451629538,5070,audio/Ti81_451624468.jpg,Ti81
3206,15303.389373,15303.425373,1,459101681,459102761,1080,audio/Ti81_459101681.jpg,Ti81
3207,2228.919183,2228.973183,1,66867575,66869195,1620,audio/Bl122_66867575.jpg,Bl122
3208,390.400161,390.505161,1,11712004,11715154,3150,audio/Or61_11712004.jpg,Or61
3209,616.895417,616.962417,1,18506862,18508872,2010,audio/Or61_18506862.jpg,Or61
3210,1783.433323,1783.446323,1,53502999,53503389,390,audio/Bl122_53502999.jpg,Bl122
3211,2090.046961,2090.049961,2,62701408,62701498,90,audio/Bl122_62701408.jpg,Bl122
3212,2204.731183,2204.737183,2,66141935,66142115,180,audio/Bl122_66141935.jpg,Bl122
3213,15025.883361,15025.99538,1,450776500,450779861,3361,audio/Ti81_450776500.jpg,Ti81
3214,2212.733183,2212.749183,2,66381995,66382475,480,audio/Bl122_66381995.jpg,Bl122
3215,807.511882,807.564882,1,24225356,24226946,1590,audio/Or61_24225356.jpg,Or61
3216,497.186221,497.215221,1,14915586,14916456,870,audio/Or61_14915586.jpg,Or61
3217,2210.116183,2210.131183,2,66303485,66303935,450,audio/Bl122_66303485.jpg,Bl122
3218,2134.386183,2134.398183,2,64031585,64031945,360,audio/Bl122_64031585.jpg,Bl122
3219,183.850971,183.855971,2,5515529,5515679,150,audio/Or61_5515529.jpg,Or61
3220,504.807221,504.847221,1,15144216,15145416,1200,audio/Or61_15144216.jpg,Or61
3221,1785.96443,1785.97743,2,53578932,53579322,390,audio/Bl122_53578932.jpg,Bl122
3222,15052.885966,15053.059966,1,451586578,451591798,5220,audio/Ti81_451586578.jpg,Ti81
3223,750.297271,750.312271,1,22508918,22509368,450,audio/Or61_22508918.jpg,Or61
3224,15033.367837,15033.463205,1,451001035,451003896,2861,audio/Ti81_451001035.jpg,Ti81
3225,227.256275,227.461275,1,6817688,6823838,6150,audio/Or61_6817688.jpg,Or61
3226,2167.912183,2167.966183,1,65037365,65038985,1620,audio/Bl122_65037365.jpg,Bl122
3227,1769.487657,1769.577657,1,53084629,53087329,2700,audio/Bl122_53084629.jpg,Bl122
3228,15164.975257,15165.003257,1,454949257,454950097,840,audio/Ti81_454949257.jpg,Ti81
3229,15035.307234,15035.450285,1,451059217,451063508,4291,audio/Ti81_451059217.jpg,Ti81
3230,805.782882,805.875882,1,24173486,24176276,2790,audio/Or61_24173486.jpg,Or61
3231,2069.747469,2069.757469,2,62092424,62092724,300,audio/Bl122_62092424.jpg,Bl122
3232,2160.776183,2160.785183,2,64823285,64823555,270,audio/Bl122_64823285.jpg,Bl122
3233,1961.061779,1961.068779,2,58831853,58832063,210,audio/Bl122_58831853.jpg,Bl122
3234,469.989221,469.994221,2,14099676,14099826,150,audio/Or61_14099676.jpg,Or61
3235,1967.192779,1967.209779,2,59015783,59016293,510,audio/Bl122_59015783.jpg,Bl122
3236,2007.396779,2007.643779,1,60221903,60229313,7410,audio/Bl122_60221903.jpg,Bl122
3237,2138.429183,2138.433183,2,64152875,64152995,120,audio/Bl122_64152875.jpg,Bl122
3238,747.709271,747.734271,1,22431278,22432028,750,audio/Or61_22431278.jpg,Or61
3239,609.042417,609.069417,2,18271272,18272082,810,audio/Or61_18271272.jpg,Or61
3240,565.359416,565.409416,2,16960782,16962282,1500,audio/Or61_16960782.jpg,Or61
3241,2198.000183,2198.024183,1,65940005,65940725,720,audio/Bl122_65940005.jpg,Bl122
3242,1953.774779,1953.793779,2,58613243,58613813,570,audio/Bl122_58613243.jpg,Bl122
3243,2102.053961,2102.092961,1,63061618,63062788,1170,audio/Bl122_63061618.jpg,Bl122
3244,1958.955779,1958.963779,2,58768673,58768913,240,audio/Bl122_58768673.jpg,Bl122
3245,2171.016183,2171.024183,2,65130485,65130725,240,audio/Bl122_65130485.jpg,Bl122
3246,2083.152961,2083.157961,2,62494588,62494738,150,audio/Bl122_62494588.jpg,Bl122
3247,3428.707651,3428.738936,1,102861229,102862168,939,audio/Ti81_102861229.jpg,Ti81
3248,2192.835183,2192.847183,2,65785055,65785415,360,audio/Bl122_65785055.jpg,Bl122
3249,2048.073469,2048.085469,1,61442204,61442564,360,audio/Bl122_61442204.jpg,Bl122
3250,746.435271,746.530271,1,22393058,22395908,2850,audio/Or61_22393058.jpg,Or61
3251,5696.042353,5696.090353,1,170881270,170882710,1440,audio/Li145_170881270.jpg,Li145
3252,565.765416,565.775416,2,16972962,16973262,300,audio/Or61_16972962.jpg,Or61
3253,813.176882,813.192882,2,24395306,24395786,480,audio/Or61_24395306.jpg,Or61
3254,4578.371304,4578.398804,1,137351139,137351964,825,audio/Ti81_137351139.jpg,Ti81
3255,1948.064779,1948.088779,2,58441943,58442663,720,audio/Bl122_58441943.jpg,Bl122
3256,1948.471779,1948.497779,1,58454153,58454933,780,audio/Bl122_58454153.jpg,Bl122
3257,1962.383779,1962.401779,2,58871513,58872053,540,audio/Bl122_58871513.jpg,Bl122
3258,623.373417,623.557417,1,18701202,18706722,5520,audio/Or61_18701202.jpg,Or61
3259,1956.086779,1956.107779,2,58682603,58683233,630,audio/Bl122_58682603.jpg,Bl122
3260,2111.430183,2111.460183,1,63342905,63343805,900,audio/Bl122_63342905.jpg,Bl122
3261,620.299417,620.315417,2,18608982,18609462,480,audio/Or61_18608982.jpg,Or61
3262,396.032529,396.075529,1,11880975,11882265,1290,audio/Or61_11880975.jpg,Or61
3263,161.324564,161.595564,1,4839736,4847866,8130,audio/Or61_4839736.jpg,Or61
3264,15032.790459,15032.879267,1,450983713,450986378,2665,audio/Ti81_450983713.jpg,Ti81
3265,5696.294353,5696.368353,1,170888830,170891050,2220,audio/Li145_170888830.jpg,Li145
3266,15070.596682,15070.622682,1,452117900,452118680,780,audio/Ti81_452117900.jpg,Ti81
3267,610.065417,610.121417,1,18301962,18303642,1680,audio/Or61_18301962.jpg,Or61
3268,2154.038183,2154.051183,2,64621145,64621535,390,audio/Bl122_64621145.jpg,Bl122
3269,2005.437779,2005.441779,2,60163133,60163253,120,audio/Bl122_60163133.jpg,Bl122
3270,1801.314115,1801.332115,2,54039423,54039963,540,audio/Bl122_54039423.jpg,Bl122
3271,475.358221,475.369221,1,14260746,14261076,330,audio/Or61_14260746.jpg,Or61
3272,483.096221,483.123221,2,14492886,14493696,810,audio/Or61_14492886.jpg,Or61
3273,2043.189469,2043.297469,1,61295684,61298924,3240,audio/Bl122_61295684.jpg,Bl122
3274,503.908221,503.949221,2,15117246,15118476,1230,audio/Or61_15117246.jpg,Or61
3275,2057.833469,2057.855469,2,61735004,61735664,660,audio/Bl122_61735004.jpg,Bl122
3276,620.272417,620.275417,2,18608172,18608262,90,audio/Or61_18608172.jpg,Or61
3277,7548.135781,7548.167781,1,226444073,226445033,960,audio/Li145_226444073.jpg,Li145
3278,15309.030373,15309.051373,1,459270911,459271541,630,audio/Ti81_459270911.jpg,Ti81
3279,9176.018719,9176.124719,1,275280561,275283741,3180,audio/Li145_275280561.jpg,Li145
3280,9172.107804,9172.276804,1,275163234,275168304,5070,audio/Li145_275163234.jpg,Li145
3281,15208.72558,15208.82058,1,456261767,456264617,2850,audio/Ti81_456261767.jpg,Ti81
3282,2038.918469,2038.984469,1,61167554,61169534,1980,audio/Bl122_61167554.jpg,Bl122
3283,5764.04172,5764.15672,1,172921251,172924701,3450,audio/Li145_172921251.jpg,Li145
3284,1983.755779,1983.759779,2,59512673,59512793,120,audio/Bl122_59512673.jpg,Bl122
3285,786.455827,786.467827,1,23593674,23594034,360,audio/Or61_23593674.jpg,Or61
3286,2144.408183,2144.420183,2,64332245,64332605,360,audio/Bl122_64332245.jpg,Bl122
3287,786.658827,786.664827,2,23599764,23599944,180,audio/Or61_23599764.jpg,Or61
3288,1971.796779,1971.804779,2,59153903,59154143,240,audio/Bl122_59153903.jpg,Bl122
3289,7553.905715,7553.997715,1,226617171,226619931,2760,audio/Li145_226617171.jpg,Li145
3290,2152.514183,2152.561183,1,64575425,64576835,1410,audio/Bl122_64575425.jpg,Bl122
3291,1769.880657,1770.076657,1,53096419,53102299,5880,audio/Bl122_53096419.jpg,Bl122
3292,15259.966114,15260.049114,1,457798983,457801473,2490,audio/Ti81_457798983.jpg,Ti81
3293,636.542417,636.557417,2,19096272,19096722,450,audio/Or61_19096272.jpg,Or61
3294,2187.294183,2187.298183,2,65618825,65618945,120,audio/Bl122_65618825.jpg,Bl122
3295,2065.281469,2065.287469,2,61958444,61958624,180,audio/Bl122_61958444.jpg,Bl122
3296,187.565971,187.609971,1,5626979,5628299,1320,audio/Or61_5626979.jpg,Or61
3297,490.740221,490.756221,2,14722206,14722686,480,audio/Or61_14722206.jpg,Or61
3298,549.072416,549.143416,1,16472172,16474302,2130,audio/Or61_16472172.jpg,Or61
3299,2055.793469,2055.966469,1,61673804,61678994,5190,audio/Bl122_61673804.jpg,Bl122
3300,502.481221,502.484221,1,15074436,15074526,90,audio/Or61_15074436.jpg,Or61
3301,1787.725115,1787.942115,1,53631753,53638263,6510,audio/Bl122_53631753.jpg,Bl122
3302,2189.912183,2189.919183,2,65697365,65697575,210,audio/Bl122_65697365.jpg,Bl122
3303,609.700417,609.725417,1,18291012,18291762,750,audio/Or61_18291012.jpg,Or61
3304,2130.030183,2130.079183,2,63900905,63902375,1470,audio/Bl122_63900905.jpg,Bl122
3305,15110.411256,15110.430256,1,453312337,453312907,570,audio/Ti81_453312337.jpg,Ti81
3306,2145.205183,2145.317183,2,64356155,64359515,3360,audio/Bl122_64356155.jpg,Bl122
3307,15215.45558,15215.48458,1,456463667,456464537,870,audio/Ti81_456463667.jpg,Ti81
3308,475.818221,476.017221,1,14274546,14280516,5970,audio/Or61_14274546.jpg,Or61
3309,760.780271,760.843271,1,22823408,22825298,1890,audio/Or61_22823408.jpg,Or61
3310,5712.085036,5712.089036,2,171362551,171362671,120,audio/Li145_171362551.jpg,Li145
3311,1975.660779,1975.668779,2,59269823,59270063,240,audio/Bl122_59269823.jpg,Bl122
3312,2232.585183,2232.694183,1,66977555,66980825,3270,audio/Bl122_66977555.jpg,Bl122
3313,518.754221,518.767221,1,15562626,15563016,390,audio/Or61_15562626.jpg,Or61
3314,317.423448,317.583448,1,9522703,9527503,4800,audio/Li145_9522703.jpg,Li145
3315,498.966221,498.990221,2,14968986,14969706,720,audio/Or61_14968986.jpg,Or61
3316,15231.474443,15231.541443,1,456944233,456946243,2010,audio/Ti81_456944233.jpg,Ti81
3317,1939.015779,1939.123779,2,58170473,58173713,3240,audio/Bl122_58170473.jpg,Bl122
3318,2050.444469,2050.589469,1,61513334,61517684,4350,audio/Bl122_61513334.jpg,Bl122
3319,385.778161,385.782161,2,11573344,11573464,120,audio/Or61_11573344.jpg,Or61
3320,728.724271,728.741271,1,21861728,21862238,510,audio/Or61_21861728.jpg,Or61
3321,2090.904961,2091.095961,1,62727148,62732878,5730,audio/Bl122_62727148.jpg,Bl122
3322,15089.3789,15089.5449,1,452681367,452686347,4980,audio/Ti81_452681367.jpg,Ti81
3323,532.649416,532.826416,1,15979482,15984792,5310,audio/Or61_15979482.jpg,Or61
3324,2095.031961,2095.039961,1,62850958,62851198,240,audio/Bl122_62850958.jpg,Bl122
3325,541.494416,541.506416,2,16244832,16245192,360,audio/Or61_16244832.jpg,Or61
3326,1974.965779,1975.026779,1,59248973,59250803,1830,audio/Bl122_59248973.jpg,Bl122
3327,2180.306183,2180.311183,2,65409185,65409335,150,audio/Bl122_65409185.jpg,Bl122
3328,2005.509779,2005.676779,1,60165293,60170303,5010,audio/Bl122_60165293.jpg,Bl122
3329,1789.544115,1789.565115,1,53686323,53686953,630,audio/Bl122_53686323.jpg,Bl122
3330,423.937593,423.940593,2,12718127,12718217,90,audio/Or61_12718127.jpg,Or61
3331,15208.95058,15209.007277,1,456268517,456270218,1701,audio/Ti81_456268517.jpg,Ti81
3332,1956.779779,1956.813779,1,58703393,58704413,1020,audio/Bl122_58703393.jpg,Bl122
3333,2130.650183,2130.656183,2,63919505,63919685,180,audio/Bl122_63919505.jpg,Bl122
3334,2228.244183,2228.258183,2,66847325,66847745,420,audio/Bl122_66847325.jpg,Bl122
3335,716.458271,716.513271,1,21493748,21495398,1650,audio/Or61_21493748.jpg,Or61
3336,6333.695902,6333.698902,2,190010877,190010967,90,audio/Li145_190010877.jpg,Li145
3337,1770.919657,1770.955657,1,53127589,53128669,1080,audio/Bl122_53127589.jpg,Bl122
3338,3539.126728,3539.243541,1,106173801,106177306,3505,audio/Ti81_106173801.jpg,Ti81
3339,2221.267183,2221.318183,2,66638015,66639545,1530,audio/Bl122_66638015.jpg,Bl122
3340,1972.700779,1972.702779,2,59181023,59181083,60,audio/Bl122_59181023.jpg,Bl122
3341,1991.154779,1991.292779,1,59734643,59738783,4140,audio/Bl122_59734643.jpg,Bl122
3342,9045.708911,9045.819911,1,271371267,271374597,3330,audio/Li145_271371267.jpg,Li145
3343,1808.769926,1808.817926,1,54263097,54264537,1440,audio/Bl122_54263097.jpg,Bl122
3344,441.702265,441.740265,1,13251067,13252207,1140,audio/Or61_13251067.jpg,Or61
3345,2054.337469,2054.358469,2,61630124,61630754,630,audio/Bl122_61630124.jpg,Bl122
3346,1804.90205,1804.90905,2,54147061,54147271,210,audio/Bl122_54147061.jpg,Bl122
3347,2124.797183,2124.804183,2,63743915,63744125,210,audio/Bl122_63743915.jpg,Bl122
3348,386.626161,386.643161,1,11598784,11599294,510,audio/Or61_11598784.jpg,Or61
3349,14942.09125,14942.237581,1,448262737,448267127,4390,audio/Ti81_448262737.jpg,Ti81
3350,793.129827,793.189827,1,23793894,23795694,1800,audio/Or61_23793894.jpg,Or61
3351,15224.264443,15224.379443,1,456727933,456731383,3450,audio/Ti81_456727933.jpg,Ti81
3352,2094.799961,2094.811961,2,62843998,62844358,360,audio/Bl122_62843998.jpg,Bl122
3353,2014.010959,2014.013959,2,60420328,60420418,90,audio/Bl122_60420328.jpg,Bl122
3354,607.826417,607.834417,2,18234792,18235032,240,audio/Or61_18234792.jpg,Or61
3355,472.382221,472.391221,2,14171466,14171736,270,audio/Or61_14171466.jpg,Or61
3356,622.797417,622.841417,1,18683922,18685242,1320,audio/Or61_18683922.jpg,Or61
3357,733.860271,733.893271,1,22015808,22016798,990,audio/Or61_22015808.jpg,Or61
3358,534.643416,534.864416,1,16039302,16045932,6630,audio/Or61_16039302.jpg,Or61
3359,2217.220183,2217.230183,2,66516605,66516905,300,audio/Bl122_66516605.jpg,Bl122
3360,1972.887779,1972.911779,1,59186633,59187353,720,audio/Bl122_59186633.jpg,Bl122
3361,2149.679183,2149.711183,2,64490375,64491335,960,audio/Bl122_64490375.jpg,Bl122
3362,2123.179183,2123.184183,2,63695375,63695525,150,audio/Bl122_63695375.jpg,Bl122
3363,15222.412443,15222.678443,1,456672373,456680353,7980,audio/Ti81_456672373.jpg,Ti81
3364,2175.406183,2175.411183,2,65262185,65262335,150,audio/Bl122_65262185.jpg,Bl122
3365,183.774971,183.819971,2,5513249,5514599,1350,audio/Or61_5513249.jpg,Or61
3366,15110.295256,15110.330256,1,453308857,453309907,1050,audio/Ti81_453308857.jpg,Ti81
3367,2149.069183,2149.080183,2,64472075,64472405,330,audio/Bl122_64472075.jpg,Bl122
3368,15285.183439,15285.241439,1,458555503,458557243,1740,audio/Ti81_458555503.jpg,Ti81
3369,178.937971,179.147971,1,5368139,5374439,6300,audio/Or61_5368139.jpg,Or61
3370,1774.723974,1774.730974,2,53241719,53241929,210,audio/Bl122_53241719.jpg,Bl122
3371,488.771221,488.783221,2,14663136,14663496,360,audio/Or61_14663136.jpg,Or61
3372,1967.336779,1967.380779,1,59020103,59021423,1320,audio/Bl122_59020103.jpg,Bl122
3373,15138.270989,15138.355989,1,454148129,454150679,2550,audio/Ti81_454148129.jpg,Ti81
3374,1947.315779,1947.319779,2,58419473,58419593,120,audio/Bl122_58419473.jpg,Bl122
3375,15027.253326,15027.279313,1,450817599,450818379,780,audio/Ti81_450817599.jpg,Ti81
3376,15273.651439,15273.713439,1,458209543,458211403,1860,audio/Ti81_458209543.jpg,Ti81
3377,631.072417,631.273417,1,18932172,18938202,6030,audio/Or61_18932172.jpg,Or61
3378,2002.833779,2003.212779,1,60085013,60096383,11370,audio/Bl122_60085013.jpg,Bl122
3379,3467.93546,3468.074727,1,104038063,104042241,4178,audio/Ti81_104038063.jpg,Ti81
3380,546.489416,546.526416,1,16394682,16395792,1110,audio/Or61_16394682.jpg,Or61
3381,15303.727373,15303.863373,1,459111821,459115901,4080,audio/Ti81_459111821.jpg,Ti81
3382,2051.399469,2051.454469,1,61541984,61543634,1650,audio/Bl122_61541984.jpg,Bl122
3383,2157.470183,2157.550183,2,64724105,64726505,2400,audio/Bl122_64724105.jpg,Bl122
3384,488.436221,488.460221,2,14653086,14653806,720,audio/Or61_14653086.jpg,Or61
3385,1941.406779,1941.412779,2,58242203,58242383,180,audio/Bl122_58242203.jpg,Bl122
3386,604.874417,604.912417,2,18146232,18147372,1140,audio/Or61_18146232.jpg,Or61
3387,2140.380183,2140.393183,2,64211405,64211795,390,audio/Bl122_64211405.jpg,Bl122
3388,1984.269779,1984.277779,2,59528093,59528333,240,audio/Bl122_59528093.jpg,Bl122
3389,475.378221,475.382221,2,14261346,14261466,120,audio/Or61_14261346.jpg,Or61
3390,2127.454183,2127.684183,1,63823625,63830525,6900,audio/Bl122_63823625.jpg,Bl122
3391,4.29015,4.32215,1,128704,129664,960,audio/Or61_128704.jpg,Or61
3392,622.789417,622.793417,2,18683682,18683802,120,audio/Or61_18683682.jpg,Or61
3393,1960.535779,1960.557779,2,58816073,58816733,660,audio/Bl122_58816073.jpg,Bl122
3394,1794.061115,1794.068115,2,53821833,53822043,210,audio/Bl122_53821833.jpg,Bl122
3395,2234.481183,2234.491183,2,67034435,67034735,300,audio/Bl122_67034435.jpg,Bl122
3396,2118.766183,2118.884183,1,63562985,63566525,3540,audio/Bl122_63562985.jpg,Bl122
3397,541.577416,541.583416,2,16247322,16247502,180,audio/Or61_16247322.jpg,Or61
3398,713.306271,713.466271,1,21399188,21403988,4800,audio/Or61_21399188.jpg,Or61
3399,2141.117183,2141.161183,2,64233515,64234835,1320,audio/Bl122_64233515.jpg,Bl122
3400,2174.561183,2174.569183,2,65236835,65237075,240,audio/Bl122_65236835.jpg,Bl122
3401,2071.954469,2071.958469,2,62158634,62158754,120,audio/Bl122_62158634.jpg,Bl122
3402,387.732161,387.872161,1,11631964,11636164,4200,audio/Or61_11631964.jpg,Or61
3403,577.38671,577.39571,1,17321601,17321871,270,audio/Or61_17321601.jpg,Or61
3404,719.187271,719.201271,1,21575618,21576038,420,audio/Or61_21575618.jpg,Or61
3405,2135.663183,2135.697183,1,64069895,64070915,1020,audio/Bl122_64069895.jpg,Bl122
3406,1970.077779,1970.080779,2,59102333,59102423,90,audio/Bl122_59102333.jpg,Bl122
3407,2158.679183,2158.685183,2,64760375,64760555,180,audio/Bl122_64760375.jpg,Bl122
3408,2212.212183,2212.272183,1,66366365,66368165,1800,audio/Bl122_66366365.jpg,Bl122
3409,617.280417,617.286417,2,18518412,18518592,180,audio/Or61_18518412.jpg,Or61
3410,14903.495253,14903.636917,1,447104857,447109107,4250,audio/Ti81_447104857.jpg,Ti81
3411,479.898221,479.901221,2,14396946,14397036,90,audio/Or61_14396946.jpg,Or61
3412,503.539221,503.568221,1,15106176,15107046,870,audio/Or61_15106176.jpg,Or61
3413,2055.071469,2055.112469,1,61652144,61653374,1230,audio/Bl122_61652144.jpg,Bl122
3414,2217.743183,2217.774183,2,66532295,66533225,930,audio/Bl122_66532295.jpg,Bl122
3415,15239.662874,15239.694874,1,457189886,457190846,960,audio/Ti81_457189886.jpg,Ti81
3416,15309.165373,15309.191373,1,459274961,459275741,780,audio/Ti81_459274961.jpg,Ti81
3417,412.799165,412.819165,1,12383974,12384574,600,audio/Or61_12383974.jpg,Or61
3418,15239.781874,15239.818874,1,457193456,457194566,1110,audio/Ti81_457193456.jpg,Ti81
3419,808.691882,808.709882,1,24260756,24261296,540,audio/Or61_24260756.jpg,Or61
3420,1949.923779,1950.141779,1,58497713,58504253,6540,audio/Bl122_58497713.jpg,Bl122
3421,15029.544927,15029.721282,1,450886347,450891638,5291,audio/Ti81_450886347.jpg,Ti81
3422,167.033975,167.353975,1,5011019,5020619,9600,audio/Or61_5011019.jpg,Or61
3423,15335.69201,15335.73201,1,460070760,460071960,1200,audio/Ti81_460070760.jpg,Ti81
3424,610.399417,610.415417,1,18311982,18312462,480,audio/Or61_18311982.jpg,Or61
3425,15278.642439,15278.904439,1,458359273,458367133,7860,audio/Ti81_458359273.jpg,Ti81
3426,15223.733443,15223.754443,1,456712003,456712633,630,audio/Ti81_456712003.jpg,Ti81
3427,2049.370469,2049.399469,2,61481114,61481984,870,audio/Bl122_61481114.jpg,Bl122
3428,1953.797779,1953.956779,1,58613933,58618703,4770,audio/Bl122_58613933.jpg,Bl122
3429,1938.798779,1938.811779,2,58163963,58164353,390,audio/Bl122_58163963.jpg,Bl122
3430,715.871271,715.876271,2,21476138,21476288,150,audio/Or61_21476138.jpg,Or61
3431,15025.53822,15025.571397,1,450766146,450767141,995,audio/Ti81_450766146.jpg,Ti81
3432,15285.260439,15285.291439,1,458557813,458558743,930,audio/Ti81_458557813.jpg,Ti81
3433,180.063971,180.128971,1,5401919,5403869,1950,audio/Or61_5401919.jpg,Or61
3434,2214.810183,2214.820183,2,66444305,66444605,300,audio/Bl122_66444305.jpg,Bl122
3435,15205.39658,15205.44558,1,456161897,456163367,1470,audio/Ti81_456161897.jpg,Ti81
3436,1968.854779,1968.945779,1,59065643,59068373,2730,audio/Bl122_59065643.jpg,Bl122
3437,399.458529,399.471529,2,11983755,11984145,390,audio/Or61_11983755.jpg,Or61
3438,15207.84958,15207.89058,1,456235487,456236717,1230,audio/Ti81_456235487.jpg,Ti81
3439,816.122882,816.132882,2,24483686,24483986,300,audio/Or61_24483686.jpg,Or61
3440,552.595416,552.623416,1,16577862,16578702,840,audio/Or61_16577862.jpg,Or61
3441,1793.643115,1793.853115,1,53809293,53815593,6300,audio/Bl122_53809293.jpg,Bl122
3442,602.570417,602.696417,1,18077112,18080892,3780,audio/Or61_18077112.jpg,Or61
3443,715.492271,715.566271,1,21464768,21466988,2220,audio/Or61_21464768.jpg,Or61
3444,5841.173404,5841.177404,1,175235202,175235322,120,audio/Li145_175235202.jpg,Li145
3445,604.577417,604.589417,2,18137322,18137682,360,audio/Or61_18137322.jpg,Or61
3446,15151.469716,15151.515716,1,454544091,454545471,1380,audio/Ti81_454544091.jpg,Ti81
3447,8888.235716,8888.252716,1,266647071,266647581,510,audio/Li145_266647071.jpg,Li145
3448,2054.362469,2054.380469,2,61630874,61631414,540,audio/Bl122_61630874.jpg,Bl122
3449,2144.074183,2144.085183,2,64322225,64322555,330,audio/Bl122_64322225.jpg,Bl122
3450,1966.312779,1966.320779,2,58989383,58989623,240,audio/Bl122_58989383.jpg,Bl122
3451,477.172221,477.303221,1,14315166,14319096,3930,audio/Or61_14315166.jpg,Or61
3452,1767.447823,1767.573823,1,53023434,53027214,3780,audio/Bl122_53023434.jpg,Bl122
3453,771.345271,771.352271,2,23140358,23140568,210,audio/Or61_23140358.jpg,Or61
3454,733.939271,733.985271,1,22018178,22019558,1380,audio/Or61_22018178.jpg,Or61
3455,2216.415183,2216.434183,1,66492455,66493025,570,audio/Bl122_66492455.jpg,Bl122
3456,1977.690779,1977.695779,2,59330723,59330873,150,audio/Bl122_59330723.jpg,Bl122
3457,15315.508428,15315.527428,1,459465252,459465822,570,audio/Ti81_459465252.jpg,Ti81
3458,412.517165,412.532165,1,12375514,12375964,450,audio/Or61_12375514.jpg,Or61
3459,2197.460183,2197.517183,1,65923805,65925515,1710,audio/Bl122_65923805.jpg,Bl122
3460,613.882417,613.899417,1,18416472,18416982,510,audio/Or61_18416472.jpg,Or61
3461,15095.060823,15095.30979,1,452851824,452859293,7469,audio/Ti81_452851824.jpg,Ti81
3462,1949.907779,1949.913779,2,58497233,58497413,180,audio/Bl122_58497233.jpg,Bl122
3463,2218.648183,2218.756183,1,66559445,66562685,3240,audio/Bl122_66559445.jpg,Bl122
3464,2201.491183,2201.541183,2,66044735,66046235,1500,audio/Bl122_66044735.jpg,Bl122
3465,482.026221,482.031221,2,14460786,14460936,150,audio/Or61_14460786.jpg,Or61
3466,1787.065115,1787.073115,2,53611953,53612193,240,audio/Bl122_53611953.jpg,Bl122
3467,618.606417,618.769417,1,18558192,18563082,4890,audio/Or61_18558192.jpg,Or61
3468,7447.002311,7447.156311,1,223410069,223414689,4620,audio/Li145_223410069.jpg,Li145
3469,8097.273141,8097.321141,1,242918194,242919634,1440,audio/Li145_242918194.jpg,Li145
3470,2220.793183,2220.835183,1,66623795,66625055,1260,audio/Bl122_66623795.jpg,Bl122
3471,412.534165,412.551165,1,12376024,12376534,510,audio/Or61_12376024.jpg,Or61
3472,1782.894323,1783.062323,1,53486829,53491869,5040,audio/Bl122_53486829.jpg,Bl122
3473,2220.715183,2220.763183,1,66621455,66622895,1440,audio/Bl122_66621455.jpg,Bl122
3474,1946.119779,1946.200779,2,58383593,58386023,2430,audio/Bl122_58383593.jpg,Bl122
3475,15151.521716,15151.666716,1,454545651,454550001,4350,audio/Ti81_454545651.jpg,Ti81
3476,2012.062959,2012.269959,2,60361888,60368098,6210,audio/Bl122_60361888.jpg,Bl122
3477,2223.888183,2223.897183,2,66716645,66716915,270,audio/Bl122_66716645.jpg,Bl122
3478,1955.418779,1955.444779,1,58662563,58663343,780,audio/Bl122_58662563.jpg,Bl122
3479,503.252221,503.254221,2,15097566,15097626,60,audio/Or61_15097566.jpg,Or61
3480,1945.499779,1945.505779,2,58364993,58365173,180,audio/Bl122_58364993.jpg,Bl122
3481,471.025221,471.050221,1,14130756,14131506,750,audio/Or61_14130756.jpg,Or61
3482,2226.510183,2226.515183,2,66795305,66795455,150,audio/Bl122_66795305.jpg,Bl122
3483,15315.602428,15315.761428,1,459468072,459472842,4770,audio/Ti81_459468072.jpg,Ti81
3484,488.586221,488.599221,2,14657586,14657976,390,audio/Or61_14657586.jpg,Or61
3485,1812.485013,1812.489013,2,54374550,54374670,120,audio/Bl122_54374550.jpg,Bl122
3486,8083.765803,8083.768803,2,242512974,242513064,90,audio/Li145_242512974.jpg,Li145
3487,729.503271,729.506271,2,21885098,21885188,90,audio/Or61_21885098.jpg,Or61
3488,804.066882,804.072882,2,24122006,24122186,180,audio/Or61_24122006.jpg,Or61
3489,15285.454439,15285.776439,1,458563633,458573293,9660,audio/Ti81_458563633.jpg,Ti81
3490,15095.999823,15096.049823,1,452879994,452881494,1500,audio/Ti81_452879994.jpg,Ti81
3491,747.601271,747.610271,2,22428038,22428308,270,audio/Or61_22428038.jpg,Or61
3492,1945.512779,1945.548779,2,58365383,58366463,1080,audio/Bl122_58365383.jpg,Bl122
3493,2218.406183,2218.624183,1,66552185,66558725,6540,audio/Bl122_66552185.jpg,Bl122
3494,15110.016256,15110.060256,1,453300487,453301807,1320,audio/Ti81_453300487.jpg,Ti81
3495,812.657882,812.769882,1,24379736,24383096,3360,audio/Or61_24379736.jpg,Or61
3496,1977.843779,1977.854779,2,59335313,59335643,330,audio/Bl122_59335313.jpg,Bl122
3497,2185.513183,2185.609183,2,65565395,65568275,2880,audio/Bl122_65565395.jpg,Bl122
3498,1959.791779,1959.794779,2,58793753,58793843,90,audio/Bl122_58793753.jpg,Bl122
3499,2056.217469,2056.258469,1,61686524,61687754,1230,audio/Bl122_61686524.jpg,Bl122
3500,494.632221,494.641221,1,14838966,14839236,270,audio/Or61_14838966.jpg,Or61
3501,476.732221,476.768221,1,14301966,14303046,1080,audio/Or61_14301966.jpg,Or61
3502,15165.988257,15166.067257,1,454979647,454982017,2370,audio/Ti81_454979647.jpg,Ti81
3503,1988.668779,1988.708779,2,59660063,59661263,1200,audio/Bl122_59660063.jpg,Bl122
3504,1940.746779,1940.762779,2,58222403,58222883,480,audio/Bl122_58222403.jpg,Bl122
3505,1486.519018,1486.545018,1,44595570,44596350,780,audio/Li145_44595570.jpg,Li145
3506,2151.327183,2151.375183,2,64539815,64541255,1440,audio/Bl122_64539815.jpg,Bl122
3507,2054.453469,2054.492469,2,61633604,61634774,1170,audio/Bl122_61633604.jpg,Bl122
3508,2143.708183,2143.730183,2,64311245,64311905,660,audio/Bl122_64311245.jpg,Bl122
3509,15085.1459,15085.4729,1,452554377,452564187,9810,audio/Ti81_452554377.jpg,Ti81
3510,15089.0899,15089.2139,1,452672697,452676417,3720,audio/Ti81_452672697.jpg,Ti81
3511,3463.87905,3464.070795,1,103916371,103922123,5752,audio/Ti81_103916371.jpg,Ti81
3512,738.401271,738.484271,1,22152038,22154528,2490,audio/Or61_22152038.jpg,Or61
3513,3544.514754,3544.664113,1,106335442,106339923,4481,audio/Ti81_106335442.jpg,Ti81
3514,2202.989183,2203.161183,1,66089675,66094835,5160,audio/Bl122_66089675.jpg,Bl122
3515,657.834685,657.879685,1,19735040,19736390,1350,audio/Li145_19735040.jpg,Li145
3516,2186.396183,2186.479183,1,65591885,65594375,2490,audio/Bl122_65591885.jpg,Bl122
3517,2113.749183,2113.784183,1,63412475,63413525,1050,audio/Bl122_63412475.jpg,Bl122
3518,1968.835779,1968.841779,2,59065073,59065253,180,audio/Bl122_59065073.jpg,Bl122
3519,1963.069779,1963.089779,2,58892093,58892693,600,audio/Bl122_58892093.jpg,Bl122
3520,15041.986698,15042.067169,1,451259600,451262015,2415,audio/Ti81_451259600.jpg,Ti81
3521,2034.191469,2034.253469,1,61025744,61027604,1860,audio/Bl122_61025744.jpg,Bl122
3522,15050.088966,15050.113966,2,451502668,451503418,750,audio/Ti81_451502668.jpg,Ti81
3523,2195.640183,2195.740183,2,65869205,65872205,3000,audio/Bl122_65869205.jpg,Bl122
3524,3466.724188,3466.796345,1,104001725,104003890,2165,audio/Ti81_104001725.jpg,Ti81
3525,547.145416,547.153416,2,16414362,16414602,240,audio/Or61_16414362.jpg,Or61
3526,3539.265996,3539.30712,1,106177979,106179213,1234,audio/Ti81_106177979.jpg,Ti81
3527,2111.187183,2111.220183,1,63335615,63336605,990,audio/Bl122_63335615.jpg,Bl122
3528,790.156827,790.159827,2,23704704,23704794,90,audio/Or61_23704704.jpg,Or61
3529,616.535417,616.579417,1,18496062,18497382,1320,audio/Or61_18496062.jpg,Or61
3530,1939.139779,1939.158779,2,58174193,58174763,570,audio/Bl122_58174193.jpg,Bl122
3531,2115.502183,2115.514183,2,63465065,63465425,360,audio/Bl122_63465065.jpg,Bl122
3532,196.958012,197.153012,1,5908740,5914590,5850,audio/Or61_5908740.jpg,Or61
3533,2001.952779,2002.151779,1,60058583,60064553,5970,audio/Bl122_60058583.jpg,Bl122
3534,15243.928874,15243.975874,1,457317866,457319276,1410,audio/Ti81_457317866.jpg,Ti81
3535,536.908416,536.979416,1,16107252,16109382,2130,audio/Or61_16107252.jpg,Or61
3536,563.990416,564.001416,2,16919712,16920042,330,audio/Or61_16919712.jpg,Or61
3537,789.661827,789.665827,2,23689854,23689974,120,audio/Or61_23689854.jpg,Or61
3538,2207.736183,2207.760183,2,66232085,66232805,720,audio/Bl122_66232085.jpg,Bl122
3539,15304.600373,15304.644373,1,459138011,459139331,1320,audio/Ti81_459138011.jpg,Ti81
3540,1790.424115,1790.528115,1,53712723,53715843,3120,audio/Bl122_53712723.jpg,Bl122
3541,538.930416,538.951416,1,16167912,16168542,630,audio/Or61_16167912.jpg,Or61
3542,412.896165,413.339165,1,12386884,12400174,13290,audio/Or61_12386884.jpg,Or61
3543,1789.422115,1789.536115,1,53682663,53686083,3420,audio/Bl122_53682663.jpg,Bl122
3544,2110.816183,2110.820183,2,63324485,63324605,120,audio/Bl122_63324485.jpg,Bl122
3545,1997.253779,1997.257779,2,59917613,59917733,120,audio/Bl122_59917613.jpg,Bl122
3546,563.913416,563.988416,2,16917402,16919652,2250,audio/Or61_16917402.jpg,Or61
3547,1542.971152,1542.994152,1,46289134,46289824,690,audio/Li145_46289134.jpg,Li145
3548,8743.036692,8743.051692,1,262291100,262291550,450,audio/Li145_262291100.jpg,Li145
3549,2147.510183,2147.519183,2,64425305,64425575,270,audio/Bl122_64425305.jpg,Bl122
3550,15035.967996,15035.984017,1,451079039,451079520,481,audio/Ti81_451079039.jpg,Ti81
3551,15277.603439,15277.624439,1,458328103,458328733,630,audio/Ti81_458328103.jpg,Ti81
3552,811.449882,811.452882,2,24343496,24343586,90,audio/Or61_24343496.jpg,Or61
3553,505.062221,505.107221,2,15151866,15153216,1350,audio/Or61_15151866.jpg,Or61
3554,2003.838779,2003.885779,1,60115163,60116573,1410,audio/Bl122_60115163.jpg,Bl122
3555,565.153416,565.181416,1,16954602,16955442,840,audio/Or61_16954602.jpg,Or61
3556,486.193221,486.231221,2,14585796,14586936,1140,audio/Or61_14585796.jpg,Or61
3557,15041.892528,15041.970109,1,451256775,451259103,2328,audio/Ti81_451256775.jpg,Ti81
3558,735.808271,735.817271,2,22074248,22074518,270,audio/Or61_22074248.jpg,Or61
3559,529.033416,529.045416,2,15871002,15871362,360,audio/Or61_15871002.jpg,Or61
3560,632.027417,632.076417,2,18960822,18962292,1470,audio/Or61_18960822.jpg,Or61
3561,2072.069469,2072.172469,2,62162084,62165174,3090,audio/Bl122_62162084.jpg,Bl122
3562,1949.494779,1949.548779,1,58484843,58486463,1620,audio/Bl122_58484843.jpg,Bl122
3563,1788.949115,1788.995115,1,53668473,53669853,1380,audio/Bl122_53668473.jpg,Bl122
3564,4.42315,4.44915,1,132694,133474,780,audio/Or61_132694.jpg,Or61
3565,611.932417,611.978417,1,18357972,18359352,1380,audio/Or61_18357972.jpg,Or61
3566,568.475467,568.504467,1,17054264,17055134,870,audio/Or61_17054264.jpg,Or61
3567,620.391417,620.479417,1,18611742,18614382,2640,audio/Or61_18611742.jpg,Or61
3568,2224.637183,2224.666183,2,66739115,66739985,870,audio/Bl122_66739115.jpg,Bl122
3569,852.030618,852.266767,1,25560918,25568003,7085,audio/Ti81_25560918.jpg,Ti81
3570,4921.428507,4921.569507,1,147642855,147647085,4230,audio/Li145_147642855.jpg,Li145
3571,211.793765,211.966765,1,6353812,6359002,5190,audio/Or61_6353812.jpg,Or61
3572,1775.307974,1775.599974,1,53259239,53267999,8760,audio/Bl122_53259239.jpg,Bl122
3573,2224.520183,2224.555183,1,66735605,66736655,1050,audio/Bl122_66735605.jpg,Bl122
3574,1998.707779,1998.711779,2,59961233,59961353,120,audio/Bl122_59961233.jpg,Bl122
3575,503.401221,503.414221,2,15102036,15102426,390,audio/Or61_15102036.jpg,Or61
3576,8865.132987,8865.143987,1,265953989,265954319,330,audio/Li145_265953989.jpg,Li145
3577,1997.373779,1997.408779,1,59921213,59922263,1050,audio/Bl122_59921213.jpg,Bl122
3578,15234.949874,15235.106874,1,457048496,457053206,4710,audio/Ti81_457048496.jpg,Ti81
3579,2085.550961,2085.766961,1,62566528,62573008,6480,audio/Bl122_62566528.jpg,Bl122
3580,15151.410716,15151.450716,1,454542321,454543521,1200,audio/Ti81_454542321.jpg,Ti81
3581,611.557417,611.572417,2,18346722,18347172,450,audio/Or61_18346722.jpg,Or61
3582,15264.456358,15264.480358,1,457933690,457934410,720,audio/Ti81_457933690.jpg,Ti81
3583,8889.456716,8889.464716,1,266683701,266683941,240,audio/Li145_266683701.jpg,Li145
3584,2199.036183,2199.095183,2,65971085,65972855,1770,audio/Bl122_65971085.jpg,Bl122
3585,559.754416,560.005416,1,16792632,16800162,7530,audio/Or61_16792632.jpg,Or61
3586,2071.831469,2071.844469,2,62154944,62155334,390,audio/Bl122_62154944.jpg,Bl122
3587,1788.109115,1788.118115,2,53643273,53643543,270,audio/Bl122_53643273.jpg,Bl122
3588,405.454692,405.514692,1,12163640,12165440,1800,audio/Or61_12163640.jpg,Or61
3589,2162.438183,2162.442183,2,64873145,64873265,120,audio/Bl122_64873145.jpg,Bl122
3590,2062.978469,2062.985469,2,61889354,61889564,210,audio/Bl122_61889354.jpg,Bl122
3591,3541.203374,3541.357779,1,106236101,106240733,4632,audio/Ti81_106236101.jpg,Ti81
3592,2167.222183,2167.228183,2,65016665,65016845,180,audio/Bl122_65016665.jpg,Bl122
3593,15298.029448,15298.045629,1,458940883,458941368,485,audio/Ti81_458940883.jpg,Ti81
3594,7552.787715,7552.797715,1,226583631,226583931,300,audio/Li145_226583631.jpg,Li145
3595,5840.866404,5840.878404,1,175225992,175226352,360,audio/Li145_175225992.jpg,Li145
3596,15021.672547,15021.849658,1,450650176,450655489,5313,audio/Ti81_450650176.jpg,Ti81
3597,723.300271,723.495271,1,21699008,21704858,5850,audio/Or61_21699008.jpg,Or61
3598,544.414416,544.433416,1,16332432,16333002,570,audio/Or61_16332432.jpg,Or61
3599,15038.5814,15038.76709,1,451157442,451163012,5570,audio/Ti81_451157442.jpg,Ti81
3600,2140.976183,2141.000183,1,64229285,64230005,720,audio/Bl122_64229285.jpg,Bl122
3601,428.944969,429.010969,1,12868349,12870329,1980,audio/Or61_12868349.jpg,Or61
3602,501.277221,501.297221,2,15038316,15038916,600,audio/Or61_15038316.jpg,Or61
3603,453.583219,453.592219,2,13607496,13607766,270,audio/Or61_13607496.jpg,Or61
3604,2205.190183,2205.371183,1,66155705,66161135,5430,audio/Bl122_66155705.jpg,Bl122
3605,2095.290961,2095.491961,1,62858728,62864758,6030,audio/Bl122_62858728.jpg,Bl122
3606,761.554271,761.644271,1,22846628,22849328,2700,audio/Or61_22846628.jpg,Or61
3607,15235.108874,15235.131874,1,457053266,457053956,690,audio/Ti81_457053266.jpg,Ti81
3608,15231.319443,15231.416443,1,456939583,456942493,2910,audio/Ti81_456939583.jpg,Ti81
3609,535.962416,535.973416,1,16078872,16079202,330,audio/Or61_16078872.jpg,Or61
3610,1812.321013,1812.326013,2,54369630,54369780,150,audio/Bl122_54369630.jpg,Bl122
3611,1793.546115,1793.575115,1,53806383,53807253,870,audio/Bl122_53806383.jpg,Bl122
3612,15221.345443,15221.486443,1,456640363,456644593,4230,audio/Ti81_456640363.jpg,Ti81
3613,498.900221,498.907221,2,14967006,14967216,210,audio/Or61_14967006.jpg,Or61
3614,5909.617207,5909.633207,1,177288516,177288996,480,audio/Li145_177288516.jpg,Li145
3615,15068.363682,15068.794682,1,452050910,452063840,12930,audio/Ti81_452050910.jpg,Ti81
3616,15133.483989,15133.510989,1,454004519,454005329,810,audio/Ti81_454004519.jpg,Ti81
3617,3579.924097,3579.949097,1,107397722,107398472,750,audio/Li145_107397722.jpg,Li145
3618,1948.564779,1948.568779,2,58456943,58457063,120,audio/Bl122_58456943.jpg,Bl122
3619,704.959271,705.020271,1,21148778,21150608,1830,audio/Or61_21148778.jpg,Or61
3620,2224.021183,2224.026183,2,66720635,66720785,150,audio/Bl122_66720635.jpg,Bl122
3621,1792.525115,1792.900115,1,53775753,53787003,11250,audio/Bl122_53775753.jpg,Bl122
3622,2050.685469,2050.715469,1,61520564,61521464,900,audio/Bl122_61520564.jpg,Bl122
3623,2000.680779,2000.841779,1,60020423,60025253,4830,audio/Bl122_60020423.jpg,Bl122
3624,2170.249183,2170.251183,2,65107475,65107535,60,audio/Bl122_65107475.jpg,Bl122
3625,1976.568779,1976.621779,2,59297063,59298653,1590,audio/Bl122_59297063.jpg,Bl122
3626,2184.325183,2184.338183,1,65529755,65530145,390,audio/Bl122_65529755.jpg,Bl122
3627,5968.396227,5968.404227,1,179051886,179052126,240,audio/Li145_179051886.jpg,Li145
3628,1809.210926,1809.275926,1,54276327,54278277,1950,audio/Bl122_54276327.jpg,Bl122
3629,2098.722961,2098.728961,2,62961688,62961868,180,audio/Bl122_62961688.jpg,Bl122
3630,15166.080257,15166.124257,1,454982407,454983727,1320,audio/Ti81_454982407.jpg,Ti81
3631,3425.558876,3425.745322,1,102766766,102772359,5593,audio/Ti81_102766766.jpg,Ti81
3632,2121.400183,2121.513183,1,63642005,63645395,3390,audio/Bl122_63642005.jpg,Bl122
3633,2223.516183,2223.535183,2,66705485,66706055,570,audio/Bl122_66705485.jpg,Bl122
3634,2189.194183,2189.205183,2,65675825,65676155,330,audio/Bl122_65675825.jpg,Bl122
3635,15128.215981,15128.255981,1,453846479,453847679,1200,audio/Ti81_453846479.jpg,Ti81
3636,2058.444469,2058.510469,1,61753334,61755314,1980,audio/Bl122_61753334.jpg,Bl122
3637,2215.554183,2215.588183,2,66466625,66467645,1020,audio/Bl122_66466625.jpg,Bl122
3638,1975.044779,1975.048779,2,59251343,59251463,120,audio/Bl122_59251343.jpg,Bl122
3639,2121.390183,2121.397183,2,63641705,63641915,210,audio/Bl122_63641705.jpg,Bl122
3640,611.886417,611.898417,2,18356592,18356952,360,audio/Or61_18356592.jpg,Or61
3641,15237.493874,15237.534874,1,457124816,457126046,1230,audio/Ti81_457124816.jpg,Ti81
3642,2083.083961,2083.086961,2,62492518,62492608,90,audio/Bl122_62492518.jpg,Bl122
3643,1939.794779,1939.874779,1,58193843,58196243,2400,audio/Bl122_58193843.jpg,Bl122
3644,2058.722469,2058.883469,1,61761674,61766504,4830,audio/Bl122_61761674.jpg,Bl122
3645,1793.114115,1793.390115,1,53793423,53801703,8280,audio/Bl122_53793423.jpg,Bl122
3646,657.988685,657.992685,2,19739660,19739780,120,audio/Li145_19739660.jpg,Li145
3647,805.984882,806.183882,1,24179546,24185516,5970,audio/Or61_24179546.jpg,Or61
3648,2117.583183,2117.675183,1,63527495,63530255,2760,audio/Bl122_63527495.jpg,Bl122
3649,15025.358208,15025.377887,1,450760746,450761336,590,audio/Ti81_450760746.jpg,Ti81
3650,2159.047183,2159.054183,2,64771415,64771625,210,audio/Bl122_64771415.jpg,Bl122
3651,2182.926183,2182.957183,1,65487785,65488715,930,audio/Bl122_65487785.jpg,Bl122
3652,182.298971,182.362971,1,5468969,5470889,1920,audio/Or61_5468969.jpg,Or61
3653,3464.758553,3464.911192,1,103942756,103947335,4579,audio/Ti81_103942756.jpg,Ti81
3654,2041.171469,2041.239469,1,61235144,61237184,2040,audio/Bl122_61235144.jpg,Bl122
3655,529.198416,529.200416,2,15875952,15876012,60,audio/Or61_15875952.jpg,Or61
3656,6953.932285,6954.011285,1,208617968,208620338,2370,audio/Li145_208617968.jpg,Li145
3657,5873.183637,5873.199637,1,176195509,176195989,480,audio/Li145_176195509.jpg,Li145
3658,813.196882,813.375882,1,24395906,24401276,5370,audio/Or61_24395906.jpg,Or61
3659,1961.078779,1961.087779,2,58832363,58832633,270,audio/Bl122_58832363.jpg,Bl122
3660,1789.796115,1789.829115,1,53693883,53694873,990,audio/Bl122_53693883.jpg,Bl122
3661,15229.619443,15229.855099,1,456888583,456895652,7069,audio/Ti81_456888583.jpg,Ti81
3662,8097.006141,8097.037141,1,242910184,242911114,930,audio/Li145_242910184.jpg,Li145
3663,15137.303989,15137.403989,1,454119119,454122119,3000,audio/Ti81_454119119.jpg,Ti81
3664,721.004271,721.008271,2,21630128,21630248,120,audio/Or61_21630128.jpg,Or61
3665,1801.532115,1801.539115,2,54045963,54046173,210,audio/Bl122_54045963.jpg,Bl122
3666,213.500857,213.658857,1,6405025,6409765,4740,audio/Or61_6405025.jpg,Or61
3667,2228.741183,2228.748183,2,66862235,66862445,210,audio/Bl122_66862235.jpg,Bl122
3668,2223.920183,2223.925183,2,66717605,66717755,150,audio/Bl122_66717605.jpg,Bl122
3669,9166.736583,9166.792583,1,275002097,275003777,1680,audio/Li145_275002097.jpg,Li145
3670,2162.244183,2162.250183,2,64867325,64867505,180,audio/Bl122_64867325.jpg,Bl122
3671,1807.837926,1807.973926,1,54235137,54239217,4080,audio/Bl122_54235137.jpg,Bl122
3672,2212.751183,2212.803183,2,66382535,66384095,1560,audio/Bl122_66382535.jpg,Bl122
3673,15216.97458,15217.02158,1,456509237,456510647,1410,audio/Ti81_456509237.jpg,Ti81
3674,5.484509,5.487509,2,164535,164625,90,audio/Or61_164535.jpg,Or61
3675,746.577271,746.621271,1,22397318,22398638,1320,audio/Or61_22397318.jpg,Or61
3676,1988.083779,1988.254779,1,59642513,59647643,5130,audio/Bl122_59642513.jpg,Bl122
3677,2223.309183,2223.328183,2,66699275,66699845,570,audio/Bl122_66699275.jpg,Bl122
3678,2143.149183,2143.274183,1,64294475,64298225,3750,audio/Bl122_64294475.jpg,Bl122
3679,15161.119257,15161.319212,1,454833577,454839576,5999,audio/Ti81_454833577.jpg,Ti81
3680,1757.430955,1757.477955,1,52722928,52724338,1410,audio/Bl122_52722928.jpg,Bl122
3681,15217.83258,15217.90158,1,456534977,456537047,2070,audio/Ti81_456534977.jpg,Ti81
3682,14943.026447,14943.06038,1,448290793,448291811,1018,audio/Ti81_448290793.jpg,Ti81
3683,631.338417,631.344417,2,18940152,18940332,180,audio/Or61_18940152.jpg,Or61
3684,2184.724183,2184.728183,2,65541725,65541845,120,audio/Bl122_65541725.jpg,Bl122
3685,804.460882,804.468882,1,24133826,24134066,240,audio/Or61_24133826.jpg,Or61
3686,715.817271,715.851271,1,21474518,21475538,1020,audio/Or61_21474518.jpg,Or61
3687,1801.222115,1801.240115,2,54036663,54037203,540,audio/Bl122_54036663.jpg,Bl122
3688,747.461271,747.469271,1,22423838,22424078,240,audio/Or61_22423838.jpg,Or61
3689,2196.325183,2196.348183,2,65889755,65890445,690,audio/Bl122_65889755.jpg,Bl122
3690,922.735713,922.925187,1,27682071,27687755,5684,audio/Ti81_27682071.jpg,Ti81
3691,545.952416,546.012416,1,16378572,16380372,1800,audio/Or61_16378572.jpg,Or61
3692,555.149416,555.226416,1,16654482,16656792,2310,audio/Or61_16654482.jpg,Or61
3693,708.685271,708.762271,1,21260558,21262868,2310,audio/Or61_21260558.jpg,Or61
3694,8741.048692,8741.108692,1,262231460,262233260,1800,audio/Li145_262231460.jpg,Li145
3695,765.898271,765.912271,2,22976948,22977368,420,audio/Or61_22976948.jpg,Or61
3696,1782.757323,1782.892323,1,53482719,53486769,4050,audio/Bl122_53482719.jpg,Bl122
3697,2222.068183,2222.220183,1,66662045,66666605,4560,audio/Bl122_66662045.jpg,Bl122
3698,2048.044469,2048.054469,1,61441334,61441634,300,audio/Bl122_61441334.jpg,Bl122
3699,2171.282183,2171.337183,2,65138465,65140115,1650,audio/Bl122_65138465.jpg,Bl122
3700,1794.098115,1794.421115,1,53822943,53832633,9690,audio/Bl122_53822943.jpg,Bl122
3701,406.536692,406.552692,2,12196100,12196580,480,audio/Or61_12196100.jpg,Or61
3702,500.425221,500.460221,1,15012756,15013806,1050,audio/Or61_15012756.jpg,Or61
3703,7567.499558,7567.603558,1,227024986,227028106,3120,audio/Li145_227024986.jpg,Li145
3704,761.647271,761.784271,1,22849418,22853528,4110,audio/Or61_22849418.jpg,Or61
3705,1771.048657,1771.218657,1,53131459,53136559,5100,audio/Bl122_53131459.jpg,Bl122
3706,1976.796779,1976.839779,1,59303903,59305193,1290,audio/Bl122_59303903.jpg,Bl122
3707,15142.267403,15142.588403,1,454268022,454277652,9630,audio/Ti81_454268022.jpg,Ti81
3708,3450.340614,3450.373161,1,103510218,103511194,976,audio/Ti81_103510218.jpg,Ti81
3709,1945.953779,1945.975779,1,58378613,58379273,660,audio/Bl122_58378613.jpg,Bl122
3710,15127.726981,15127.805981,1,453831809,453834179,2370,audio/Ti81_453831809.jpg,Ti81
3711,1952.318779,1952.324779,2,58569563,58569743,180,audio/Bl122_58569563.jpg,Bl122
3712,614.056417,614.086417,2,18421692,18422592,900,audio/Or61_18421692.jpg,Or61
3713,2154.502183,2154.506183,2,64635065,64635185,120,audio/Bl122_64635065.jpg,Bl122
3714,3539.321501,3539.451433,1,106179645,106183542,3897,audio/Ti81_106179645.jpg,Ti81
3715,781.054878,781.109878,1,23431646,23433296,1650,audio/Or61_23431646.jpg,Or61
3716,2144.232183,2144.299183,2,64326965,64328975,2010,audio/Bl122_64326965.jpg,Bl122
3717,15210.33458,15210.38258,1,456310037,456311477,1440,audio/Ti81_456310037.jpg,Ti81
3718,15058.355966,15058.675966,1,451750678,451760278,9600,audio/Ti81_451750678.jpg,Ti81
3719,2159.467183,2159.472183,2,64784015,64784165,150,audio/Bl122_64784015.jpg,Bl122
3720,2151.279183,2151.322183,2,64538375,64539665,1290,audio/Bl122_64538375.jpg,Bl122
3721,3469.868296,3470.062031,1,104096048,104101860,5812,audio/Ti81_104096048.jpg,Ti81
3722,2136.011183,2136.017183,2,64080335,64080515,180,audio/Bl122_64080335.jpg,Bl122
3723,15132.716989,15132.732989,1,453981509,453981989,480,audio/Ti81_453981509.jpg,Ti81
3724,406.654692,406.828692,1,12199640,12204860,5220,audio/Or61_12199640.jpg,Or61
3725,15051.992966,15052.165721,1,451559788,451564971,5183,audio/Ti81_451559788.jpg,Ti81
3726,1959.128779,1959.140779,2,58773863,58774223,360,audio/Bl122_58773863.jpg,Bl122
3727,15208.38558,15208.614516,1,456251567,456258435,6868,audio/Ti81_456251567.jpg,Ti81
3728,1963.651779,1963.656779,2,58909553,58909703,150,audio/Bl122_58909553.jpg,Bl122
3729,14940.318684,14940.5952,1,448209560,448217856,8296,audio/Ti81_448209560.jpg,Ti81
3730,532.626416,532.632416,2,15978792,15978972,180,audio/Or61_15978792.jpg,Or61
3731,701.297271,701.337271,1,21038918,21040118,1200,audio/Or61_21038918.jpg,Or61
3732,184.759971,184.787971,1,5542799,5543639,840,audio/Or61_5542799.jpg,Or61
3733,2212.118183,2212.128183,2,66363545,66363845,300,audio/Bl122_66363545.jpg,Bl122
3734,580.22971,580.29171,1,17406891,17408751,1860,audio/Or61_17406891.jpg,Or61
3735,2231.703183,2231.746183,1,66951095,66952385,1290,audio/Bl122_66951095.jpg,Bl122
3736,2049.967469,2049.990469,1,61499024,61499714,690,audio/Bl122_61499024.jpg,Bl122
3737,2008.347779,2008.356779,2,60250433,60250703,270,audio/Bl122_60250433.jpg,Bl122
3738,15163.163257,15163.406017,1,454894897,454902180,7283,audio/Ti81_454894897.jpg,Ti81
3739,2113.929183,2114.004183,1,63417875,63420125,2250,audio/Bl122_63417875.jpg,Bl122
3740,1779.665538,1779.831538,1,53389966,53394946,4980,audio/Bl122_53389966.jpg,Bl122
3741,1992.987779,1993.003779,2,59789633,59790113,480,audio/Bl122_59789633.jpg,Bl122
3742,1812.521013,1812.552013,1,54375630,54376560,930,audio/Bl122_54375630.jpg,Bl122
3743,2033.530469,2033.542469,2,61005914,61006274,360,audio/Bl122_61005914.jpg,Bl122
3744,441.534265,441.578265,1,13246027,13247347,1320,audio/Or61_13246027.jpg,Or61
3745,2050.134469,2050.157469,1,61504034,61504724,690,audio/Bl122_61504034.jpg,Bl122
3746,816.707882,816.785882,1,24501236,24503576,2340,audio/Or61_24501236.jpg,Or61
3747,787.276827,787.405827,1,23618304,23622174,3870,audio/Or61_23618304.jpg,Or61
3748,2216.343183,2216.401183,1,66490295,66492035,1740,audio/Bl122_66490295.jpg,Bl122
3749,482.193221,482.198221,2,14465796,14465946,150,audio/Or61_14465796.jpg,Or61
3750,15105.070256,15105.154256,1,453152107,453154627,2520,audio/Ti81_453152107.jpg,Ti81
3751,2207.663183,2207.691183,1,66229895,66230735,840,audio/Bl122_66229895.jpg,Bl122
3752,3422.117185,3422.287484,1,102663515,102668624,5109,audio/Ti81_102663515.jpg,Ti81
3753,1997.465779,1997.678779,1,59923973,59930363,6390,audio/Bl122_59923973.jpg,Bl122
3754,402.504692,402.747692,1,12075140,12082430,7290,audio/Or61_12075140.jpg,Or61
3755,725.102271,725.117271,1,21753068,21753518,450,audio/Or61_21753068.jpg,Or61
3756,509.370221,509.398221,1,15281106,15281946,840,audio/Or61_15281106.jpg,Or61
3757,15347.841971,15347.858971,1,460435259,460435769,510,audio/Ti81_460435259.jpg,Ti81
3758,395.836529,395.890529,1,11875095,11876715,1620,audio/Or61_11875095.jpg,Or61
3759,1961.548779,1961.555779,2,58846463,58846673,210,audio/Bl122_58846463.jpg,Bl122
3760,721.483271,721.773271,1,21644498,21653198,8700,audio/Or61_21644498.jpg,Or61
3761,545.346416,545.588416,1,16360392,16367652,7260,audio/Or61_16360392.jpg,Or61
3762,2185.650183,2185.663183,2,65569505,65569895,390,audio/Bl122_65569505.jpg,Bl122
3763,488.765221,488.769221,2,14662956,14663076,120,audio/Or61_14662956.jpg,Or61
3764,760.522271,760.567271,1,22815668,22817018,1350,audio/Or61_22815668.jpg,Or61
3765,15090.5729,15090.5959,1,452717187,452717877,690,audio/Ti81_452717187.jpg,Ti81
3766,6333.513902,6333.547902,1,190005417,190006437,1020,audio/Li145_190005417.jpg,Li145
3767,15123.989981,15124.047981,1,453719699,453721439,1740,audio/Ti81_453719699.jpg,Ti81
3768,8097.381141,8097.437141,1,242921434,242923114,1680,audio/Li145_242921434.jpg,Li145
3769,787.520827,787.526827,2,23625624,23625804,180,audio/Or61_23625624.jpg,Or61
3770,2159.477183,2159.491183,1,64784315,64784735,420,audio/Bl122_64784315.jpg,Bl122
3771,503.438221,503.459221,2,15103146,15103776,630,audio/Or61_15103146.jpg,Or61
3772,1815.415379,1815.420379,2,54462461,54462611,150,audio/Bl122_54462461.jpg,Bl122
3773,2176.108183,2176.124183,2,65283245,65283725,480,audio/Bl122_65283245.jpg,Bl122
3774,3466.523487,3466.549347,1,103995704,103996480,776,audio/Ti81_103995704.jpg,Ti81
3775,15265.214358,15265.488358,1,457956430,457964650,8220,audio/Ti81_457956430.jpg,Ti81
3776,2138.732183,2138.760183,1,64161965,64162805,840,audio/Bl122_64161965.jpg,Bl122
3777,406.231692,406.243692,2,12186950,12187310,360,audio/Or61_12186950.jpg,Or61
3778,507.035221,507.184221,1,15211056,15215526,4470,audio/Or61_15211056.jpg,Or61
3779,15031.00143,15031.237579,1,450930042,450937127,7085,audio/Ti81_450930042.jpg,Ti81
3780,2228.714183,2228.733183,2,66861425,66861995,570,audio/Bl122_66861425.jpg,Bl122
3781,472.028221,472.047221,2,14160846,14161416,570,audio/Or61_14160846.jpg,Or61
3782,384.429161,384.730161,1,11532874,11541904,9030,audio/Or61_11532874.jpg,Or61
3783,2187.825183,2187.829183,2,65634755,65634875,120,audio/Bl122_65634755.jpg,Bl122
3784,723.809271,723.833271,1,21714278,21714998,720,audio/Or61_21714278.jpg,Or61
3785,184.792971,184.822971,1,5543789,5544689,900,audio/Or61_5543789.jpg,Or61
3786,2077.204823,2077.209823,2,62316144,62316294,150,audio/Bl122_62316144.jpg,Bl122
3787,15077.212682,15077.246682,1,452316380,452317400,1020,audio/Ti81_452316380.jpg,Ti81
3788,1938.304779,1938.328779,2,58149143,58149863,720,audio/Bl122_58149143.jpg,Bl122
3789,719.651271,719.681271,1,21589538,21590438,900,audio/Or61_21589538.jpg,Or61
3790,2222.713183,2222.743183,1,66681395,66682295,900,audio/Bl122_66681395.jpg,Bl122
3791,15032.645389,15032.772419,1,450979361,450983172,3811,audio/Ti81_450979361.jpg,Ti81
3792,537.812416,537.850416,1,16134372,16135512,1140,audio/Or61_16134372.jpg,Or61
3793,2068.210469,2068.218469,2,62046314,62046554,240,audio/Bl122_62046314.jpg,Bl122
3794,790.491827,790.498827,2,23714754,23714964,210,audio/Or61_23714754.jpg,Or61
3795,9045.896911,9045.921911,1,271376907,271377657,750,audio/Li145_271376907.jpg,Li145
3796,711.399271,711.448271,1,21341978,21343448,1470,audio/Or61_21341978.jpg,Or61
3797,2154.304183,2154.349183,2,64629125,64630475,1350,audio/Bl122_64629125.jpg,Bl122
3798,1976.686779,1976.696779,2,59300603,59300903,300,audio/Bl122_59300603.jpg,Bl122
3799,489.108221,489.114221,2,14673246,14673426,180,audio/Or61_14673246.jpg,Or61
3800,2141.450183,2141.738183,1,64243505,64252145,8640,audio/Bl122_64243505.jpg,Bl122
3801,184.011971,184.202971,1,5520359,5526089,5730,audio/Or61_5520359.jpg,Or61
3802,2141.757183,2141.813183,2,64252715,64254395,1680,audio/Bl122_64252715.jpg,Bl122
3803,2229.263183,2229.279183,2,66877895,66878375,480,audio/Bl122_66877895.jpg,Bl122
3804,3.630816,3.650816,2,108924,109524,600,audio/Or61_108924.jpg,Or61
3805,5885.138674,5885.152674,1,176554160,176554580,420,audio/Li145_176554160.jpg,Li145
3806,771.813271,771.822271,2,23154398,23154668,270,audio/Or61_23154398.jpg,Or61
3807,579.51471,579.52071,2,17385441,17385621,180,audio/Or61_17385441.jpg,Or61
3808,2132.886183,2132.898183,2,63986585,63986945,360,audio/Bl122_63986585.jpg,Bl122
3809,532.108416,532.299416,1,15963252,15968982,5730,audio/Or61_15963252.jpg,Or61
3810,1786.03843,1786.08343,1,53581152,53582502,1350,audio/Bl122_53581152.jpg,Bl122
3811,15329.434625,15329.508625,1,459883038,459885258,2220,audio/Ti81_459883038.jpg,Ti81
3812,1771.338657,1771.341657,2,53140159,53140249,90,audio/Bl122_53140159.jpg,Bl122
3813,518.647221,518.696221,1,15559416,15560886,1470,audio/Or61_15559416.jpg,Or61
3814,2103.277961,2103.423961,1,63098338,63102718,4380,audio/Bl122_63098338.jpg,Bl122
3815,2189.323183,2189.420183,1,65679695,65682605,2910,audio/Bl122_65679695.jpg,Bl122
3816,6332.648902,6332.661902,1,189979467,189979857,390,audio/Li145_189979467.jpg,Li145
3817,8864.551987,8864.568987,1,265936559,265937069,510,audio/Li145_265936559.jpg,Li145
3818,789.990827,789.999827,2,23699724,23699994,270,audio/Or61_23699724.jpg,Or61
3819,2175.029183,2175.036183,2,65250875,65251085,210,audio/Bl122_65250875.jpg,Bl122
3820,14942.675157,14942.680108,1,448280254,448280403,149,audio/Ti81_448280254.jpg,Ti81
3821,15122.189727,15122.248981,1,453665691,453667469,1778,audio/Ti81_453665691.jpg,Ti81
3822,2196.174183,2196.218183,1,65885225,65886545,1320,audio/Bl122_65885225.jpg,Bl122
3823,196.946012,196.954012,2,5908380,5908620,240,audio/Or61_5908380.jpg,Or61
3824,1948.532779,1948.552779,1,58455983,58456583,600,audio/Bl122_58455983.jpg,Bl122
3825,2124.255183,2124.265183,2,63727655,63727955,300,audio/Bl122_63727655.jpg,Bl122
3826,563.096416,563.112416,2,16892892,16893372,480,audio/Or61_16892892.jpg,Or61
3827,2165.423183,2165.431183,2,64962695,64962935,240,audio/Bl122_64962695.jpg,Bl122
3828,506.791221,506.851221,1,15203736,15205536,1800,audio/Or61_15203736.jpg,Or61
3829,608.623417,608.642417,1,18258702,18259272,570,audio/Or61_18258702.jpg,Or61
3830,762.675271,762.696271,2,22880258,22880888,630,audio/Or61_22880258.jpg,Or61
3831,726.263271,726.289271,1,21787898,21788678,780,audio/Or61_21787898.jpg,Or61
3832,2013.985959,2014.004959,2,60419578,60420148,570,audio/Bl122_60419578.jpg,Bl122
3833,441.638265,441.649265,2,13249147,13249477,330,audio/Or61_13249147.jpg,Or61
3834,473.483221,473.542221,1,14204496,14206266,1770,audio/Or61_14204496.jpg,Or61
3835,2197.720183,2197.726183,2,65931605,65931785,180,audio/Bl122_65931605.jpg,Bl122
3836,761.841271,761.878271,1,22855238,22856348,1110,audio/Or61_22855238.jpg,Or61
3837,3420.622459,3420.745453,1,102618673,102622363,3690,audio/Ti81_102618673.jpg,Ti81
3838,1956.817779,1956.820779,2,58704533,58704623,90,audio/Bl122_58704533.jpg,Bl122
3839,14942.362405,14942.557654,1,448270872,448276729,5857,audio/Ti81_448270872.jpg,Ti81
3840,2040.045815,2040.053815,1,61201374,61201614,240,audio/Li145_61201374.jpg,Li145
3841,419.529581,419.709581,1,12585887,12591287,5400,audio/Or61_12585887.jpg,Or61
3842,478.775221,478.786221,1,14363256,14363586,330,audio/Or61_14363256.jpg,Or61
3843,413.804165,413.893165,1,12414124,12416794,2670,audio/Or61_12414124.jpg,Or61
3844,397.818529,397.823529,2,11934555,11934705,150,audio/Or61_11934555.jpg,Or61
3845,15069.320682,15069.385682,1,452079620,452081570,1950,audio/Ti81_452079620.jpg,Ti81
3846,495.736221,495.738221,2,14872086,14872146,60,audio/Or61_14872086.jpg,Or61
3847,2049.255469,2049.300469,2,61477664,61479014,1350,audio/Bl122_61477664.jpg,Bl122
3848,2140.624183,2140.630183,2,64218725,64218905,180,audio/Bl122_64218725.jpg,Bl122
3849,2122.679183,2122.689183,2,63680375,63680675,300,audio/Bl122_63680375.jpg,Bl122
3850,15133.138989,15133.168989,1,453994169,453995069,900,audio/Ti81_453994169.jpg,Ti81
3851,1976.623779,1976.665779,2,59298713,59299973,1260,audio/Bl122_59298713.jpg,Bl122
3852,2153.290183,2153.326183,2,64598705,64599785,1080,audio/Bl122_64598705.jpg,Bl122
3853,2122.833183,2123.011183,1,63684995,63690335,5340,audio/Bl122_63684995.jpg,Bl122
3854,2213.957183,2213.962183,2,66418715,66418865,150,audio/Bl122_66418715.jpg,Bl122
3855,2150.454183,2150.504183,1,64513625,64515125,1500,audio/Bl122_64513625.jpg,Bl122
3856,15033.858048,15033.929321,1,451015741,451017879,2138,audio/Ti81_451015741.jpg,Ti81
3857,1938.694779,1938.709779,2,58160843,58161293,450,audio/Bl122_58160843.jpg,Bl122
3858,2003.703779,2003.725779,1,60111113,60111773,660,audio/Bl122_60111113.jpg,Bl122
3859,15155.556257,15155.678257,1,454666687,454670347,3660,audio/Ti81_454666687.jpg,Ti81
3860,2212.146183,2212.164183,2,66364385,66364925,540,audio/Bl122_66364385.jpg,Bl122
3861,557.737416,557.804416,1,16732122,16734132,2010,audio/Or61_16732122.jpg,Or61
3862,2218.129183,2218.183183,2,66543875,66545495,1620,audio/Bl122_66543875.jpg,Bl122
3863,7550.361715,7550.542715,1,226510851,226516281,5430,audio/Li145_226510851.jpg,Li145
3864,538.827416,538.835416,1,16164822,16165062,240,audio/Or61_16164822.jpg,Or61
3865,531.788416,531.795416,2,15953652,15953862,210,audio/Or61_15953652.jpg,Or61
3866,2171.798183,2171.800183,2,65153945,65154005,60,audio/Bl122_65153945.jpg,Bl122
3867,15309.354373,15309.441373,1,459280631,459283241,2610,audio/Ti81_459280631.jpg,Ti81
3868,2107.753377,2107.770377,2,63232601,63233111,510,audio/Bl122_63232601.jpg,Bl122
3869,1954.353779,1954.379779,1,58630613,58631393,780,audio/Bl122_58630613.jpg,Bl122
3870,2150.307183,2150.400183,2,64509215,64512005,2790,audio/Bl122_64509215.jpg,Bl122
3871,15239.528874,15239.572115,1,457185866,457187163,1297,audio/Ti81_457185866.jpg,Ti81
3872,14889.367076,14889.433303,1,446681012,446682999,1987,audio/Ti81_446681012.jpg,Ti81
3873,15048.240966,15048.277966,1,451447228,451448338,1110,audio/Ti81_451447228.jpg,Ti81
3874,2081.074287,2081.099287,1,62432228,62432978,750,audio/Bl122_62432228.jpg,Bl122
3875,1976.218779,1976.254779,2,59286563,59287643,1080,audio/Bl122_59286563.jpg,Bl122
3876,706.643271,706.700271,1,21199298,21201008,1710,audio/Or61_21199298.jpg,Or61
3877,510.747221,510.776221,1,15322416,15323286,870,audio/Or61_15322416.jpg,Or61
3878,2154.877183,2154.903183,1,64646315,64647095,780,audio/Bl122_64646315.jpg,Bl122
3879,2154.797183,2154.805183,2,64643915,64644155,240,audio/Bl122_64643915.jpg,Bl122
3880,15032.343138,15032.430169,1,450970294,450972905,2611,audio/Ti81_450970294.jpg,Ti81
3881,7553.754715,7553.796715,1,226612641,226613901,1260,audio/Li145_226612641.jpg,Li145
3882,619.615417,619.643417,2,18588462,18589302,840,audio/Or61_18588462.jpg,Or61
3883,630.226417,630.288417,1,18906792,18908652,1860,audio/Or61_18906792.jpg,Or61
3884,2228.127183,2228.179183,1,66843815,66845375,1560,audio/Bl122_66843815.jpg,Bl122
3885,763.921271,764.289271,1,22917638,22928678,11040,audio/Or61_22917638.jpg,Or61
3886,5568.029059,5568.317059,1,167040871,167049511,8640,audio/Li145_167040871.jpg,Li145
3887,403.552692,403.554692,2,12106580,12106640,60,audio/Or61_12106580.jpg,Or61
3888,1998.897779,1998.946779,2,59966933,59968403,1470,audio/Bl122_59966933.jpg,Bl122
3889,2058.982469,2058.994469,2,61769474,61769834,360,audio/Bl122_61769474.jpg,Bl122
3890,745.319271,745.549271,1,22359578,22366478,6900,audio/Or61_22359578.jpg,Or61
3891,15247.601074,15247.675074,1,457428032,457430252,2220,audio/Ti81_457428032.jpg,Ti81
3892,15128.277981,15128.325981,1,453848339,453849779,1440,audio/Ti81_453848339.jpg,Ti81
3893,766.249271,766.272271,1,22987478,22988168,690,audio/Or61_22987478.jpg,Or61
3894,411.518165,411.594165,1,12345544,12347824,2280,audio/Or61_12345544.jpg,Or61
3895,601.447417,601.637417,1,18043422,18049122,5700,audio/Or61_18043422.jpg,Or61
3896,798.064827,798.068827,2,23941944,23942064,120,audio/Or61_23941944.jpg,Or61
3897,6303.424561,6303.536561,1,189102736,189106096,3360,audio/Li145_189102736.jpg,Li145
3898,15164.586257,15164.655257,1,454937587,454939657,2070,audio/Ti81_454937587.jpg,Ti81
3899,576.94171,577.13871,1,17308251,17314161,5910,audio/Or61_17308251.jpg,Or61
3900,15057.748569,15057.806966,1,451732457,451734208,1751,audio/Ti81_451732457.jpg,Ti81
3901,15298.521664,15298.549664,1,458955649,458956489,840,audio/Ti81_458955649.jpg,Ti81
3902,2234.245183,2234.434183,1,67027355,67033025,5670,audio/Bl122_67027355.jpg,Bl122
3903,15155.301257,15155.381257,1,454659037,454661437,2400,audio/Ti81_454659037.jpg,Ti81
3904,2163.498183,2163.523183,2,64904945,64905695,750,audio/Bl122_64904945.jpg,Bl122
3905,15053.556966,15053.580966,1,451606708,451607428,720,audio/Ti81_451606708.jpg,Ti81
3906,471.379221,471.389221,2,14141376,14141676,300,audio/Or61_14141376.jpg,Or61
3907,15057.703966,15057.729966,1,451731118,451731898,780,audio/Ti81_451731118.jpg,Ti81
3908,720.412271,720.550271,1,21612368,21616508,4140,audio/Or61_21612368.jpg,Or61
3909,15059.647966,15059.833966,1,451789438,451795018,5580,audio/Ti81_451789438.jpg,Ti81
3910,15304.789373,15304.838373,1,459143681,459145151,1470,audio/Ti81_459143681.jpg,Ti81
3911,7563.787654,7563.794654,1,226913629,226913839,210,audio/Li145_226913629.jpg,Li145
3912,396.971529,396.985529,2,11909145,11909565,420,audio/Or61_11909145.jpg,Or61
3913,747.368271,747.384271,1,22421048,22421528,480,audio/Or61_22421048.jpg,Or61
3914,942.089059,942.26062,1,28262671,28267818,5147,audio/Ti81_28262671.jpg,Ti81
3915,15343.385971,15343.409971,1,460301579,460302299,720,audio/Ti81_460301579.jpg,Ti81
3916,413.681165,413.801165,1,12410434,12414034,3600,audio/Or61_12410434.jpg,Or61
3917,508.501221,508.575221,1,15255036,15257256,2220,audio/Or61_15255036.jpg,Or61
3918,15298.490664,15298.512664,1,458954719,458955379,660,audio/Ti81_458954719.jpg,Ti81
3919,15347.761971,15347.784971,1,460432859,460433549,690,audio/Ti81_460432859.jpg,Ti81
3920,15243.645874,15243.830874,1,457309376,457314926,5550,audio/Ti81_457309376.jpg,Ti81
3921,6332.482902,6332.504902,2,189974487,189975147,660,audio/Li145_189974487.jpg,Li145
3922,2126.209183,2126.219183,2,63786275,63786575,300,audio/Bl122_63786275.jpg,Bl122
3923,2089.991961,2090.017961,1,62699758,62700538,780,audio/Bl122_62699758.jpg,Bl122
3924,387.914161,388.051161,1,11637424,11641534,4110,audio/Or61_11637424.jpg,Or61
3925,2228.556183,2228.561183,2,66856685,66856835,150,audio/Bl122_66856685.jpg,Bl122
3926,9609.728826,9609.896602,1,288291864,288296898,5034,audio/Ti81_288291864.jpg,Ti81
3927,2166.038183,2166.047183,2,64981145,64981415,270,audio/Bl122_64981145.jpg,Bl122
3928,705.857271,705.865271,1,21175718,21175958,240,audio/Or61_21175718.jpg,Or61
3929,453.607219,453.679219,1,13608216,13610376,2160,audio/Or61_13608216.jpg,Or61
3930,2064.359469,2064.380469,1,61930784,61931414,630,audio/Bl122_61930784.jpg,Bl122
3931,2083.638961,2083.649961,2,62509168,62509498,330,audio/Bl122_62509168.jpg,Bl122
3932,5697.204353,5697.226353,1,170916130,170916790,660,audio/Li145_170916130.jpg,Li145
3933,771.131271,771.140271,2,23133938,23134208,270,audio/Or61_23133938.jpg,Or61
3934,729.058271,729.085271,1,21871748,21872558,810,audio/Or61_21871748.jpg,Or61
3935,2172.021183,2172.032183,2,65160635,65160965,330,audio/Bl122_65160635.jpg,Bl122
3936,3.569816,3.571816,2,107094,107154,60,audio/Or61_107094.jpg,Or61
3937,606.548417,606.636417,1,18196452,18199092,2640,audio/Or61_18196452.jpg,Or61
3938,4.26615,4.27215,2,127984,128164,180,audio/Or61_127984.jpg,Or61
3939,1948.146779,1948.152779,2,58444403,58444583,180,audio/Bl122_58444403.jpg,Bl122
3940,3540.05997,3540.375339,1,106201799,106211260,9461,audio/Ti81_106201799.jpg,Ti81
3941,4225.530876,4225.692876,1,126765926,126770786,4860,audio/Li145_126765926.jpg,Li145
3942,2198.721183,2198.728183,2,65961635,65961845,210,audio/Bl122_65961635.jpg,Bl122
3943,1989.055779,1989.058779,2,59671673,59671763,90,audio/Bl122_59671673.jpg,Bl122
3944,500.929221,501.021221,2,15027876,15030636,2760,audio/Or61_15027876.jpg,Or61
3945,2040.504815,2040.512815,2,61215144,61215384,240,audio/Li145_61215144.jpg,Li145
3946,2163.856183,2164.048183,1,64915685,64921445,5760,audio/Bl122_64915685.jpg,Bl122
3947,475.451221,475.520221,2,14263536,14265606,2070,audio/Or61_14263536.jpg,Or61
3948,532.448416,532.452416,2,15973452,15973572,120,audio/Or61_15973452.jpg,Or61
3949,2149.718183,2149.914183,1,64491545,64497425,5880,audio/Bl122_64491545.jpg,Bl122
3950,2039.048815,2039.061815,1,61171464,61171854,390,audio/Li145_61171464.jpg,Li145
3951,15149.711716,15149.880716,1,454491351,454496421,5070,audio/Ti81_454491351.jpg,Ti81
3952,2167.357183,2167.373183,2,65020715,65021195,480,audio/Bl122_65020715.jpg,Bl122
3953,2049.448469,2049.483469,2,61483454,61484504,1050,audio/Bl122_61483454.jpg,Bl122
3954,2214.233183,2214.236183,2,66426995,66427085,90,audio/Bl122_66426995.jpg,Bl122
3955,827.324616,827.522616,1,24819738,24825678,5940,audio/Bl122_24819738.jpg,Bl122
3956,15067.038314,15067.149682,1,452011149,452014490,3341,audio/Ti81_452011149.jpg,Ti81
3957,2157.237183,2157.267183,2,64717115,64718015,900,audio/Bl122_64717115.jpg,Bl122
3958,2224.675183,2224.705183,2,66740255,66741155,900,audio/Bl122_66740255.jpg,Bl122
3959,5842.573404,5842.610404,1,175277202,175278312,1110,audio/Li145_175277202.jpg,Li145
3960,1998.826779,1998.832779,2,59964803,59964983,180,audio/Bl122_59964803.jpg,Bl122
3961,798.672827,798.881827,1,23960184,23966454,6270,audio/Or61_23960184.jpg,Or61
3962,2059.479469,2059.511469,2,61784384,61785344,960,audio/Bl122_61784384.jpg,Bl122
3963,14937.703766,14937.848205,1,448131112,448135446,4334,audio/Ti81_448131112.jpg,Ti81
3964,795.748827,795.829827,1,23872464,23874894,2430,audio/Or61_23872464.jpg,Or61
3965,15021.294986,15021.311764,1,450638849,450639352,503,audio/Ti81_450638849.jpg,Ti81
3966,8092.122536,8092.138536,1,242763676,242764156,480,audio/Li145_242763676.jpg,Li145
3967,2221.882183,2222.003183,1,66656465,66660095,3630,audio/Bl122_66656465.jpg,Bl122
3968,1486.423018,1486.432018,1,44592690,44592960,270,audio/Li145_44592690.jpg,Li145
3969,1944.398779,1944.403779,2,58331963,58332113,150,audio/Bl122_58331963.jpg,Bl122
3970,1986.825779,1986.908779,1,59604773,59607263,2490,audio/Bl122_59604773.jpg,Bl122
3971,2176.249183,2176.258183,2,65287475,65287745,270,audio/Bl122_65287475.jpg,Bl122
3972,2098.586961,2098.624961,1,62957608,62958748,1140,audio/Bl122_62957608.jpg,Bl122
3973,803.184882,803.361882,1,24095546,24100856,5310,audio/Or61_24095546.jpg,Or61
3974,604.411417,604.544417,1,18132342,18136332,3990,audio/Or61_18132342.jpg,Or61
3975,489.339221,489.506221,1,14680176,14685186,5010,audio/Or61_14680176.jpg,Or61
3976,2000.366779,2000.436779,1,60011003,60013103,2100,audio/Bl122_60011003.jpg,Bl122
3977,509.028221,509.070221,1,15270846,15272106,1260,audio/Or61_15270846.jpg,Or61
3978,730.502271,730.547271,1,21915068,21916418,1350,audio/Or61_21915068.jpg,Or61
3979,672.442078,672.525078,1,20173262,20175752,2490,audio/Or61_20173262.jpg,Or61
3980,2165.037183,2165.039183,2,64951115,64951175,60,audio/Bl122_64951115.jpg,Bl122
3981,15250.661074,15250.886074,1,457519832,457526582,6750,audio/Ti81_457519832.jpg,Ti81
3982,1997.307779,1997.325779,1,59919233,59919773,540,audio/Bl122_59919233.jpg,Bl122
3983,2226.467183,2226.470183,2,66794015,66794105,90,audio/Bl122_66794015.jpg,Bl122
3984,475.013221,475.141221,1,14250396,14254236,3840,audio/Or61_14250396.jpg,Or61
3985,15093.221823,15093.258823,1,452796654,452797764,1110,audio/Ti81_452796654.jpg,Ti81
3986,15125.407981,15125.441981,1,453762239,453763259,1020,audio/Ti81_453762239.jpg,Ti81
3987,730.312271,730.384271,1,21909368,21911528,2160,audio/Or61_21909368.jpg,Or61
3988,618.924417,618.948417,1,18567732,18568452,720,audio/Or61_18567732.jpg,Or61
3989,1790.782115,1790.866115,1,53723463,53725983,2520,audio/Bl122_53723463.jpg,Bl122
3990,1956.721779,1956.726779,2,58701653,58701803,150,audio/Bl122_58701653.jpg,Bl122
3991,1958.557779,1958.565779,2,58756733,58756973,240,audio/Bl122_58756733.jpg,Bl122
3992,812.069882,812.214882,1,24362096,24366446,4350,audio/Or61_24362096.jpg,Or61
3993,2226.712183,2226.716183,2,66801365,66801485,120,audio/Bl122_66801365.jpg,Bl122
3994,2215.677183,2215.739183,1,66470315,66472175,1860,audio/Bl122_66470315.jpg,Bl122
3995,2054.543469,2054.572469,2,61636304,61637174,870,audio/Bl122_61636304.jpg,Bl122
3996,5873.015637,5873.051637,1,176190469,176191549,1080,audio/Li145_176190469.jpg,Li145
3997,2186.521183,2186.527183,2,65595635,65595815,180,audio/Bl122_65595635.jpg,Bl122
3998,946.662548,946.826414,1,28399876,28404792,4916,audio/Ti81_28399876.jpg,Ti81
3999,4577.738799,4578.044834,1,137332163,137341345,9182,audio/Ti81_137332163.jpg,Ti81
4000,593.546457,593.549457,2,17806393,17806483,90,audio/Or61_17806393.jpg,Or61
4001,1934.099613,1934.318613,1,58022988,58029558,6570,audio/Bl122_58022988.jpg,Bl122
4002,2140.845183,2140.854183,2,64225355,64225625,270,audio/Bl122_64225355.jpg,Bl122
4003,556.715416,556.740416,1,16701462,16702212,750,audio/Or61_16701462.jpg,Or61
4004,710.137271,710.139271,2,21304118,21304178,60,audio/Or61_21304118.jpg,Or61
4005,2177.374183,2177.508183,1,65321225,65325245,4020,audio/Bl122_65321225.jpg,Bl122
4006,2227.523183,2227.569183,2,66825695,66827075,1380,audio/Bl122_66825695.jpg,Bl122
4007,6954.306285,6954.321285,1,208629188,208629638,450,audio/Li145_208629188.jpg,Li145
4008,1985.915779,1986.250779,1,59577473,59587523,10050,audio/Bl122_59577473.jpg,Bl122
4009,1947.494779,1947.527779,1,58424843,58425833,990,audio/Bl122_58424843.jpg,Bl122
4010,2158.062183,2158.091183,2,64741865,64742735,870,audio/Bl122_64741865.jpg,Bl122
4011,2171.381183,2171.387183,2,65141435,65141615,180,audio/Bl122_65141435.jpg,Bl122
4012,1965.440779,1965.461779,2,58963223,58963853,630,audio/Bl122_58963223.jpg,Bl122
4013,2059.463469,2059.474469,2,61783904,61784234,330,audio/Bl122_61783904.jpg,Bl122
4014,2126.688183,2126.694183,2,63800645,63800825,180,audio/Bl122_63800645.jpg,Bl122
4015,15075.937682,15076.086705,1,452278130,452282601,4471,audio/Ti81_452278130.jpg,Ti81
4016,8739.402692,8739.415692,1,262182080,262182470,390,audio/Li145_262182080.jpg,Li145
4017,2189.730183,2189.863183,1,65691905,65695895,3990,audio/Bl122_65691905.jpg,Bl122
4018,2168.445183,2168.533183,1,65053355,65055995,2640,audio/Bl122_65053355.jpg,Bl122
4019,575.83071,575.98371,1,17274921,17279511,4590,audio/Or61_17274921.jpg,Or61
4020,1750.012622,1750.052622,1,52500378,52501578,1200,audio/Bl122_52500378.jpg,Bl122
4021,1960.353779,1960.368779,2,58810613,58811063,450,audio/Bl122_58810613.jpg,Bl122
4022,787.266827,787.269827,2,23618004,23618094,90,audio/Or61_23618004.jpg,Or61
4023,14947.229314,14947.243489,1,448416879,448417304,425,audio/Ti81_448416879.jpg,Ti81
4024,811.774882,811.778882,2,24353246,24353366,120,audio/Or61_24353246.jpg,Or61
4025,3419.426956,3419.455087,1,102582808,102583652,844,audio/Ti81_102582808.jpg,Ti81
4026,2052.098469,2052.271469,1,61562954,61568144,5190,audio/Bl122_61562954.jpg,Bl122
4027,2082.035961,2082.041961,2,62461078,62461258,180,audio/Bl122_62461078.jpg,Bl122
4028,2188.749183,2188.764183,2,65662475,65662925,450,audio/Bl122_65662475.jpg,Bl122
4029,7563.072654,7563.203654,1,226892179,226896109,3930,audio/Li145_226892179.jpg,Li145
4030,2141.937183,2141.959183,2,64258115,64258775,660,audio/Bl122_64258115.jpg,Bl122
4031,15281.067439,15281.105439,1,458432023,458433163,1140,audio/Ti81_458432023.jpg,Ti81
4032,2082.732961,2082.740961,2,62481988,62482228,240,audio/Bl122_62481988.jpg,Bl122
4033,7547.299781,7547.434781,1,226418993,226423043,4050,audio/Li145_226418993.jpg,Li145
4034,5872.971637,5872.976637,1,176189149,176189299,150,audio/Li145_176189149.jpg,Li145
4035,8091.995536,8092.016536,1,242759866,242760496,630,audio/Li145_242759866.jpg,Li145
4036,2122.092183,2122.100183,2,63662765,63663005,240,audio/Bl122_63662765.jpg,Bl122
4037,748.202271,748.212271,2,22446068,22446368,300,audio/Or61_22446068.jpg,Or61
4038,810.079882,810.147882,1,24302396,24304436,2040,audio/Or61_24302396.jpg,Or61
4039,404.049692,404.098692,1,12121490,12122960,1470,audio/Or61_12121490.jpg,Or61
4040,487.506221,487.580221,1,14625186,14627406,2220,audio/Or61_14625186.jpg,Or61
4041,7546.488781,7546.527781,1,226394663,226395833,1170,audio/Li145_226394663.jpg,Li145
4042,565.883416,565.906416,2,16976502,16977192,690,audio/Or61_16976502.jpg,Or61
4043,2222.746183,2222.771183,2,66682385,66683135,750,audio/Bl122_66682385.jpg,Bl122
4044,1783.389323,1783.398323,1,53501679,53501949,270,audio/Bl122_53501679.jpg,Bl122
4045,626.265417,626.308417,2,18787962,18789252,1290,audio/Or61_18787962.jpg,Or61
4046,8741.021692,8741.025692,2,262230650,262230770,120,audio/Li145_262230650.jpg,Li145
4047,2146.142183,2146.155183,2,64384265,64384655,390,audio/Bl122_64384265.jpg,Bl122
4048,2198.237183,2198.296183,2,65947115,65948885,1770,audio/Bl122_65947115.jpg,Bl122
4049,498.927221,498.930221,2,14967816,14967906,90,audio/Or61_14967816.jpg,Or61
4050,2048.562469,2048.568469,2,61456874,61457054,180,audio/Bl122_61456874.jpg,Bl122
4051,1967.123779,1967.130779,2,59013713,59013923,210,audio/Bl122_59013713.jpg,Bl122
4052,2159.733183,2159.744183,1,64791995,64792325,330,audio/Bl122_64791995.jpg,Bl122
4053,1789.062115,1789.075115,1,53671863,53672253,390,audio/Bl122_53671863.jpg,Bl122
4054,1951.661779,1951.692779,2,58549853,58550783,930,audio/Bl122_58549853.jpg,Bl122
4055,708.059271,708.256271,1,21241778,21247688,5910,audio/Or61_21241778.jpg,Or61
4056,1977.617779,1977.627779,2,59328533,59328833,300,audio/Bl122_59328533.jpg,Bl122
4057,756.739271,756.820271,1,22702178,22704608,2430,audio/Or61_22702178.jpg,Or61
4058,15105.706256,15105.914256,1,453171187,453177427,6240,audio/Ti81_453171187.jpg,Ti81
4059,745.552271,745.682271,1,22366568,22370468,3900,audio/Or61_22366568.jpg,Or61
4060,699.808271,700.095271,1,20994248,21002858,8610,audio/Or61_20994248.jpg,Or61
4061,290.089864,290.137864,1,8702695,8704135,1440,audio/Or61_8702695.jpg,Or61
4062,15344.203971,15344.219971,1,460326119,460326599,480,audio/Ti81_460326119.jpg,Ti81
4063,9168.536583,9168.538583,2,275056097,275056157,60,audio/Li145_275056097.jpg,Li145
4064,1960.904779,1960.938779,1,58827143,58828163,1020,audio/Bl122_58827143.jpg,Bl122
4065,2221.321183,2221.372183,2,66639635,66641165,1530,audio/Bl122_66639635.jpg,Bl122
4066,1940.975779,1941.150779,1,58229273,58234523,5250,audio/Bl122_58229273.jpg,Bl122
4067,2199.013183,2199.016183,2,65970395,65970485,90,audio/Bl122_65970395.jpg,Bl122
4068,15240.573874,15240.637874,1,457217216,457219136,1920,audio/Ti81_457217216.jpg,Ti81
4069,712.669271,712.690271,1,21380078,21380708,630,audio/Or61_21380078.jpg,Or61
4070,8083.340803,8083.342803,2,242500224,242500284,60,audio/Li145_242500224.jpg,Li145
4071,2094.907961,2094.911961,2,62847238,62847358,120,audio/Bl122_62847238.jpg,Bl122
4072,722.728271,722.733271,2,21681848,21681998,150,audio/Or61_21681848.jpg,Or61
4073,15271.938439,15272.004439,1,458158153,458160133,1980,audio/Ti81_458158153.jpg,Ti81
4074,14941.164505,14941.18595,1,448234935,448235578,643,audio/Ti81_448234935.jpg,Ti81
4075,397.837529,397.839529,2,11935125,11935185,60,audio/Or61_11935125.jpg,Or61
4076,498.846221,498.872221,2,14965386,14966166,780,audio/Or61_14965386.jpg,Or61
4077,2130.980183,2131.017183,2,63929405,63930515,1110,audio/Bl122_63929405.jpg,Bl122
4078,8097.782141,8097.790141,1,242933464,242933704,240,audio/Li145_242933464.jpg,Li145
4079,499.308221,499.364221,2,14979246,14980926,1680,audio/Or61_14979246.jpg,Or61
4080,15328.595625,15328.622625,1,459857868,459858678,810,audio/Ti81_459857868.jpg,Ti81
4081,3543.615951,3543.748028,1,106308478,106312440,3962,audio/Ti81_106308478.jpg,Ti81
4082,2131.066183,2131.071183,2,63931985,63932135,150,audio/Bl122_63931985.jpg,Bl122
4083,9617.862585,9618.037615,1,288535877,288541128,5251,audio/Ti81_288535877.jpg,Ti81
4084,15222.892341,15223.090049,2,456686770,456692701,5931,audio/Ti81_456686770.jpg,Ti81
4085,753.925271,753.937271,1,22617758,22618118,360,audio/Or61_22617758.jpg,Or61
4086,2059.339469,2059.345469,2,61780184,61780364,180,audio/Bl122_61780184.jpg,Bl122
4087,601.003417,601.042417,1,18030102,18031272,1170,audio/Or61_18030102.jpg,Or61
4088,15106.232256,15106.291256,1,453186967,453188737,1770,audio/Ti81_453186967.jpg,Ti81
4089,2229.220183,2229.225183,2,66876605,66876755,150,audio/Bl122_66876605.jpg,Bl122
4090,15231.211443,15231.266443,1,456936343,456937993,1650,audio/Ti81_456936343.jpg,Ti81
4091,1938.675779,1938.691779,2,58160273,58160753,480,audio/Bl122_58160273.jpg,Bl122
4092,386.714161,386.724161,1,11601424,11601724,300,audio/Or61_11601424.jpg,Or61
4093,2053.539469,2053.734469,1,61606184,61612034,5850,audio/Bl122_61606184.jpg,Bl122
4094,706.369271,706.372271,2,21191078,21191168,90,audio/Or61_21191078.jpg,Or61
4095,2166.011183,2166.015183,2,64980335,64980455,120,audio/Bl122_64980335.jpg,Bl122
4096,15057.186966,15057.223966,1,451715608,451716718,1110,audio/Ti81_451715608.jpg,Ti81
4097,2222.243183,2222.267183,2,66667295,66668015,720,audio/Bl122_66667295.jpg,Bl122
4098,673.304078,673.467078,1,20199122,20204012,4890,audio/Or61_20199122.jpg,Or61
4099,546.407416,546.424416,1,16392222,16392732,510,audio/Or61_16392222.jpg,Or61
4100,2085.187961,2085.311961,1,62555638,62559358,3720,audio/Bl122_62555638.jpg,Bl122
4101,556.034416,556.323416,1,16681032,16689702,8670,audio/Or61_16681032.jpg,Or61
4102,15034.232202,15034.305115,1,451026966,451029153,2187,audio/Ti81_451026966.jpg,Ti81
4103,2089.825961,2089.834961,2,62694778,62695048,270,audio/Bl122_62694778.jpg,Bl122
4104,2006.243779,2006.256779,2,60187313,60187703,390,audio/Bl122_60187313.jpg,Bl122
4105,2104.115961,2104.304961,1,63123478,63129148,5670,audio/Bl122_63123478.jpg,Bl122
4106,2177.138183,2177.144183,2,65314145,65314325,180,audio/Bl122_65314145.jpg,Bl122
4107,15343.685971,15343.801971,1,460310579,460314059,3480,audio/Ti81_460310579.jpg,Ti81
4108,2123.913183,2123.924183,2,63717395,63717725,330,audio/Bl122_63717395.jpg,Bl122
4109,2122.825183,2122.827183,2,63684755,63684815,60,audio/Bl122_63684755.jpg,Bl122
4110,8738.811692,8738.947692,1,262164350,262168430,4080,audio/Li145_262164350.jpg,Li145
4111,2223.385183,2223.392183,2,66701555,66701765,210,audio/Bl122_66701555.jpg,Bl122
4112,2129.435183,2129.442183,2,63883055,63883265,210,audio/Bl122_63883055.jpg,Bl122
4113,1940.922779,1940.972779,2,58227683,58229183,1500,audio/Bl122_58227683.jpg,Bl122
4114,2187.840183,2187.875183,1,65635205,65636255,1050,audio/Bl122_65635205.jpg,Bl122
4115,489.018221,489.061221,2,14670546,14671836,1290,audio/Or61_14670546.jpg,Or61
4116,180.204971,180.217971,1,5406149,5406539,390,audio/Or61_5406149.jpg,Or61
4117,626.057417,626.069417,1,18781722,18782082,360,audio/Or61_18781722.jpg,Or61
4118,15272.082439,15272.152439,1,458162473,458164573,2100,audio/Ti81_458162473.jpg,Ti81
4119,2057.274469,2057.301469,1,61718234,61719044,810,audio/Bl122_61718234.jpg,Bl122
4120,15221.291443,15221.339443,1,456638743,456640183,1440,audio/Ti81_456638743.jpg,Ti81
4121,2046.629469,2046.719469,1,61398884,61401584,2700,audio/Bl122_61398884.jpg,Bl122
4122,1990.415779,1990.469779,1,59712473,59714093,1620,audio/Bl122_59712473.jpg,Bl122
4123,2170.318183,2170.327183,2,65109545,65109815,270,audio/Bl122_65109545.jpg,Bl122
4124,528.888416,528.898416,2,15866652,15866952,300,audio/Or61_15866652.jpg,Or61
4125,2194.042183,2194.084183,2,65821265,65822525,1260,audio/Bl122_65821265.jpg,Bl122
4126,735.245271,735.275271,1,22057358,22058258,900,audio/Or61_22057358.jpg,Or61
4127,2068.554469,2068.569469,2,62056634,62057084,450,audio/Bl122_62056634.jpg,Bl122
4128,5711.200036,5711.280036,1,171336001,171338401,2400,audio/Li145_171336001.jpg,Li145
4129,540.791416,540.820416,1,16223742,16224612,870,audio/Or61_16223742.jpg,Or61
4130,5967.915227,5967.924227,1,179037456,179037726,270,audio/Li145_179037456.jpg,Li145
4131,15071.145682,15071.165682,1,452134370,452134970,600,audio/Ti81_452134370.jpg,Ti81
4132,1797.705115,1797.743115,2,53931153,53932293,1140,audio/Bl122_53931153.jpg,Bl122
4133,15137.999989,15138.076989,1,454139999,454142309,2310,audio/Ti81_454139999.jpg,Ti81
4134,7554.570715,7554.881715,1,226637121,226646451,9330,audio/Li145_226637121.jpg,Li145
4135,187.419971,187.441971,1,5622599,5623259,660,audio/Or61_5622599.jpg,Or61
4136,7555.491715,7555.526715,1,226664751,226665801,1050,audio/Li145_226664751.jpg,Li145
4137,887.326904,887.498465,1,26619807,26624953,5146,audio/Ti81_26619807.jpg,Ti81
4138,724.970271,724.992271,1,21749108,21749768,660,audio/Or61_21749108.jpg,Or61
4139,2116.583183,2116.588183,2,63497495,63497645,150,audio/Bl122_63497495.jpg,Bl122
4140,15060.703966,15060.999966,1,451821118,451829998,8880,audio/Ti81_451821118.jpg,Ti81
4141,512.502221,512.520221,1,15375066,15375606,540,audio/Or61_15375066.jpg,Or61
4142,4906.043385,4906.117385,1,147181301,147183521,2220,audio/Li145_147181301.jpg,Li145
4143,2177.517183,2177.519183,2,65325515,65325575,60,audio/Bl122_65325515.jpg,Bl122
4144,3448.552406,3448.566913,1,103456572,103457007,435,audio/Ti81_103456572.jpg,Ti81
4145,2141.998183,2142.015183,1,64259945,64260455,510,audio/Bl122_64259945.jpg,Bl122
4146,1997.769779,1997.972779,1,59933093,59939183,6090,audio/Bl122_59933093.jpg,Bl122
4147,3418.354826,3418.450698,1,102550644,102553520,2876,audio/Ti81_102550644.jpg,Ti81
4148,1972.806779,1972.808779,2,59184203,59184263,60,audio/Bl122_59184203.jpg,Bl122
4149,759.603271,759.943271,1,22788098,22798298,10200,audio/Or61_22788098.jpg,Or61
4150,15058.687302,15058.731302,1,451760619,451761939,1320,audio/Ti81_451760619.jpg,Ti81
4151,1977.718779,1977.724779,2,59331563,59331743,180,audio/Bl122_59331563.jpg,Bl122
4152,2158.992183,2158.996183,2,64769765,64769885,120,audio/Bl122_64769765.jpg,Bl122
4153,1972.752779,1972.762779,2,59182583,59182883,300,audio/Bl122_59182583.jpg,Bl122
4154,2039.292815,2039.311815,1,61178784,61179354,570,audio/Li145_61178784.jpg,Li145
4155,2152.117183,2152.122183,2,64563515,64563665,150,audio/Bl122_64563515.jpg,Bl122
4156,3412.387782,3412.418057,1,102371633,102372541,908,audio/Ti81_102371633.jpg,Ti81
4157,2218.634183,2218.642183,2,66559025,66559265,240,audio/Bl122_66559025.jpg,Bl122
4158,727.584271,727.659271,1,21827528,21829778,2250,audio/Or61_21827528.jpg,Or61
4159,557.811416,557.914416,1,16734342,16737432,3090,audio/Or61_16734342.jpg,Or61
4160,2013.807959,2013.810959,2,60414238,60414328,90,audio/Bl122_60414238.jpg,Bl122
4161,15134.315989,15134.487989,1,454029479,454034639,5160,audio/Ti81_454029479.jpg,Ti81
4162,710.735271,710.815271,1,21322058,21324458,2400,audio/Or61_21322058.jpg,Or61
4163,15272.159439,15272.229439,1,458164783,458166883,2100,audio/Ti81_458164783.jpg,Ti81
4164,2011.050959,2011.146959,1,60331528,60334408,2880,audio/Bl122_60331528.jpg,Bl122
4165,496.535221,496.794221,1,14896056,14903826,7770,audio/Or61_14896056.jpg,Or61
4166,1768.294657,1768.387657,1,53048839,53051629,2790,audio/Bl122_53048839.jpg,Bl122
4167,15024.927917,15025.113107,1,450747837,450753393,5556,audio/Ti81_450747837.jpg,Ti81
4168,763.872271,763.916271,1,22916168,22917488,1320,audio/Or61_22916168.jpg,Or61
4169,1788.549115,1788.580115,2,53656473,53657403,930,audio/Bl122_53656473.jpg,Bl122
4170,15036.359433,15036.367128,1,451090782,451091013,231,audio/Ti81_451090782.jpg,Ti81
4171,2063.880469,2064.009469,2,61916414,61920284,3870,audio/Bl122_61916414.jpg,Bl122
4172,2064.042469,2064.148469,2,61921274,61924454,3180,audio/Bl122_61921274.jpg,Bl122
4173,15028.993409,15029.029235,1,450869802,450870877,1075,audio/Ti81_450869802.jpg,Ti81
4174,392.572161,392.727161,1,11777164,11781814,4650,audio/Or61_11777164.jpg,Or61
4175,15049.306966,15049.348966,1,451479208,451480468,1260,audio/Ti81_451479208.jpg,Ti81
4176,8084.529803,8084.561803,1,242535894,242536854,960,audio/Li145_242535894.jpg,Li145
4177,754.663271,754.669271,2,22639898,22640078,180,audio/Or61_22639898.jpg,Or61
4178,2191.711183,2191.762183,1,65751335,65752865,1530,audio/Bl122_65751335.jpg,Bl122
4179,1944.490779,1944.533779,1,58334723,58336013,1290,audio/Bl122_58334723.jpg,Bl122
4180,611.760417,611.786417,1,18352812,18353592,780,audio/Or61_18352812.jpg,Or61
4181,8097.218141,8097.253141,1,242916544,242917594,1050,audio/Li145_242916544.jpg,Li145
4182,2064.015469,2064.037469,2,61920464,61921124,660,audio/Bl122_61920464.jpg,Bl122
4183,2186.979183,2187.004183,2,65609375,65610125,750,audio/Bl122_65609375.jpg,Bl122
4184,15259.107114,15259.261114,1,457773213,457777833,4620,audio/Ti81_457773213.jpg,Ti81
4185,15259.614114,15259.668114,1,457788423,457790043,1620,audio/Ti81_457788423.jpg,Ti81
4186,15067.879682,15067.921682,1,452036390,452037650,1260,audio/Ti81_452036390.jpg,Ti81
4187,1986.280779,1986.284779,2,59588423,59588543,120,audio/Bl122_59588423.jpg,Bl122
4188,2012.451959,2012.471959,2,60373558,60374158,600,audio/Bl122_60373558.jpg,Bl122
4189,2201.602183,2201.780183,1,66048065,66053405,5340,audio/Bl122_66048065.jpg,Bl122
4190,2152.386183,2152.406183,2,64571585,64572185,600,audio/Bl122_64571585.jpg,Bl122
4191,498.765221,498.768221,2,14962956,14963046,90,audio/Or61_14962956.jpg,Or61
4192,14930.861256,14931.035087,1,447925837,447931052,5215,audio/Ti81_447925837.jpg,Ti81
4193,2055.299469,2055.444469,1,61658984,61663334,4350,audio/Bl122_61658984.jpg,Bl122
4194,2158.129183,2158.141183,2,64743875,64744235,360,audio/Bl122_64743875.jpg,Bl122
4195,15151.326716,15151.386716,1,454539801,454541601,1800,audio/Ti81_454539801.jpg,Ti81
4196,556.383416,556.454416,1,16691502,16693632,2130,audio/Or61_16691502.jpg,Or61
4197,15025.481959,15025.500755,1,450764458,450765022,564,audio/Ti81_450764458.jpg,Ti81
4198,2130.521183,2130.532183,2,63915635,63915965,330,audio/Bl122_63915635.jpg,Bl122
4199,2123.823183,2123.904183,1,63714695,63717125,2430,audio/Bl122_63714695.jpg,Bl122
4200,3421.942092,3421.995957,1,102658262,102659878,1616,audio/Ti81_102658262.jpg,Ti81
4201,718.262271,718.295271,1,21547868,21548858,990,audio/Or61_21547868.jpg,Or61
4202,1790.082115,1790.114115,1,53702463,53703423,960,audio/Bl122_53702463.jpg,Bl122
4203,760.286271,760.519271,1,22808588,22815578,6990,audio/Or61_22808588.jpg,Or61
4204,6301.675561,6301.721561,1,189050266,189051646,1380,audio/Li145_189050266.jpg,Li145
4205,2040.101815,2040.115815,1,61203054,61203474,420,audio/Li145_61203054.jpg,Li145
4206,491.949221,492.065221,1,14758476,14761956,3480,audio/Or61_14758476.jpg,Or61
4207,2047.033469,2047.037469,2,61411004,61411124,120,audio/Bl122_61411004.jpg,Bl122
4208,15052.650966,15052.775966,1,451579528,451583278,3750,audio/Ti81_451579528.jpg,Ti81
4209,1942.368779,1942.409779,1,58271063,58272293,1230,audio/Bl122_58271063.jpg,Bl122
4210,2231.201183,2231.228183,2,66936035,66936845,810,audio/Bl122_66936035.jpg,Bl122
4211,5967.878227,5967.902227,1,179036346,179037066,720,audio/Li145_179036346.jpg,Li145
4212,15177.286145,15177.365145,1,455318584,455320954,2370,audio/Ti81_455318584.jpg,Ti81
4213,9613.418775,9613.583146,1,288402563,288407494,4931,audio/Ti81_288402563.jpg,Ti81
4214,541.406416,541.410416,2,16242192,16242312,120,audio/Or61_16242192.jpg,Or61
4215,1800.099115,1800.140115,2,54002973,54004203,1230,audio/Bl122_54002973.jpg,Bl122
4216,486.257221,486.419221,1,14587716,14592576,4860,audio/Or61_14587716.jpg,Or61
4217,15299.472664,15299.500664,1,458984179,458985019,840,audio/Ti81_458984179.jpg,Ti81
4218,2143.140183,2143.144183,2,64294205,64294325,120,audio/Bl122_64294205.jpg,Bl122
4219,2088.693961,2088.699961,2,62660818,62660998,180,audio/Bl122_62660818.jpg,Bl122
4220,771.378271,771.388271,2,23141348,23141648,300,audio/Or61_23141348.jpg,Or61
4221,2061.195469,2061.264469,1,61835864,61837934,2070,audio/Bl122_61835864.jpg,Bl122
4222,820.767419,820.981419,1,24623022,24629442,6420,audio/Bl122_24623022.jpg,Bl122
4223,790.472827,790.476827,2,23714184,23714304,120,audio/Or61_23714184.jpg,Or61
4224,1996.616779,1996.625779,2,59898503,59898773,270,audio/Bl122_59898503.jpg,Bl122
4225,2179.004183,2179.016183,2,65370125,65370485,360,audio/Bl122_65370125.jpg,Bl122
4226,611.414417,611.423417,2,18342432,18342702,270,audio/Or61_18342432.jpg,Or61
4227,1486.253018,1486.272018,1,44587590,44588160,570,audio/Li145_44587590.jpg,Li145
4228,5841.904404,5841.930404,1,175257132,175257912,780,audio/Li145_175257132.jpg,Li145
4229,3547.93664,3548.338764,1,106438099,106450162,12063,audio/Ti81_106438099.jpg,Ti81
4230,2192.768183,2192.773183,2,65783045,65783195,150,audio/Bl122_65783045.jpg,Bl122
4231,2149.566183,2149.573183,2,64486985,64487195,210,audio/Bl122_64486985.jpg,Bl122
4232,616.752417,616.881417,1,18502572,18506442,3870,audio/Or61_18502572.jpg,Or61
4233,15224.569443,15224.633443,1,456737083,456739003,1920,audio/Ti81_456737083.jpg,Ti81
4234,211.013765,211.172765,1,6330412,6335182,4770,audio/Or61_6330412.jpg,Or61
4235,2037.543469,2037.638469,2,61126304,61129154,2850,audio/Bl122_61126304.jpg,Bl122
4236,1962.722779,1962.734779,2,58881683,58882043,360,audio/Bl122_58881683.jpg,Bl122
4237,403.631692,403.634692,2,12108950,12109040,90,audio/Or61_12108950.jpg,Or61
4238,7531.167966,7531.192966,1,225935038,225935788,750,audio/Li145_225935038.jpg,Li145
4239,2010.956959,2010.960959,2,60328708,60328828,120,audio/Bl122_60328708.jpg,Bl122
4240,2122.437183,2122.491183,1,63673115,63674735,1620,audio/Bl122_63673115.jpg,Bl122
4241,1801.500115,1801.505115,2,54045003,54045153,150,audio/Bl122_54045003.jpg,Bl122
4242,441.764265,441.922265,1,13252927,13257667,4740,audio/Or61_13252927.jpg,Or61
4243,487.391221,487.421221,2,14621736,14622636,900,audio/Or61_14621736.jpg,Or61
4244,792.865827,792.908827,1,23785974,23787264,1290,audio/Or61_23785974.jpg,Or61
4245,15334.00501,15334.20001,1,460020150,460026000,5850,audio/Ti81_460020150.jpg,Ti81
4246,738.692271,738.844271,1,22160768,22165328,4560,audio/Or61_22160768.jpg,Or61
4247,15261.876358,15261.967358,1,457856290,457859020,2730,audio/Ti81_457856290.jpg,Ti81
4248,15340.544971,15340.609971,1,460216349,460218299,1950,audio/Ti81_460216349.jpg,Ti81
4249,483.855221,483.891221,1,14515656,14516736,1080,audio/Or61_14515656.jpg,Or61
4250,2000.868779,2000.921779,1,60026063,60027653,1590,audio/Bl122_60026063.jpg,Bl122
4251,2185.714183,2185.732183,2,65571425,65571965,540,audio/Bl122_65571425.jpg,Bl122
4252,578.05771,578.19371,1,17341731,17345811,4080,audio/Or61_17341731.jpg,Or61
4253,3447.729985,3447.956799,1,103431899,103438703,6804,audio/Ti81_103431899.jpg,Ti81
4254,1983.226779,1983.282779,2,59496803,59498483,1680,audio/Bl122_59496803.jpg,Bl122
4255,811.225882,811.404882,1,24336776,24342146,5370,audio/Or61_24336776.jpg,Or61
4256,8889.468716,8889.473716,1,266684061,266684211,150,audio/Li145_266684061.jpg,Li145
4257,2155.434183,2155.712183,1,64663025,64671365,8340,audio/Bl122_64663025.jpg,Bl122
4258,1783.264323,1783.275323,1,53497929,53498259,330,audio/Bl122_53497929.jpg,Bl122
4259,620.684417,620.691417,2,18620532,18620742,210,audio/Or61_18620532.jpg,Or61
4260,15339.858971,15339.910971,1,460195769,460197329,1560,audio/Ti81_460195769.jpg,Ti81
4261,2215.776183,2215.931183,1,66473285,66477935,4650,audio/Bl122_66473285.jpg,Bl122
4262,392.778161,392.856161,1,11783344,11785684,2340,audio/Or61_11783344.jpg,Or61
4263,534.625416,534.634416,2,16038762,16039032,270,audio/Or61_16038762.jpg,Or61
4264,706.375271,706.503271,1,21191258,21195098,3840,audio/Or61_21191258.jpg,Or61
4265,2191.131183,2191.167183,2,65733935,65735015,1080,audio/Bl122_65733935.jpg,Bl122
4266,7569.288558,7569.295558,1,227078656,227078866,210,audio/Li145_227078656.jpg,Li145
4267,3448.683032,3448.967874,1,103460490,103469036,8546,audio/Ti81_103460490.jpg,Ti81
4268,804.573882,804.646882,1,24137216,24139406,2190,audio/Or61_24137216.jpg,Or61
4269,7555.693715,7555.699715,1,226670811,226670991,180,audio/Li145_226670811.jpg,Li145
4270,5721.159018,5721.264018,1,171634770,171637920,3150,audio/Li145_171634770.jpg,Li145
4271,7569.504558,7569.551558,1,227085136,227086546,1410,audio/Li145_227085136.jpg,Li145
4272,15161.527257,15161.667257,1,454845817,454850017,4200,audio/Ti81_454845817.jpg,Ti81
4273,2116.507183,2116.527183,2,63495215,63495815,600,audio/Bl122_63495215.jpg,Bl122
4274,488.787221,488.856221,2,14663616,14665686,2070,audio/Or61_14663616.jpg,Or61
4275,4905.559385,4905.692385,1,147166781,147170771,3990,audio/Li145_147166781.jpg,Li145
4276,2066.635469,2066.661469,2,61999064,61999844,780,audio/Bl122_61999064.jpg,Bl122
4277,15108.510256,15108.749256,1,453255307,453262477,7170,audio/Ti81_453255307.jpg,Ti81
4278,2140.204183,2140.365183,1,64206125,64210955,4830,audio/Bl122_64206125.jpg,Bl122
4279,555.115416,555.143416,1,16653462,16654302,840,audio/Or61_16653462.jpg,Or61
4280,1952.647779,1952.650779,2,58579433,58579523,90,audio/Bl122_58579433.jpg,Bl122
4281,722.645271,722.655271,2,21679358,21679658,300,audio/Or61_21679358.jpg,Or61
4282,2006.915779,2007.023779,1,60207473,60210713,3240,audio/Bl122_60207473.jpg,Bl122
4283,708.051271,708.057271,2,21241538,21241718,180,audio/Or61_21241538.jpg,Or61
4284,3465.114164,3465.267433,1,103953424,103958022,4598,audio/Ti81_103953424.jpg,Ti81
4285,2056.787469,2056.790469,2,61703624,61703714,90,audio/Bl122_61703624.jpg,Bl122
4286,7569.773558,7569.834558,1,227093206,227095036,1830,audio/Li145_227093206.jpg,Li145
4287,6957.010877,6957.032877,1,208710326,208710986,660,audio/Li145_208710326.jpg,Li145
4288,552.098416,552.103416,2,16562952,16563102,150,audio/Or61_16562952.jpg,Or61
4289,2221.579183,2221.803183,1,66647375,66654095,6720,audio/Bl122_66647375.jpg,Bl122
4290,6286.107659,6286.241659,1,188583229,188587249,4020,audio/Li145_188583229.jpg,Li145
4291,607.847417,607.953417,1,18235422,18238602,3180,audio/Or61_18235422.jpg,Or61
4292,608.047417,608.324417,1,18241422,18249732,8310,audio/Or61_18241422.jpg,Or61
4293,1801.057115,1801.142115,2,54031713,54034263,2550,audio/Bl122_54031713.jpg,Bl122
4294,2001.012779,2001.058779,2,60030383,60031763,1380,audio/Bl122_60030383.jpg,Bl122
4295,2218.190183,2218.210183,2,66545705,66546305,600,audio/Bl122_66545705.jpg,Bl122
4296,750.254271,750.262271,1,22507628,22507868,240,audio/Or61_22507628.jpg,Or61
4297,15127.661981,15127.724981,1,453829859,453831749,1890,audio/Ti81_453829859.jpg,Ti81
4298,2111.239183,2111.245183,2,63337175,63337355,180,audio/Bl122_63337175.jpg,Bl122
4299,498.404221,498.495221,2,14952126,14954856,2730,audio/Or61_14952126.jpg,Or61
4300,14904.620365,14904.790034,1,447138610,447143701,5091,audio/Ti81_447138610.jpg,Ti81
4301,1959.614779,1959.637779,2,58788443,58789133,690,audio/Bl122_58788443.jpg,Bl122
4302,631.939417,631.996417,1,18958182,18959892,1710,audio/Or61_18958182.jpg,Or61
4303,9609.292228,9609.463158,1,288278766,288283894,5128,audio/Ti81_288278766.jpg,Ti81
4304,1988.644779,1988.651779,2,59659343,59659553,210,audio/Bl122_59659343.jpg,Bl122
4305,619.206417,619.485417,1,18576192,18584562,8370,audio/Or61_18576192.jpg,Or61
4306,2192.302183,2192.306183,2,65769065,65769185,120,audio/Bl122_65769065.jpg,Bl122
4307,14773.119969,14773.283709,1,443193599,443198511,4912,audio/Ti81_443193599.jpg,Ti81
4308,2012.415959,2012.431959,2,60372478,60372958,480,audio/Bl122_60372478.jpg,Bl122
4309,15247.564074,15247.584074,1,457426922,457427522,600,audio/Ti81_457426922.jpg,Ti81
4310,549.463416,549.467416,2,16483902,16484022,120,audio/Or61_16483902.jpg,Or61
4311,754.080271,754.096271,1,22622408,22622888,480,audio/Or61_22622408.jpg,Or61
4312,2139.537183,2139.540183,2,64186115,64186205,90,audio/Bl122_64186115.jpg,Bl122
4313,2000.655779,2000.664779,2,60019673,60019943,270,audio/Bl122_60019673.jpg,Bl122
4314,2036.346469,2036.524469,1,61090394,61095734,5340,audio/Bl122_61090394.jpg,Bl122
4315,2068.220469,2068.277469,1,62046614,62048324,1710,audio/Bl122_62046614.jpg,Bl122
4316,15058.989966,15059.173966,1,451769698,451775218,5520,audio/Ti81_451769698.jpg,Ti81
4317,2057.418469,2057.485469,1,61722554,61724564,2010,audio/Bl122_61722554.jpg,Bl122
4318,1938.738779,1938.769779,2,58162163,58163093,930,audio/Bl122_58162163.jpg,Bl122
4319,1787.034115,1787.063115,1,53611023,53611893,870,audio/Bl122_53611023.jpg,Bl122
4320,1808.756926,1808.760926,2,54262707,54262827,120,audio/Bl122_54262707.jpg,Bl122
4321,2059.660469,2059.690469,1,61789814,61790714,900,audio/Bl122_61789814.jpg,Bl122
4322,1939.741779,1939.744779,2,58192253,58192343,90,audio/Bl122_58192253.jpg,Bl122
4323,15020.765292,15020.887907,1,450622958,450626637,3679,audio/Ti81_450622958.jpg,Ti81
4324,15100.102823,15100.313823,1,453003084,453009414,6330,audio/Ti81_453003084.jpg,Ti81
4325,794.994827,795.021827,1,23849844,23850654,810,audio/Or61_23849844.jpg,Or61
4326,716.113271,716.118271,1,21483398,21483548,150,audio/Or61_21483398.jpg,Or61
4327,488.743221,488.751221,2,14662296,14662536,240,audio/Or61_14662296.jpg,Or61
4328,813.413882,813.480882,1,24402416,24404426,2010,audio/Or61_24402416.jpg,Or61
4329,626.313417,626.315417,2,18789402,18789462,60,audio/Or61_18789402.jpg,Or61
4330,15117.010981,15117.074981,1,453510329,453512249,1920,audio/Ti81_453510329.jpg,Ti81
4331,2181.846183,2182.109183,1,65455385,65463275,7890,audio/Bl122_65455385.jpg,Bl122
4332,2114.940183,2115.057183,1,63448205,63451715,3510,audio/Bl122_63448205.jpg,Bl122
4333,503.710221,503.799221,1,15111306,15113976,2670,audio/Or61_15111306.jpg,Or61
4334,15085.5519,15085.6319,1,452566557,452568957,2400,audio/Ti81_452566557.jpg,Ti81
4335,15247.810074,15247.942074,1,457434302,457438262,3960,audio/Ti81_457434302.jpg,Ti81
4336,213.745857,213.850857,1,6412375,6415525,3150,audio/Or61_6412375.jpg,Or61
4337,795.437827,795.457827,1,23863134,23863734,600,audio/Or61_23863134.jpg,Or61
4338,7563.333654,7563.457654,1,226900009,226903729,3720,audio/Li145_226900009.jpg,Li145
4339,14931.857319,14932.065463,1,447955719,447961963,6244,audio/Ti81_447955719.jpg,Ti81
4340,481.953221,481.965221,2,14458596,14458956,360,audio/Or61_14458596.jpg,Or61
4341,211.550765,211.562765,2,6346522,6346882,360,audio/Or61_6346522.jpg,Or61
4342,217.964413,218.016413,1,6538932,6540492,1560,audio/Or61_6538932.jpg,Or61
4343,1971.611779,1971.631779,2,59148353,59148953,600,audio/Bl122_59148353.jpg,Bl122
4344,2157.594183,2157.703183,1,64727825,64731095,3270,audio/Bl122_64727825.jpg,Bl122
4345,1970.707779,1970.881779,1,59121233,59126453,5220,audio/Bl122_59121233.jpg,Bl122
4346,2218.004183,2218.068183,2,66540125,66542045,1920,audio/Bl122_66540125.jpg,Bl122
4347,1784.41143,1784.48143,1,53532342,53534442,2100,audio/Bl122_53532342.jpg,Bl122
4348,2138.487183,2138.497183,2,64154615,64154915,300,audio/Bl122_64154615.jpg,Bl122
4349,15315.332428,15315.502428,1,459459972,459465072,5100,audio/Ti81_459459972.jpg,Ti81
4350,728.586271,728.720271,1,21857588,21861608,4020,audio/Or61_21857588.jpg,Or61
4351,413.614165,413.671165,1,12408424,12410134,1710,audio/Or61_12408424.jpg,Or61
4352,1979.822779,1979.826779,2,59394683,59394803,120,audio/Bl122_59394683.jpg,Bl122
4353,2149.405183,2149.539183,2,64482155,64486175,4020,audio/Bl122_64482155.jpg,Bl122
4354,15165.357257,15165.422257,1,454960717,454962667,1950,audio/Ti81_454960717.jpg,Ti81
4355,6287.111659,6287.155659,1,188613349,188614669,1320,audio/Li145_188613349.jpg,Li145
4356,2013.670959,2013.683959,2,60410128,60410518,390,audio/Bl122_60410128.jpg,Bl122
4357,2004.707779,2004.719779,2,60141233,60141593,360,audio/Bl122_60141233.jpg,Bl122
4358,6300.073561,6300.092561,2,189002206,189002776,570,audio/Li145_189002206.jpg,Li145
4359,1944.733779,1944.754779,2,58342013,58342643,630,audio/Bl122_58342013.jpg,Bl122
4360,756.311271,756.433271,1,22689338,22692998,3660,audio/Or61_22689338.jpg,Or61
4361,2048.443469,2048.493469,2,61453304,61454804,1500,audio/Bl122_61453304.jpg,Bl122
4362,2053.400469,2053.404469,2,61602014,61602134,120,audio/Bl122_61602014.jpg,Bl122
4363,510.123221,510.136221,1,15303696,15304086,390,audio/Or61_15303696.jpg,Or61
4364,1992.464779,1992.468779,2,59773943,59774063,120,audio/Bl122_59773943.jpg,Bl122
4365,2226.395183,2226.465183,1,66791855,66793955,2100,audio/Bl122_66791855.jpg,Bl122
4366,15032.065109,15032.123893,1,450961953,450963716,1763,audio/Ti81_450961953.jpg,Ti81
4367,6537.27968,6537.43968,1,196118390,196123190,4800,audio/Li145_196118390.jpg,Li145
4368,7546.672781,7546.700781,1,226400183,226401023,840,audio/Li145_226400183.jpg,Li145
4369,1982.303779,1982.337779,2,59469113,59470133,1020,audio/Bl122_59469113.jpg,Bl122
4370,632.002417,632.023417,2,18960072,18960702,630,audio/Or61_18960072.jpg,Or61
4371,2095.989961,2095.994961,2,62879698,62879848,150,audio/Bl122_62879698.jpg,Bl122
4372,9616.404694,9616.571335,1,288492140,288497140,5000,audio/Ti81_288492140.jpg,Ti81
4373,386.581161,386.619161,1,11597434,11598574,1140,audio/Or61_11597434.jpg,Or61
4374,15124.509981,15124.553626,1,453735299,453736608,1309,audio/Ti81_453735299.jpg,Ti81
4375,15034.047395,15034.118417,1,451021421,451023552,2131,audio/Ti81_451021421.jpg,Ti81
4376,564.938416,565.090416,1,16948152,16952712,4560,audio/Or61_16948152.jpg,Or61
4377,2123.292183,2123.295183,2,63698765,63698855,90,audio/Bl122_63698765.jpg,Bl122
4378,749.187271,749.203271,1,22475618,22476098,480,audio/Or61_22475618.jpg,Or61
4379,746.285271,746.335271,1,22388558,22390058,1500,audio/Or61_22388558.jpg,Or61
4380,15243.994874,15244.022874,1,457319846,457320686,840,audio/Ti81_457319846.jpg,Ti81
4381,2171.762183,2171.769183,1,65152865,65153075,210,audio/Bl122_65152865.jpg,Bl122
4382,2224.453183,2224.507183,1,66733595,66735215,1620,audio/Bl122_66733595.jpg,Bl122
4383,748.134271,748.153271,1,22444028,22444598,570,audio/Or61_22444028.jpg,Or61
4384,565.191416,565.242416,1,16955742,16957272,1530,audio/Or61_16955742.jpg,Or61
4385,89.488871,89.495871,2,2684666,2684876,210,audio/Bl122_2684666.jpg,Bl122
4386,2204.365183,2204.598183,1,66130955,66137945,6990,audio/Bl122_66130955.jpg,Bl122
4387,2233.803183,2233.806183,2,67014095,67014185,90,audio/Bl122_67014095.jpg,Bl122
4388,2116.118183,2116.142183,1,63483545,63484265,720,audio/Bl122_63483545.jpg,Bl122
4389,504.599221,504.604221,2,15137976,15138126,150,audio/Or61_15137976.jpg,Or61
4390,15128.428981,15128.475981,1,453852869,453854279,1410,audio/Ti81_453852869.jpg,Ti81
4391,4578.199239,4578.216142,1,137345977,137346484,507,audio/Ti81_137345977.jpg,Ti81
4392,3543.866354,3544.014704,1,106315990,106320441,4451,audio/Ti81_106315990.jpg,Ti81
4393,542.902416,542.940416,1,16287072,16288212,1140,audio/Or61_16287072.jpg,Or61
4394,15128.188981,15128.212981,1,453845669,453846389,720,audio/Ti81_453845669.jpg,Ti81
4395,2216.552183,2216.561183,2,66496565,66496835,270,audio/Bl122_66496565.jpg,Bl122
4396,537.646416,537.697416,1,16129392,16130922,1530,audio/Or61_16129392.jpg,Or61
4397,2143.769183,2143.771183,2,64313075,64313135,60,audio/Bl122_64313075.jpg,Bl122
4398,2054.394469,2054.421469,2,61631834,61632644,810,audio/Bl122_61631834.jpg,Bl122
4399,730.098271,730.127271,1,21902948,21903818,870,audio/Or61_21902948.jpg,Or61
4400,2107.738377,2107.747377,2,63232151,63232421,270,audio/Bl122_63232151.jpg,Bl122
4401,2040.602815,2040.605815,2,61218084,61218174,90,audio/Li145_61218084.jpg,Li145
4402,518.807221,518.866221,1,15564216,15565986,1770,audio/Or61_15564216.jpg,Or61
4403,6949.399842,6949.415842,1,208481995,208482475,480,audio/Li145_208481995.jpg,Li145
4404,2124.319183,2124.352183,2,63729575,63730565,990,audio/Bl122_63729575.jpg,Bl122
4405,9180.925829,9180.942829,1,275427774,275428284,510,audio/Li145_275427774.jpg,Li145
4406,15301.723373,15301.916373,1,459051701,459057491,5790,audio/Ti81_459051701.jpg,Ti81
4407,672.731078,672.802078,1,20181932,20184062,2130,audio/Or61_20181932.jpg,Or61
4408,759.284271,759.349271,1,22778528,22780478,1950,audio/Or61_22778528.jpg,Or61
4409,2176.371183,2176.379183,2,65291135,65291375,240,audio/Bl122_65291135.jpg,Bl122
4410,2000.521779,2000.538779,2,60015653,60016163,510,audio/Bl122_60015653.jpg,Bl122
4411,557.212416,557.250416,1,16716372,16717512,1140,audio/Or61_16716372.jpg,Or61
4412,15096.83381,15096.84544,1,452905014,452905363,349,audio/Ti81_452905014.jpg,Ti81
4413,506.969221,507.013221,1,15209076,15210396,1320,audio/Or61_15209076.jpg,Or61
4414,406.263692,406.316692,2,12187910,12189500,1590,audio/Or61_12187910.jpg,Or61
4415,15139.143989,15139.190989,1,454174319,454175729,1410,audio/Ti81_454174319.jpg,Ti81
4416,201.550012,201.771012,1,6046500,6053130,6630,audio/Or61_6046500.jpg,Or61
4417,2012.398959,2012.407959,2,60371968,60372238,270,audio/Bl122_60371968.jpg,Bl122
4418,15266.071358,15266.346358,1,457982140,457990390,8250,audio/Ti81_457982140.jpg,Ti81
4419,15083.9429,15083.9599,2,452518287,452518797,510,audio/Ti81_452518287.jpg,Ti81
4420,2146.690183,2146.697183,2,64400705,64400915,210,audio/Bl122_64400705.jpg,Bl122
4421,603.630417,603.656417,1,18108912,18109692,780,audio/Or61_18108912.jpg,Or61
4422,15041.220917,15041.23883,1,451236627,451237164,537,audio/Ti81_451236627.jpg,Ti81
4423,183.823971,183.840971,2,5514719,5515229,510,audio/Or61_5514719.jpg,Or61
4424,533.162416,533.310416,1,15994872,15999312,4440,audio/Or61_15994872.jpg,Or61
4425,14805.233167,14805.390978,1,444156995,444161729,4734,audio/Ti81_444156995.jpg,Ti81
4426,1940.482779,1940.488779,2,58214483,58214663,180,audio/Bl122_58214483.jpg,Bl122
4427,2068.345469,2068.489469,1,62050364,62054684,4320,audio/Bl122_62050364.jpg,Bl122
4428,5886.854515,5886.949515,1,176605635,176608485,2850,audio/Li145_176605635.jpg,Li145
4429,2181.644183,2181.647183,2,65449325,65449415,90,audio/Bl122_65449325.jpg,Bl122
4430,490.699221,490.701221,2,14720976,14721036,60,audio/Or61_14720976.jpg,Or61
4431,637.721417,637.753417,1,19131642,19132602,960,audio/Or61_19131642.jpg,Or61
4432,15041.608948,15041.782275,1,451248268,451253468,5200,audio/Ti81_451248268.jpg,Ti81
4433,2220.147183,2220.422183,1,66604415,66612665,8250,audio/Bl122_66604415.jpg,Bl122
4434,403.598692,403.621692,2,12107960,12108650,690,audio/Or61_12107960.jpg,Or61
4435,1979.664779,1979.669779,2,59389943,59390093,150,audio/Bl122_59389943.jpg,Bl122
4436,748.034271,748.045271,1,22441028,22441358,330,audio/Or61_22441028.jpg,Or61
4437,2100.586961,2100.749961,1,63017608,63022498,4890,audio/Bl122_63017608.jpg,Bl122
4438,2097.899961,2097.903961,2,62936998,62937118,120,audio/Bl122_62936998.jpg,Bl122
4439,2163.356183,2163.384183,1,64900685,64901525,840,audio/Bl122_64900685.jpg,Bl122
4440,933.422199,933.633623,1,28002665,28009008,6343,audio/Ti81_28002665.jpg,Ti81
4441,548.524416,548.565416,1,16455732,16456962,1230,audio/Or61_16455732.jpg,Or61
4442,906.455391,906.625817,1,27193661,27198774,5113,audio/Ti81_27193661.jpg,Ti81
4443,9172.685804,9172.698804,1,275180574,275180964,390,audio/Li145_275180574.jpg,Li145
4444,2179.591183,2179.594183,2,65387735,65387825,90,audio/Bl122_65387735.jpg,Bl122
4445,3414.608993,3414.639016,1,102438269,102439170,901,audio/Ti81_102438269.jpg,Ti81
4446,1934.472613,1934.632613,1,58034178,58038978,4800,audio/Bl122_58034178.jpg,Bl122
4447,552.288416,552.375416,1,16568652,16571262,2610,audio/Or61_16568652.jpg,Or61
4448,490.779221,491.011221,1,14723376,14730336,6960,audio/Or61_14723376.jpg,Or61
4449,2159.978183,2160.011183,2,64799345,64800335,990,audio/Bl122_64799345.jpg,Bl122
4450,2089.966961,2089.976961,1,62699008,62699308,300,audio/Bl122_62699008.jpg,Bl122
4451,15277.833439,15277.852439,1,458335003,458335573,570,audio/Ti81_458335003.jpg,Ti81
4452,553.729416,553.976416,1,16611882,16619292,7410,audio/Or61_16611882.jpg,Or61
4453,2178.476183,2178.479183,2,65354285,65354375,90,audio/Bl122_65354285.jpg,Bl122
4454,15284.347439,15284.537272,1,458530423,458536118,5695,audio/Ti81_458530423.jpg,Ti81
4455,816.138882,816.352882,1,24484166,24490586,6420,audio/Or61_24484166.jpg,Or61
4456,619.732417,619.739417,2,18591972,18592182,210,audio/Or61_18591972.jpg,Or61
4457,15214.76658,15214.82458,1,456442997,456444737,1740,audio/Ti81_456442997.jpg,Ti81
4458,759.528271,759.599271,1,22785848,22787978,2130,audio/Or61_22785848.jpg,Or61
4459,754.505271,754.518271,2,22635158,22635548,390,audio/Or61_22635158.jpg,Or61
4460,672.533078,672.587078,1,20175992,20177612,1620,audio/Or61_20175992.jpg,Or61
4461,747.029271,747.091271,1,22410878,22412738,1860,audio/Or61_22410878.jpg,Or61
4462,1789.185115,1789.303115,1,53675553,53679093,3540,audio/Bl122_53675553.jpg,Bl122
4463,2228.976183,2228.992183,2,66869285,66869765,480,audio/Bl122_66869285.jpg,Bl122
4464,486.458221,486.495221,2,14593746,14594856,1110,audio/Or61_14593746.jpg,Or61
4465,2235.072183,2235.081183,2,67052165,67052435,270,audio/Bl122_67052165.jpg,Bl122
4466,2228.486183,2228.540183,1,66854585,66856205,1620,audio/Bl122_66854585.jpg,Bl122
4467,497.994221,498.024221,2,14939826,14940726,900,audio/Or61_14939826.jpg,Or61
4468,518.444221,518.567221,1,15553326,15557016,3690,audio/Or61_15553326.jpg,Or61
4469,771.649271,771.666271,2,23149478,23149988,510,audio/Or61_23149478.jpg,Or61
4470,1486.442018,1486.454018,1,44593260,44593620,360,audio/Li145_44593260.jpg,Li145
4471,412.6713,412.8823,1,12380139,12386469,6330,audio/Bl122_12380139.jpg,Bl122
4472,6338.322837,6338.335837,1,190149685,190150075,390,audio/Li145_190149685.jpg,Li145
4473,747.838271,747.860271,1,22435148,22435808,660,audio/Or61_22435148.jpg,Or61
4474,183.872971,183.886971,2,5516189,5516609,420,audio/Or61_5516189.jpg,Or61
4475,6285.895659,6285.926659,1,188576869,188577799,930,audio/Li145_188576869.jpg,Li145
4476,792.504827,792.509827,2,23775144,23775294,150,audio/Or61_23775144.jpg,Or61
4477,2138.671183,2138.674183,2,64160135,64160225,90,audio/Bl122_64160135.jpg,Bl122
4478,2042.246469,2042.264469,2,61267394,61267934,540,audio/Bl122_61267394.jpg,Bl122
4479,3467.190431,3467.213137,1,104015712,104016394,682,audio/Ti81_104015712.jpg,Ti81
4480,2215.623183,2215.638183,2,66468695,66469145,450,audio/Bl122_66468695.jpg,Bl122
4481,1789.875115,1789.930115,1,53696253,53697903,1650,audio/Bl122_53696253.jpg,Bl122
4482,769.321271,769.379271,1,23079638,23081378,1740,audio/Or61_23079638.jpg,Or61
4483,790.518827,790.530827,2,23715564,23715924,360,audio/Or61_23715564.jpg,Or61
4484,2094.763961,2094.788961,1,62842918,62843668,750,audio/Bl122_62842918.jpg,Bl122
4485,546.249416,546.271416,1,16387482,16388142,660,audio/Or61_16387482.jpg,Or61
4486,2092.684961,2092.719961,2,62780548,62781598,1050,audio/Bl122_62780548.jpg,Bl122
4487,2158.406183,2158.425183,2,64752185,64752755,570,audio/Bl122_64752185.jpg,Bl122
4488,762.027271,762.032271,2,22860818,22860968,150,audio/Or61_22860818.jpg,Or61
4489,509.188221,509.198221,2,15275646,15275946,300,audio/Or61_15275646.jpg,Or61
4490,15027.412525,15027.443305,1,450822375,450823299,924,audio/Ti81_450822375.jpg,Ti81
4491,764.549271,764.557271,1,22936478,22936718,240,audio/Or61_22936478.jpg,Or61
4492,15148.773607,15148.922716,1,454463208,454467681,4473,audio/Ti81_454463208.jpg,Ti81
4493,2003.601779,2003.655779,1,60108053,60109673,1620,audio/Bl122_60108053.jpg,Bl122
4494,2007.758779,2007.964779,1,60232763,60238943,6180,audio/Bl122_60232763.jpg,Bl122
4495,2038.539469,2038.589469,2,61156184,61157684,1500,audio/Bl122_61156184.jpg,Bl122
4496,517.301221,517.307221,2,15519036,15519216,180,audio/Or61_15519036.jpg,Or61
4497,2053.219469,2053.378469,1,61596584,61601354,4770,audio/Bl122_61596584.jpg,Bl122
4498,15165.803257,15165.874257,1,454974097,454976227,2130,audio/Ti81_454974097.jpg,Ti81
4499,754.541271,754.574271,2,22636238,22637228,990,audio/Or61_22636238.jpg,Or61
4500,2069.824469,2069.827469,2,62094734,62094824,90,audio/Bl122_62094734.jpg,Bl122
4501,2134.823183,2134.826183,2,64044695,64044785,90,audio/Bl122_64044695.jpg,Bl122
4502,475.603221,475.707221,2,14268096,14271216,3120,audio/Or61_14268096.jpg,Or61
4503,812.378882,812.382882,2,24371366,24371486,120,audio/Or61_24371366.jpg,Or61
4504,448.247112,448.331112,1,13447413,13449933,2520,audio/Or61_13447413.jpg,Or61
4505,1966.521779,1966.615779,2,58995653,58998473,2820,audio/Bl122_58995653.jpg,Bl122
4506,428.512969,428.587969,1,12855389,12857639,2250,audio/Or61_12855389.jpg,Or61
4507,2115.421183,2115.444183,1,63462635,63463325,690,audio/Bl122_63462635.jpg,Bl122
4508,7553.807715,7553.890715,1,226614231,226616721,2490,audio/Li145_226614231.jpg,Li145
4509,15159.800257,15160.019257,1,454794007,454800577,6570,audio/Ti81_454794007.jpg,Ti81
4510,15026.261931,15026.318192,1,450787857,450789545,1688,audio/Ti81_450787857.jpg,Ti81
4511,770.883271,770.910271,2,23126498,23127308,810,audio/Or61_23126498.jpg,Or61
4512,1998.062779,1998.070779,2,59941883,59942123,240,audio/Bl122_59941883.jpg,Bl122
4513,816.542882,816.602882,1,24496286,24498086,1800,audio/Or61_24496286.jpg,Or61
4514,2206.736183,2206.755183,2,66202085,66202655,570,audio/Bl122_66202085.jpg,Bl122
4515,2156.620183,2156.630183,2,64698605,64698905,300,audio/Bl122_64698605.jpg,Bl122
4516,2005.382779,2005.421779,1,60161483,60162653,1170,audio/Bl122_60161483.jpg,Bl122
4517,2123.019183,2123.080183,1,63690575,63692405,1830,audio/Bl122_63690575.jpg,Bl122
4518,1790.576115,1790.771115,1,53717283,53723133,5850,audio/Bl122_53717283.jpg,Bl122
4519,798.538827,798.562827,2,23956164,23956884,720,audio/Or61_23956164.jpg,Or61
4520,1954.337779,1954.351779,2,58630133,58630553,420,audio/Bl122_58630133.jpg,Bl122
4521,1969.650779,1969.706779,1,59089523,59091203,1680,audio/Bl122_59089523.jpg,Bl122
4522,2156.640183,2156.648183,2,64699205,64699445,240,audio/Bl122_64699205.jpg,Bl122
4523,15328.005625,15328.087625,1,459840168,459842628,2460,audio/Ti81_459840168.jpg,Ti81
4524,2098.381961,2098.498961,1,62951458,62954968,3510,audio/Bl122_62951458.jpg,Bl122
4525,3466.584296,3466.667296,1,103997528,104000018,2490,audio/Ti81_103997528.jpg,Ti81
4526,397.050529,397.093529,2,11911515,11912805,1290,audio/Or61_11911515.jpg,Or61
4527,7488.578431,7488.855431,1,224657352,224665662,8310,audio/Li145_224657352.jpg,Li145
4528,543.311416,543.340416,1,16299342,16300212,870,audio/Or61_16299342.jpg,Or61
4529,15138.469989,15138.549989,1,454154099,454156499,2400,audio/Ti81_454154099.jpg,Ti81
4530,2128.467183,2128.614183,1,63854015,63858425,4410,audio/Bl122_63854015.jpg,Bl122
4531,2109.438082,2109.496082,1,63283142,63284882,1740,audio/Bl122_63283142.jpg,Bl122
4532,724.585271,724.587271,2,21737558,21737618,60,audio/Or61_21737558.jpg,Or61
4533,6303.178561,6303.215561,1,189095356,189096466,1110,audio/Li145_189095356.jpg,Li145
4534,2154.816183,2154.875183,1,64644485,64646255,1770,audio/Bl122_64644485.jpg,Bl122
4535,2052.507469,2052.549469,2,61575224,61576484,1260,audio/Bl122_61575224.jpg,Bl122
4536,1937.990779,1937.994779,2,58139723,58139843,120,audio/Bl122_58139723.jpg,Bl122
4537,15049.750966,15049.774966,1,451492528,451493248,720,audio/Ti81_451492528.jpg,Ti81
4538,2165.452183,2165.455183,2,64963565,64963655,90,audio/Bl122_64963565.jpg,Bl122
4539,1966.454779,1966.459779,2,58993643,58993793,150,audio/Bl122_58993643.jpg,Bl122
4540,1986.579779,1986.628779,1,59597393,59598863,1470,audio/Bl122_59597393.jpg,Bl122
4541,627.925417,628.095417,1,18837762,18842862,5100,audio/Or61_18837762.jpg,Or61
4542,5706.146085,5706.182085,1,171184382,171185462,1080,audio/Li145_171184382.jpg,Li145
4543,553.145416,553.228416,1,16594362,16596852,2490,audio/Or61_16594362.jpg,Or61
4544,15247.06378,15247.295872,1,457411913,457418876,6963,audio/Ti81_457411913.jpg,Ti81
4545,8889.952716,8890.083716,1,266698581,266702511,3930,audio/Li145_266698581.jpg,Li145
4546,2035.289469,2035.294469,2,61058684,61058834,150,audio/Bl122_61058684.jpg,Bl122
4547,15127.321981,15127.340981,1,453819659,453820229,570,audio/Ti81_453819659.jpg,Ti81
4548,1960.017779,1960.028779,2,58800533,58800863,330,audio/Bl122_58800533.jpg,Bl122
4549,2055.120469,2055.132469,1,61653614,61653974,360,audio/Bl122_61653614.jpg,Bl122
4550,593.024457,593.026457,2,17790733,17790793,60,audio/Or61_17790733.jpg,Or61
4551,720.276271,720.290271,1,21608288,21608708,420,audio/Or61_21608288.jpg,Or61
4552,2149.921183,2150.137183,1,64497635,64504115,6480,audio/Bl122_64497635.jpg,Bl122
4553,15148.612716,15148.670716,1,454458381,454460121,1740,audio/Ti81_454458381.jpg,Ti81
4554,15132.101417,15132.312272,1,453963042,453969368,6326,audio/Ti81_453963042.jpg,Ti81
4555,1996.259779,1996.524779,1,59887793,59895743,7950,audio/Bl122_59887793.jpg,Bl122
4556,15236.779874,15236.796874,1,457103396,457103906,510,audio/Ti81_457103396.jpg,Ti81
4557,2220.882183,2220.914183,1,66626465,66627425,960,audio/Bl122_66626465.jpg,Bl122
4558,602.198417,602.248417,1,18065952,18067452,1500,audio/Or61_18065952.jpg,Or61
4559,603.598417,603.619417,1,18107952,18108582,630,audio/Or61_18107952.jpg,Or61
4560,1769.827657,1769.851657,2,53094829,53095549,720,audio/Bl122_53094829.jpg,Bl122
4561,793.828827,793.907827,1,23814864,23817234,2370,audio/Or61_23814864.jpg,Or61
4562,2145.871183,2145.901183,2,64376135,64377035,900,audio/Bl122_64376135.jpg,Bl122
4563,629.782417,629.824417,1,18893472,18894732,1260,audio/Or61_18893472.jpg,Or61
4564,15093.425823,15093.483823,1,452802774,452804514,1740,audio/Ti81_452802774.jpg,Ti81
4565,787.582827,787.632827,1,23627484,23628984,1500,audio/Or61_23627484.jpg,Or61
4566,3499.651338,3499.824338,1,104989540,104994730,5190,audio/Li145_104989540.jpg,Li145
4567,2154.069183,2154.272183,1,64622075,64628165,6090,audio/Bl122_64622075.jpg,Bl122
4568,494.131221,494.216221,1,14823936,14826486,2550,audio/Or61_14823936.jpg,Or61
4569,568.423467,568.444467,1,17052704,17053334,630,audio/Or61_17052704.jpg,Or61
4570,2164.305183,2164.309183,2,64929155,64929275,120,audio/Bl122_64929155.jpg,Bl122
4571,2182.255183,2182.259183,2,65467655,65467775,120,audio/Bl122_65467655.jpg,Bl122
4572,14898.461261,14898.610179,1,446953837,446958305,4468,audio/Ti81_446953837.jpg,Ti81
4573,15023.267307,15023.631875,1,450698019,450708956,10937,audio/Ti81_450698019.jpg,Ti81
4574,2001.143779,2001.163779,2,60034313,60034913,600,audio/Bl122_60034313.jpg,Bl122
4575,15223.994443,15224.023443,1,456719833,456720703,870,audio/Ti81_456719833.jpg,Ti81
4576,493.799221,493.820221,2,14813976,14814606,630,audio/Or61_14813976.jpg,Or61
4577,14944.065148,14944.090377,1,448321954,448322711,757,audio/Ti81_448321954.jpg,Ti81
4578,755.811271,755.892271,1,22674338,22676768,2430,audio/Or61_22674338.jpg,Or61
4579,7553.364715,7553.384715,1,226600941,226601541,600,audio/Li145_226600941.jpg,Li145
4580,2141.868183,2141.898183,2,64256045,64256945,900,audio/Bl122_64256045.jpg,Bl122
4581,2151.377183,2151.384183,2,64541315,64541525,210,audio/Bl122_64541315.jpg,Bl122
4582,504.335221,504.339221,2,15130056,15130176,120,audio/Or61_15130056.jpg,Or61
4583,560.750416,560.822416,1,16822512,16824672,2160,audio/Or61_16822512.jpg,Or61
4584,15046.011759,15046.170958,1,451380352,451385128,4776,audio/Ti81_451380352.jpg,Ti81
4585,183.396971,183.460971,1,5501909,5503829,1920,audio/Or61_5501909.jpg,Or61
4586,2119.186183,2119.205183,1,63575585,63576155,570,audio/Bl122_63575585.jpg,Bl122
4587,770.914271,770.921271,2,23127428,23127638,210,audio/Or61_23127428.jpg,Or61
4588,15136.809989,15136.868989,1,454104299,454106069,1770,audio/Ti81_454104299.jpg,Ti81
4589,437.722191,437.992191,1,13131665,13139765,8100,audio/Or61_13131665.jpg,Or61
4590,1943.769779,1943.788779,2,58313093,58313663,570,audio/Bl122_58313093.jpg,Bl122
4591,15031.830978,15031.854442,1,450954929,450955633,704,audio/Ti81_450954929.jpg,Ti81
4592,2110.904183,2110.942183,1,63327125,63328265,1140,audio/Bl122_63327125.jpg,Bl122
4593,15102.607256,15102.913256,1,453078217,453087397,9180,audio/Ti81_453078217.jpg,Ti81
4594,8863.848987,8864.026987,1,265915469,265920809,5340,audio/Li145_265915469.jpg,Li145
4595,5968.582227,5968.588227,2,179057466,179057646,180,audio/Li145_179057466.jpg,Li145
4596,1974.772779,1974.783779,2,59243183,59243513,330,audio/Bl122_59243183.jpg,Bl122
4597,488.561221,488.573221,2,14656836,14657196,360,audio/Or61_14656836.jpg,Or61
4598,507.697221,507.721221,1,15230916,15231636,720,audio/Or61_15230916.jpg,Or61
4599,1787.086115,1787.103115,2,53612583,53613093,510,audio/Bl122_53612583.jpg,Bl122
4600,3419.464296,3419.478425,1,102583928,102584352,424,audio/Ti81_102583928.jpg,Ti81
4601,2046.563469,2046.573469,2,61396904,61397204,300,audio/Bl122_61396904.jpg,Bl122
4602,6332.903902,6333.013902,1,189987117,189990417,3300,audio/Li145_189987117.jpg,Li145
4603,766.059271,766.079271,1,22981778,22982378,600,audio/Or61_22981778.jpg,Or61
4604,15298.551664,15298.580664,1,458956549,458957419,870,audio/Ti81_458956549.jpg,Ti81
4605,7563.733654,7563.774654,1,226912009,226913239,1230,audio/Li145_226912009.jpg,Li145
4606,2000.938779,2000.945779,2,60028163,60028373,210,audio/Bl122_60028163.jpg,Bl122
4607,2144.888183,2144.953183,1,64346645,64348595,1950,audio/Bl122_64346645.jpg,Bl122
4608,2092.119961,2092.153961,1,62763598,62764618,1020,audio/Bl122_62763598.jpg,Bl122
4609,8889.771716,8889.822716,1,266693151,266694681,1530,audio/Li145_266693151.jpg,Li145
4610,15297.355664,15297.593328,1,458920669,458927799,7130,audio/Ti81_458920669.jpg,Ti81
4611,1945.925779,1945.931779,2,58377773,58377953,180,audio/Bl122_58377773.jpg,Bl122
4612,15118.028981,15118.084981,1,453540869,453542549,1680,audio/Ti81_453540869.jpg,Ti81
4613,1984.261779,1984.264779,2,59527853,59527943,90,audio/Bl122_59527853.jpg,Bl122
4614,6946.995821,6947.005821,1,208409874,208410174,300,audio/Li145_208409874.jpg,Li145
4615,2038.894469,2038.910469,2,61166834,61167314,480,audio/Bl122_61166834.jpg,Bl122
4616,795.128827,795.268827,1,23853864,23858064,4200,audio/Or61_23853864.jpg,Or61
4617,2065.881469,2065.886469,2,61976444,61976594,150,audio/Bl122_61976444.jpg,Bl122
4618,2143.381183,2143.687183,1,64301435,64310615,9180,audio/Bl122_64301435.jpg,Bl122
4619,1958.368779,1958.424779,2,58751063,58752743,1680,audio/Bl122_58751063.jpg,Bl122
4620,15262.163358,15262.214358,1,457864900,457866430,1530,audio/Ti81_457864900.jpg,Ti81
4621,7569.838558,7569.844558,2,227095156,227095336,180,audio/Li145_227095156.jpg,Li145
4622,553.677416,553.725416,1,16610322,16611762,1440,audio/Or61_16610322.jpg,Or61
4623,613.909417,613.920417,1,18417282,18417612,330,audio/Or61_18417282.jpg,Or61
4624,15073.861682,15073.894682,1,452215850,452216840,990,audio/Ti81_452215850.jpg,Ti81
4625,1993.721779,1993.914779,1,59811653,59817443,5790,audio/Bl122_59811653.jpg,Bl122
4626,1788.341115,1788.374115,1,53650233,53651223,990,audio/Bl122_53650233.jpg,Bl122
4627,2148.094183,2148.212183,1,64442825,64446365,3540,audio/Bl122_64442825.jpg,Bl122
4628,807.672882,808.005882,1,24230186,24240176,9990,audio/Or61_24230186.jpg,Or61
4629,487.810221,487.814221,2,14634306,14634426,120,audio/Or61_14634306.jpg,Or61
4630,1996.631779,1996.663779,2,59898953,59899913,960,audio/Bl122_59898953.jpg,Bl122
4631,2200.838183,2200.857183,2,66025145,66025715,570,audio/Bl122_66025145.jpg,Bl122
4632,4578.05871,4578.114972,1,137341761,137343449,1688,audio/Ti81_137341761.jpg,Ti81
4633,455.850826,456.043826,1,13675524,13681314,5790,audio/Or61_13675524.jpg,Or61
4634,1982.342779,1982.399779,2,59470283,59471993,1710,audio/Bl122_59470283.jpg,Bl122
4635,2198.666183,2198.681183,2,65959985,65960435,450,audio/Bl122_65959985.jpg,Bl122
4636,15122.987981,15123.164614,1,453689639,453694938,5299,audio/Ti81_453689639.jpg,Ti81
4637,15125.148981,15125.177981,1,453754469,453755339,870,audio/Ti81_453754469.jpg,Ti81
4638,2223.859183,2223.862183,2,66715775,66715865,90,audio/Bl122_66715775.jpg,Bl122
4639,15105.179256,15105.212256,1,453155377,453156367,990,audio/Ti81_453155377.jpg,Ti81
4640,730.261271,730.310271,1,21907838,21909308,1470,audio/Or61_21907838.jpg,Or61
4641,721.200271,721.230271,1,21636008,21636908,900,audio/Or61_21636008.jpg,Or61
4642,15056.683966,15057.030966,1,451700518,451710928,10410,audio/Ti81_451700518.jpg,Ti81
4643,15027.701908,15027.79551,1,450831057,450833865,2808,audio/Ti81_450831057.jpg,Ti81
4644,15156.869257,15156.922257,1,454706077,454707667,1590,audio/Ti81_454706077.jpg,Ti81
4645,2082.044961,2082.211961,1,62461348,62466358,5010,audio/Bl122_62461348.jpg,Bl122
4646,15209.02558,15209.21458,1,456270767,456276437,5670,audio/Ti81_456270767.jpg,Ti81
4647,15335.73801,15335.808098,1,460072140,460074242,2102,audio/Ti81_460072140.jpg,Ti81
4648,601.284417,601.307417,1,18038532,18039222,690,audio/Or61_18038532.jpg,Or61
4649,7569.859558,7569.877558,1,227095786,227096326,540,audio/Li145_227095786.jpg,Li145
4650,15110.196256,15110.225256,1,453305887,453306757,870,audio/Ti81_453305887.jpg,Ti81
4651,15107.477256,15107.527256,1,453224317,453225817,1500,audio/Ti81_453224317.jpg,Ti81
4652,1987.511779,1987.556779,2,59625353,59626703,1350,audio/Bl122_59625353.jpg,Bl122
4653,2095.164961,2095.177961,1,62854948,62855338,390,audio/Bl122_62854948.jpg,Bl122
4654,15047.486966,15047.537966,1,451424608,451426138,1530,audio/Ti81_451424608.jpg,Ti81
4655,1955.045779,1955.050779,2,58651373,58651523,150,audio/Bl122_58651373.jpg,Bl122
4656,15235.140874,15235.174874,1,457054226,457055246,1020,audio/Ti81_457054226.jpg,Ti81
4657,615.459417,615.461417,2,18463782,18463842,60,audio/Or61_18463782.jpg,Or61
4658,15109.597256,15109.735256,1,453287917,453292057,4140,audio/Ti81_453287917.jpg,Ti81
4659,15334.64101,15334.66601,1,460039230,460039980,750,audio/Ti81_460039230.jpg,Ti81
4660,536.568416,536.574416,1,16097052,16097232,180,audio/Or61_16097052.jpg,Or61
4661,15328.223625,15328.355115,1,459846708,459850653,3945,audio/Ti81_459846708.jpg,Ti81
4662,5841.406404,5841.423404,1,175242192,175242702,510,audio/Li145_175242192.jpg,Li145
4663,2048.134469,2048.147469,1,61444034,61444424,390,audio/Bl122_61444034.jpg,Bl122
4664,1800.817115,1800.981115,1,54024513,54029433,4920,audio/Bl122_54024513.jpg,Bl122
4665,5839.582404,5839.875404,1,175187472,175196262,8790,audio/Li145_175187472.jpg,Li145
4666,15223.859443,15223.946443,1,456715783,456718393,2610,audio/Ti81_456715783.jpg,Ti81
4667,15302.309373,15302.367373,1,459069281,459071021,1740,audio/Ti81_459069281.jpg,Ti81
4668,629.888417,629.925417,1,18896652,18897762,1110,audio/Or61_18896652.jpg,Or61
4669,8091.868536,8091.888536,1,242756056,242756656,600,audio/Li145_242756056.jpg,Li145
4670,3429.685928,3429.726706,1,102890577,102891801,1224,audio/Ti81_102890577.jpg,Ti81
4671,2156.844183,2156.869183,2,64705325,64706075,750,audio/Bl122_64705325.jpg,Bl122
4672,712.121271,712.191271,1,21363638,21365738,2100,audio/Or61_21363638.jpg,Or61
4673,6952.826285,6952.909285,1,208584788,208587278,2490,audio/Li145_208584788.jpg,Li145
4674,1799.529115,1799.531115,2,53985873,53985933,60,audio/Bl122_53985873.jpg,Bl122
4675,2064.512469,2064.516469,2,61935374,61935494,120,audio/Bl122_61935374.jpg,Bl122
4676,15275.903439,15276.048439,1,458277103,458281453,4350,audio/Ti81_458277103.jpg,Ti81
4677,601.210417,601.234417,1,18036312,18037032,720,audio/Or61_18036312.jpg,Or61
4678,1981.853779,1981.861779,2,59455613,59455853,240,audio/Bl122_59455613.jpg,Bl122
4679,512.210221,512.244221,1,15366306,15367326,1020,audio/Or61_15366306.jpg,Or61
4680,15150.174716,15150.418716,1,454505241,454512561,7320,audio/Ti81_454505241.jpg,Ti81
4681,1960.566779,1960.584779,2,58817003,58817543,540,audio/Bl122_58817003.jpg,Bl122
4682,5967.597227,5967.613227,1,179027916,179028396,480,audio/Li145_179027916.jpg,Li145
4683,2111.414183,2111.428183,2,63342425,63342845,420,audio/Bl122_63342425.jpg,Bl122
4684,619.657417,619.676417,2,18589722,18590292,570,audio/Or61_18589722.jpg,Or61
4685,9134.750751,9134.756751,1,274042522,274042702,180,audio/Li145_274042522.jpg,Li145
4686,2179.042183,2179.049183,2,65371265,65371475,210,audio/Bl122_65371265.jpg,Bl122
4687,2170.780183,2170.784183,2,65123405,65123525,120,audio/Bl122_65123405.jpg,Bl122
4688,2091.642961,2091.652961,2,62749288,62749588,300,audio/Bl122_62749288.jpg,Bl122
4689,2208.056183,2208.125183,2,66241685,66243755,2070,audio/Bl122_66241685.jpg,Bl122
4690,2149.319183,2149.352183,2,64479575,64480565,990,audio/Bl122_64479575.jpg,Bl122
4691,497.034221,497.172221,1,14911026,14915166,4140,audio/Or61_14911026.jpg,Or61
4692,6334.577902,6334.591902,1,190037337,190037757,420,audio/Li145_190037337.jpg,Li145
4693,1961.925779,1962.197779,1,58857773,58865933,8160,audio/Bl122_58857773.jpg,Bl122
4694,1956.634779,1956.640779,2,58699043,58699223,180,audio/Bl122_58699043.jpg,Bl122
4695,2220.965183,2221.086183,1,66628955,66632585,3630,audio/Bl122_66628955.jpg,Bl122
4696,2145.766183,2145.794183,2,64372985,64373825,840,audio/Bl122_64372985.jpg,Bl122
4697,15243.500874,15243.548874,1,457305026,457306466,1440,audio/Ti81_457305026.jpg,Ti81
4698,15033.577873,15033.647128,1,451007336,451009413,2077,audio/Ti81_451007336.jpg,Ti81
4699,2109.835082,2109.837082,2,63295052,63295112,60,audio/Bl122_63295052.jpg,Bl122
4700,533.145416,533.153416,2,15994362,15994602,240,audio/Or61_15994362.jpg,Or61
4701,1800.320115,1800.324115,2,54009603,54009723,120,audio/Bl122_54009603.jpg,Bl122
4702,2199.643183,2199.910183,1,65989295,65997305,8010,audio/Bl122_65989295.jpg,Bl122
4703,2191.249183,2191.251183,2,65737475,65737535,60,audio/Bl122_65737475.jpg,Bl122
4704,2231.262183,2231.270183,2,66937865,66938105,240,audio/Bl122_66937865.jpg,Bl122
4705,5711.391036,5711.456036,1,171341731,171343681,1950,audio/Li145_171341731.jpg,Li145
4706,486.919221,486.952221,2,14607576,14608566,990,audio/Or61_14607576.jpg,Or61
4707,2146.892183,2147.103183,1,64406765,64413095,6330,audio/Bl122_64406765.jpg,Bl122
4708,3547.597302,3547.761251,1,106427919,106432837,4918,audio/Ti81_106427919.jpg,Ti81
4709,1947.534779,1947.652779,1,58426043,58429583,3540,audio/Bl122_58426043.jpg,Bl122
4710,2141.063183,2141.076183,2,64231895,64232285,390,audio/Bl122_64231895.jpg,Bl122
4711,513.373221,513.468221,1,15401196,15404046,2850,audio/Or61_15401196.jpg,Or61
4712,2167.375183,2167.561183,1,65021255,65026835,5580,audio/Bl122_65021255.jpg,Bl122
4713,91.523253,91.529253,2,2745697,2745877,180,audio/Bl122_2745697.jpg,Bl122
4714,6302.842561,6302.850561,1,189085276,189085516,240,audio/Li145_189085276.jpg,Li145
4715,9611.333678,9611.507005,1,288340010,288345210,5200,audio/Ti81_288340010.jpg,Ti81
4716,470.714221,470.728221,2,14121426,14121846,420,audio/Or61_14121426.jpg,Or61
4717,2158.293183,2158.341183,2,64748795,64750235,1440,audio/Bl122_64748795.jpg,Bl122
4718,2094.837961,2094.861961,1,62845138,62845858,720,audio/Bl122_62845138.jpg,Bl122
4719,2146.022183,2146.074183,1,64380665,64382225,1560,audio/Bl122_64380665.jpg,Bl122
4720,1989.335779,1989.347779,2,59680073,59680433,360,audio/Bl122_59680073.jpg,Bl122
4721,602.331417,602.505417,1,18069942,18075162,5220,audio/Or61_18069942.jpg,Or61
4722,1993.649779,1993.677779,2,59809493,59810333,840,audio/Bl122_59809493.jpg,Bl122
4723,2121.887183,2121.894183,2,63656615,63656825,210,audio/Bl122_63656615.jpg,Bl122
4724,9165.726583,9165.856583,1,274971797,274975697,3900,audio/Li145_274971797.jpg,Li145
4725,15028.899051,15028.984831,1,450866971,450869544,2573,audio/Ti81_450866971.jpg,Ti81
4726,15036.051506,15036.058065,1,451081545,451081741,196,audio/Ti81_451081545.jpg,Ti81
4727,8092.025536,8092.038536,1,242760766,242761156,390,audio/Li145_242760766.jpg,Li145
4728,15070.743682,15070.830682,1,452122310,452124920,2610,audio/Ti81_452122310.jpg,Ti81
4729,2211.158183,2211.164183,2,66334745,66334925,180,audio/Bl122_66334745.jpg,Bl122
4730,1970.190779,1970.427779,1,59105723,59112833,7110,audio/Bl122_59105723.jpg,Bl122
4731,15272.989439,15273.032439,1,458189683,458190973,1290,audio/Ti81_458189683.jpg,Ti81
4732,2085.058961,2085.077961,1,62551768,62552338,570,audio/Bl122_62551768.jpg,Bl122
4733,2188.067183,2188.691183,1,65642015,65660735,18720,audio/Bl122_65642015.jpg,Bl122
4734,1996.890779,1996.922779,1,59906723,59907683,960,audio/Bl122_59906723.jpg,Bl122
4735,716.775271,716.798271,1,21503258,21503948,690,audio/Or61_21503258.jpg,Or61
4736,3548.349648,3548.492447,1,106450489,106454773,4284,audio/Ti81_106450489.jpg,Ti81
4737,14896.458727,14896.677216,1,446893761,446900316,6555,audio/Ti81_446893761.jpg,Ti81
4738,815.722882,815.846882,1,24471686,24475406,3720,audio/Or61_24471686.jpg,Or61
4739,2171.803183,2171.810183,2,65154095,65154305,210,audio/Bl122_65154095.jpg,Bl122
4740,943.847559,944.045359,1,28315426,28321360,5934,audio/Ti81_28315426.jpg,Ti81
4741,2147.338183,2147.344183,2,64420145,64420325,180,audio/Bl122_64420145.jpg,Bl122
4742,2083.765961,2083.777961,2,62512978,62513338,360,audio/Bl122_62512978.jpg,Bl122
4743,1956.548779,1956.603779,2,58696463,58698113,1650,audio/Bl122_58696463.jpg,Bl122
4744,494.347221,494.372221,1,14830416,14831166,750,audio/Or61_14830416.jpg,Or61
4745,1938.004779,1938.012779,2,58140143,58140383,240,audio/Bl122_58140143.jpg,Bl122
4746,621.161417,621.338417,1,18634842,18640152,5310,audio/Or61_18634842.jpg,Or61
4747,767.431271,767.444271,1,23022938,23023328,390,audio/Or61_23022938.jpg,Or61
4748,7531.150966,7531.153966,1,225934528,225934618,90,audio/Li145_225934528.jpg,Li145
4749,701.074271,701.271271,1,21032228,21038138,5910,audio/Or61_21032228.jpg,Or61
4750,15036.493275,15036.541212,1,451094798,451096236,1438,audio/Ti81_451094798.jpg,Ti81
4751,2222.005183,2222.009183,2,66660155,66660275,120,audio/Bl122_66660155.jpg,Bl122
4752,1774.678974,1774.685974,2,53240369,53240579,210,audio/Bl122_53240369.jpg,Bl122
4753,530.089416,530.116416,2,15902682,15903492,810,audio/Or61_15902682.jpg,Or61
4754,2058.598469,2058.621469,1,61757954,61758644,690,audio/Bl122_61757954.jpg,Bl122
4755,5887.330515,5887.361515,1,176619915,176620845,930,audio/Li145_176619915.jpg,Li145
4756,6299.888561,6299.941561,1,188996656,188998246,1590,audio/Li145_188996656.jpg,Li145
4757,794.981827,794.992827,2,23849454,23849784,330,audio/Or61_23849454.jpg,Or61
4758,512.455221,512.499221,1,15373656,15374976,1320,audio/Or61_15373656.jpg,Or61
4759,2057.239469,2057.242469,2,61717184,61717274,90,audio/Bl122_61717184.jpg,Bl122
4760,15047.856966,15047.893966,1,451435708,451436818,1110,audio/Ti81_451435708.jpg,Ti81
4761,490.709221,490.738221,2,14721276,14722146,870,audio/Or61_14721276.jpg,Or61
4762,396.966529,396.969529,2,11908995,11909085,90,audio/Or61_11908995.jpg,Or61
4763,6332.561902,6332.566902,2,189976857,189977007,150,audio/Li145_189976857.jpg,Li145
4764,2130.221183,2130.484183,1,63906635,63914525,7890,audio/Bl122_63906635.jpg,Bl122
4765,1954.121779,1954.174779,2,58623653,58625243,1590,audio/Bl122_58623653.jpg,Bl122
4766,15106.527256,15106.782256,1,453195817,453203467,7650,audio/Ti81_453195817.jpg,Ti81
4767,15264.154392,15264.171079,1,457924631,457925132,501,audio/Ti81_457924631.jpg,Ti81
4768,3438.06845,3438.386595,1,103142053,103151597,9544,audio/Ti81_103142053.jpg,Ti81
4769,2211.986183,2212.108183,1,66359585,66363245,3660,audio/Bl122_66359585.jpg,Bl122
4770,15043.44011,15043.472908,1,451303203,451304187,984,audio/Ti81_451303203.jpg,Ti81
4771,713.189271,713.214271,1,21395678,21396428,750,audio/Or61_21395678.jpg,Or61
4772,15155.827257,15155.883257,1,454674817,454676497,1680,audio/Ti81_454674817.jpg,Ti81
4773,547.659416,547.801416,1,16429782,16434042,4260,audio/Or61_16429782.jpg,Or61
4774,574.51971,574.80371,1,17235591,17244111,8520,audio/Or61_17235591.jpg,Or61
4775,478.486221,478.590221,1,14354586,14357706,3120,audio/Or61_14354586.jpg,Or61
4776,1939.175779,1939.301779,1,58175273,58179053,3780,audio/Bl122_58175273.jpg,Bl122
4777,2115.522183,2115.784183,1,63465665,63473525,7860,audio/Bl122_63465665.jpg,Bl122
4778,631.667417,631.693417,1,18950022,18950802,780,audio/Or61_18950022.jpg,Or61
4779,15027.218005,15027.238945,1,450816540,450817168,628,audio/Ti81_450816540.jpg,Ti81
4780,6332.617902,6332.645902,1,189978537,189979377,840,audio/Li145_189978537.jpg,Li145
4781,6301.393561,6301.397561,2,189041806,189041926,120,audio/Li145_189041806.jpg,Li145
4782,2153.433183,2153.440183,2,64602995,64603205,210,audio/Bl122_64602995.jpg,Bl122
4783,395.765529,395.768529,2,11872965,11873055,90,audio/Or61_11872965.jpg,Or61
4784,15136.998989,15137.143989,1,454109969,454114319,4350,audio/Ti81_454109969.jpg,Ti81
4785,15298.853664,15298.987664,1,458965609,458969629,4020,audio/Ti81_458965609.jpg,Ti81
4786,7243.534974,7243.692974,1,217306049,217310789,4740,audio/Li145_217306049.jpg,Li145
4787,3544.710535,3544.733747,1,106341316,106342012,696,audio/Ti81_106341316.jpg,Ti81
4788,612.616417,612.653417,2,18378492,18379602,1110,audio/Or61_18378492.jpg,Or61
4789,615.387417,615.451417,1,18461622,18463542,1920,audio/Or61_18461622.jpg,Or61
4790,2004.433779,2004.438779,2,60133013,60133163,150,audio/Bl122_60133013.jpg,Bl122
4791,550.745416,550.978416,1,16522362,16529352,6990,audio/Or61_16522362.jpg,Or61
4792,2049.776469,2049.791469,2,61493294,61493744,450,audio/Bl122_61493294.jpg,Bl122
4793,15080.561334,15080.786347,1,452416840,452423590,6750,audio/Ti81_452416840.jpg,Ti81
4794,15296.391664,15296.492664,1,458891749,458894779,3030,audio/Ti81_458891749.jpg,Ti81
4795,609.497417,609.532417,1,18284922,18285972,1050,audio/Or61_18284922.jpg,Or61
4796,1976.842779,1976.875779,1,59305283,59306273,990,audio/Bl122_59305283.jpg,Bl122
4797,2148.269183,2148.339183,1,64448075,64450175,2100,audio/Bl122_64448075.jpg,Bl122
4798,2175.420183,2175.447183,2,65262605,65263415,810,audio/Bl122_65262605.jpg,Bl122
4799,15031.880807,15031.907045,1,450956424,450957211,787,audio/Ti81_450956424.jpg,Ti81
4800,1974.803779,1974.963779,1,59244113,59248913,4800,audio/Bl122_59244113.jpg,Bl122
4801,1954.471779,1954.492779,1,58634153,58634783,630,audio/Bl122_58634153.jpg,Bl122
4802,1792.511115,1792.521115,2,53775333,53775633,300,audio/Bl122_53775333.jpg,Bl122
4803,2069.596469,2069.703469,1,62087894,62091104,3210,audio/Bl122_62087894.jpg,Bl122
4804,2123.797183,2123.811183,2,63713915,63714335,420,audio/Bl122_63713915.jpg,Bl122
4805,2223.933183,2223.947183,2,66717995,66718415,420,audio/Bl122_66717995.jpg,Bl122
4806,511.374221,511.469221,1,15341226,15344076,2850,audio/Or61_15341226.jpg,Or61
4807,1979.257779,1979.280779,2,59377733,59378423,690,audio/Bl122_59377733.jpg,Bl122
4808,1957.840779,1957.867779,2,58735223,58736033,810,audio/Bl122_58735223.jpg,Bl122
4809,633.171417,633.181417,2,18995142,18995442,300,audio/Or61_18995142.jpg,Or61
4810,543.283416,543.300416,1,16298502,16299012,510,audio/Or61_16298502.jpg,Or61
4811,2120.009183,2120.095183,1,63600275,63602855,2580,audio/Bl122_63600275.jpg,Bl122
4812,1788.709115,1788.754115,2,53661273,53662623,1350,audio/Bl122_53661273.jpg,Bl122
4813,607.381417,607.425417,1,18221442,18222762,1320,audio/Or61_18221442.jpg,Or61
4814,15083.7949,15083.9319,1,452513847,452517957,4110,audio/Ti81_452513847.jpg,Ti81
4815,537.713416,537.739416,1,16131402,16132182,780,audio/Or61_16131402.jpg,Or61
4816,498.778221,498.841221,2,14963346,14965236,1890,audio/Or61_14963346.jpg,Or61
4817,1976.906779,1976.965779,1,59307203,59308973,1770,audio/Bl122_59307203.jpg,Bl122
4818,2050.333469,2050.365469,1,61510004,61510964,960,audio/Bl122_61510004.jpg,Bl122
4819,492.387221,492.441221,2,14771616,14773236,1620,audio/Or61_14771616.jpg,Or61
4820,15240.804874,15240.830874,1,457224146,457224926,780,audio/Ti81_457224146.jpg,Ti81
4821,527.886416,527.950416,1,15836592,15838512,1920,audio/Or61_15836592.jpg,Or61
4822,537.168416,537.193416,1,16115052,16115802,750,audio/Or61_16115052.jpg,Or61
4823,2194.006183,2194.011183,2,65820185,65820335,150,audio/Bl122_65820185.jpg,Bl122
4824,2100.122961,2100.126961,2,63003688,63003808,120,audio/Bl122_63003688.jpg,Bl122
4825,2176.429183,2176.526183,1,65292875,65295785,2910,audio/Bl122_65292875.jpg,Bl122
4826,657.682685,657.688685,1,19730480,19730660,180,audio/Li145_19730480.jpg,Li145
4827,15126.646981,15126.743981,1,453799409,453802319,2910,audio/Ti81_453799409.jpg,Ti81
4828,15241.005874,15241.028874,1,457230176,457230866,690,audio/Ti81_457230176.jpg,Ti81
4829,562.325416,562.331416,2,16869762,16869942,180,audio/Or61_16869762.jpg,Or61
4830,500.526221,500.903221,1,15015786,15027096,11310,audio/Or61_15015786.jpg,Or61
4831,2230.393183,2230.408183,2,66911795,66912245,450,audio/Bl122_66911795.jpg,Bl122
4832,924.938002,925.113852,1,27748140,27753415,5275,audio/Ti81_27748140.jpg,Ti81
4833,746.762271,746.802271,1,22402868,22404068,1200,audio/Or61_22402868.jpg,Or61
4834,619.682417,619.699417,1,18590472,18590982,510,audio/Or61_18590472.jpg,Or61
4835,2130.890183,2130.895183,2,63926705,63926855,150,audio/Bl122_63926705.jpg,Bl122
4836,2122.796183,2122.802183,2,63683885,63684065,180,audio/Bl122_63683885.jpg,Bl122
4837,605.032417,605.151417,1,18150972,18154542,3570,audio/Or61_18150972.jpg,Or61
4838,1952.196779,1952.222779,2,58565903,58566683,780,audio/Bl122_58565903.jpg,Bl122
4839,2052.653469,2052.656469,2,61579604,61579694,90,audio/Bl122_61579604.jpg,Bl122
4840,615.229417,615.232417,2,18456882,18456972,90,audio/Or61_18456882.jpg,Or61
4841,2171.998183,2172.014183,2,65159945,65160425,480,audio/Bl122_65159945.jpg,Bl122
4842,2109.996082,2110.030082,1,63299882,63300902,1020,audio/Bl122_63299882.jpg,Bl122
4843,3423.681544,3423.9954,1,102710446,102719862,9416,audio/Ti81_102710446.jpg,Ti81
4844,2185.089183,2185.104183,2,65552675,65553125,450,audio/Bl122_65552675.jpg,Bl122
4845,2107.370377,2107.380377,1,63221111,63221411,300,audio/Bl122_63221111.jpg,Bl122
4846,15343.225971,15343.245971,1,460296779,460297379,600,audio/Ti81_460296779.jpg,Ti81
4847,2130.916183,2130.948183,2,63927485,63928445,960,audio/Bl122_63927485.jpg,Bl122
4848,15124.054981,15124.124981,1,453721649,453723749,2100,audio/Ti81_453721649.jpg,Ti81
4849,15083.6639,15083.7509,1,452509917,452512527,2610,audio/Ti81_452509917.jpg,Ti81
4850,1974.321779,1974.347779,1,59229653,59230433,780,audio/Bl122_59229653.jpg,Bl122
4851,3621.55853,3621.68553,1,108646755,108650565,3810,audio/Li145_108646755.jpg,Li145
4852,497.272221,497.341221,2,14918166,14920236,2070,audio/Or61_14918166.jpg,Or61
4853,794.300827,794.344827,1,23829024,23830344,1320,audio/Or61_23829024.jpg,Or61
4854,2138.443183,2138.471183,2,64153295,64154135,840,audio/Bl122_64153295.jpg,Bl122
4855,15021.259665,15021.289436,1,450637789,450638683,894,audio/Ti81_450637789.jpg,Ti81
4856,14889.46484,14889.490448,1,446683945,446684713,768,audio/Ti81_446683945.jpg,Ti81
4857,1941.155779,1941.291779,1,58234673,58238753,4080,audio/Bl122_58234673.jpg,Bl122
4858,2123.250183,2123.266183,2,63697505,63697985,480,audio/Bl122_63697505.jpg,Bl122
4859,15248.511074,15248.748074,1,457455332,457462442,7110,audio/Ti81_457455332.jpg,Ti81
4860,2032.801469,2032.935469,1,60984044,60988064,4020,audio/Bl122_60984044.jpg,Bl122
4861,627.574417,627.610417,2,18827232,18828312,1080,audio/Or61_18827232.jpg,Or61
4862,719.683271,719.715271,1,21590498,21591458,960,audio/Or61_21590498.jpg,Or61
4863,392.460161,392.526161,1,11773804,11775784,1980,audio/Or61_11773804.jpg,Or61
4864,2096.551961,2096.638961,1,62896558,62899168,2610,audio/Bl122_62896558.jpg,Bl122
4865,1989.957779,1990.025779,1,59698733,59700773,2040,audio/Bl122_59698733.jpg,Bl122
4866,2038.595469,2038.638469,2,61157864,61159154,1290,audio/Bl122_61157864.jpg,Bl122
4867,15151.919716,15151.965716,1,454557591,454558971,1380,audio/Ti81_454557591.jpg,Ti81
4868,1947.203779,1947.209779,2,58416113,58416293,180,audio/Bl122_58416113.jpg,Bl122
4869,2190.057183,2190.071183,2,65701715,65702135,420,audio/Bl122_65701715.jpg,Bl122
4870,746.092271,746.134271,1,22382768,22384028,1260,audio/Or61_22382768.jpg,Or61
4871,2070.848469,2070.917469,1,62125454,62127524,2070,audio/Bl122_62125454.jpg,Bl122
4872,15148.261716,15148.304716,1,454447851,454449141,1290,audio/Ti81_454447851.jpg,Ti81
4873,15157.504257,15157.649257,1,454725127,454729477,4350,audio/Ti81_454725127.jpg,Ti81
4874,2165.459183,2165.467183,2,64963775,64964015,240,audio/Bl122_64963775.jpg,Bl122
4875,2006.830779,2006.911779,1,60204923,60207353,2430,audio/Bl122_60204923.jpg,Bl122
4876,794.028827,794.083827,1,23820864,23822514,1650,audio/Or61_23820864.jpg,Or61
4877,15056.531966,15056.584966,1,451695958,451697548,1590,audio/Ti81_451695958.jpg,Ti81
4878,758.380271,758.422271,1,22751408,22752668,1260,audio/Or61_22751408.jpg,Or61
4879,531.554416,531.675416,1,15946632,15950262,3630,audio/Or61_15946632.jpg,Or61
4880,1976.523779,1976.561779,2,59295713,59296853,1140,audio/Bl122_59295713.jpg,Bl122
4881,2203.469183,2203.633183,1,66104075,66108995,4920,audio/Bl122_66104075.jpg,Bl122
4882,1951.696779,1951.711779,2,58550903,58551353,450,audio/Bl122_58550903.jpg,Bl122
4883,2000.567779,2000.617779,2,60017033,60018533,1500,audio/Bl122_60017033.jpg,Bl122
4884,15266.506358,15266.770358,1,457995190,458003110,7920,audio/Ti81_457995190.jpg,Ti81
4885,789.236827,789.333827,1,23677104,23680014,2910,audio/Or61_23677104.jpg,Or61
4886,658.048685,658.091685,1,19741460,19742750,1290,audio/Li145_19741460.jpg,Li145
4887,705.984271,706.050271,1,21179528,21181508,1980,audio/Or61_21179528.jpg,Or61
4888,2202.405183,2202.409183,2,66072155,66072275,120,audio/Bl122_66072155.jpg,Bl122
4889,211.564765,211.744765,1,6346942,6352342,5400,audio/Or61_6346942.jpg,Or61
4890,2224.091183,2224.134183,1,66722735,66724025,1290,audio/Bl122_66722735.jpg,Bl122
4891,549.293416,549.356416,1,16478802,16480692,1890,audio/Or61_16478802.jpg,Or61
4892,15315.198428,15315.243428,1,459455952,459457302,1350,audio/Ti81_459455952.jpg,Ti81
4893,2169.771183,2170.237183,1,65093135,65107115,13980,audio/Bl122_65093135.jpg,Bl122
4894,2190.627183,2190.751183,1,65718815,65722535,3720,audio/Bl122_65718815.jpg,Bl122
4895,764.670271,764.677271,1,22940108,22940318,210,audio/Or61_22940108.jpg,Or61
4896,15106.391256,15106.520256,1,453191737,453195607,3870,audio/Ti81_453191737.jpg,Ti81
4897,611.900417,611.904417,2,18357012,18357132,120,audio/Or61_18357012.jpg,Or61
4898,5886.970515,5887.058515,1,176609115,176611755,2640,audio/Li145_176609115.jpg,Li145
4899,15020.915912,15020.960064,1,450627477,450628801,1324,audio/Ti81_450627477.jpg,Ti81
4900,554.088416,554.092416,2,16622652,16622772,120,audio/Or61_16622652.jpg,Or61
4901,14888.968102,14889.283818,1,446669043,446678514,9471,audio/Ti81_446669043.jpg,Ti81
4902,2174.000183,2174.199183,1,65220005,65225975,5970,audio/Bl122_65220005.jpg,Bl122
4903,804.006882,804.048882,1,24120206,24121466,1260,audio/Or61_24120206.jpg,Or61
4904,539.600416,539.624416,1,16188012,16188732,720,audio/Or61_16188012.jpg,Or61
4905,1995.231779,1995.285779,1,59856953,59858573,1620,audio/Bl122_59856953.jpg,Bl122
4906,398.035529,398.053529,1,11941065,11941605,540,audio/Or61_11941065.jpg,Or61
4907,2130.022183,2130.025183,2,63900665,63900755,90,audio/Bl122_63900665.jpg,Bl122
4908,2159.501183,2159.521183,1,64785035,64785635,600,audio/Bl122_64785035.jpg,Bl122
4909,2124.497183,2124.509183,2,63734915,63735275,360,audio/Bl122_63734915.jpg,Bl122
4910,757.611271,757.617271,2,22728338,22728518,180,audio/Or61_22728338.jpg,Or61
4911,1795.004115,1795.007115,2,53850123,53850213,90,audio/Bl122_53850123.jpg,Bl122
4912,1989.385779,1989.637779,1,59681573,59689133,7560,audio/Bl122_59681573.jpg,Bl122
4913,2114.395183,2114.536183,1,63431855,63436085,4230,audio/Bl122_63431855.jpg,Bl122
4914,15090.1489,15090.3779,1,452704467,452711337,6870,audio/Ti81_452704467.jpg,Ti81
4915,2048.803469,2048.891469,1,61464104,61466744,2640,audio/Bl122_61464104.jpg,Bl122
4916,2138.801183,2139.069183,1,64164035,64172075,8040,audio/Bl122_64164035.jpg,Bl122
4917,1962.844779,1962.984779,1,58885343,58889543,4200,audio/Bl122_58885343.jpg,Bl122
4918,2000.092779,2000.098779,2,60002783,60002963,180,audio/Bl122_60002783.jpg,Bl122
4919,8739.050692,8739.074692,1,262171520,262172240,720,audio/Li145_262171520.jpg,Li145
4920,2090.072961,2090.173961,1,62702188,62705218,3030,audio/Bl122_62702188.jpg,Bl122
4921,540.974416,541.013416,1,16229232,16230402,1170,audio/Or61_16229232.jpg,Or61
4922,2174.574183,2174.594183,1,65237225,65237825,600,audio/Bl122_65237225.jpg,Bl122
4923,4905.713385,4905.798385,1,147171401,147173951,2550,audio/Li145_147171401.jpg,Li145
4924,1991.742779,1991.753779,2,59752283,59752613,330,audio/Bl122_59752283.jpg,Bl122
4925,2144.684183,2144.859183,1,64340525,64345775,5250,audio/Bl122_64340525.jpg,Bl122
4926,575.67871,575.69571,1,17270361,17270871,510,audio/Or61_17270361.jpg,Or61
4927,15317.109528,15317.328979,1,459513285,459519869,6584,audio/Ti81_459513285.jpg,Ti81
4928,1812.502013,1812.516013,2,54375060,54375480,420,audio/Bl122_54375060.jpg,Bl122
4929,2175.712183,2175.727183,2,65271365,65271815,450,audio/Bl122_65271365.jpg,Bl122
4930,2146.640183,2146.654183,2,64399205,64399625,420,audio/Bl122_64399205.jpg,Bl122
4931,702.616271,702.878271,1,21078488,21086348,7860,audio/Or61_21078488.jpg,Or61
4932,2166.997183,2167.059183,1,65009915,65011775,1860,audio/Bl122_65009915.jpg,Bl122
4933,2136.870183,2137.025183,1,64106105,64110755,4650,audio/Bl122_64106105.jpg,Bl122
4934,2216.706183,2216.710183,2,66501185,66501305,120,audio/Bl122_66501185.jpg,Bl122
4935,15073.063682,15073.295682,1,452191910,452198870,6960,audio/Ti81_452191910.jpg,Ti81
4936,9165.141583,9165.223583,1,274954247,274956707,2460,audio/Li145_274954247.jpg,Li145
4937,2050.207469,2050.245469,1,61506224,61507364,1140,audio/Bl122_61506224.jpg,Bl122
4938,635.663417,635.854417,1,19069902,19075632,5730,audio/Or61_19069902.jpg,Or61
4939,2165.086183,2165.090183,2,64952585,64952705,120,audio/Bl122_64952585.jpg,Bl122
4940,609.008417,609.040417,2,18270252,18271212,960,audio/Or61_18270252.jpg,Or61
4941,728.082271,728.089271,2,21842468,21842678,210,audio/Or61_21842468.jpg,Or61
4942,1945.286779,1945.448779,1,58358603,58363463,4860,audio/Bl122_58358603.jpg,Bl122
4943,606.263417,606.330417,1,18187902,18189912,2010,audio/Or61_18187902.jpg,Or61
4944,2033.121469,2033.127469,2,60993644,60993824,180,audio/Bl122_60993644.jpg,Bl122
4945,6956.893877,6956.898877,1,208706816,208706966,150,audio/Li145_208706816.jpg,Li145
4946,1938.819779,1938.831779,2,58164593,58164953,360,audio/Bl122_58164593.jpg,Bl122
4947,810.155882,810.195882,1,24304676,24305876,1200,audio/Or61_24304676.jpg,Or61
4948,795.989827,796.048827,1,23879694,23881464,1770,audio/Or61_23879694.jpg,Or61
4949,2160.018183,2160.025183,2,64800545,64800755,210,audio/Bl122_64800545.jpg,Bl122
4950,817.090724,817.281724,1,24512721,24518451,5730,audio/Bl122_24512721.jpg,Bl122
4951,2127.438183,2127.441183,2,63823145,63823235,90,audio/Bl122_63823145.jpg,Bl122
4952,2071.199469,2071.235469,2,62135984,62137064,1080,audio/Bl122_62135984.jpg,Bl122
4953,1963.254779,1963.258779,2,58897643,58897763,120,audio/Bl122_58897643.jpg,Bl122
4954,713.074271,713.187271,1,21392228,21395618,3390,audio/Or61_21392228.jpg,Or61
4955,2183.970183,2184.073183,1,65519105,65522195,3090,audio/Bl122_65519105.jpg,Bl122
4956,2046.509469,2046.560469,1,61395284,61396814,1530,audio/Bl122_61395284.jpg,Bl122
4957,925.34445,925.381033,1,27760333,27761430,1097,audio/Ti81_27760333.jpg,Ti81
4958,2160.798183,2160.962183,1,64823945,64828865,4920,audio/Bl122_64823945.jpg,Bl122
4959,7545.740781,7545.951781,1,226372223,226378553,6330,audio/Li145_226372223.jpg,Li145
4960,2151.019183,2151.037183,2,64530575,64531115,540,audio/Bl122_64530575.jpg,Bl122
4961,1945.935779,1945.947779,2,58378073,58378433,360,audio/Bl122_58378073.jpg,Bl122
4962,264.846507,264.930507,1,7945395,7947915,2520,audio/Or61_7945395.jpg,Or61
4963,183.025971,183.041971,1,5490779,5491259,480,audio/Or61_5490779.jpg,Or61
4964,2054.856469,2054.869469,1,61645694,61646084,390,audio/Bl122_61645694.jpg,Bl122
4965,6333.384902,6333.400902,1,190001547,190002027,480,audio/Li145_190001547.jpg,Li145
4966,1804.76505,1804.79105,1,54142951,54143731,780,audio/Bl122_54142951.jpg,Bl122
4967,486.426221,486.448221,1,14592786,14593446,660,audio/Or61_14592786.jpg,Or61
4968,403.841692,404.046692,1,12115250,12121400,6150,audio/Or61_12115250.jpg,Or61
4969,512.829221,512.974221,1,15384876,15389226,4350,audio/Or61_15384876.jpg,Or61
4970,5721.282018,5721.312018,1,171638460,171639360,900,audio/Li145_171638460.jpg,Li145
4971,626.569417,626.587417,2,18797082,18797622,540,audio/Or61_18797082.jpg,Or61
4972,2169.631183,2169.687183,1,65088935,65090615,1680,audio/Bl122_65088935.jpg,Bl122
4973,2044.991469,2044.996469,2,61349744,61349894,150,audio/Bl122_61349744.jpg,Bl122
4974,15091.0589,15091.3789,1,452731767,452741367,9600,audio/Ti81_452731767.jpg,Ti81
4975,579.90171,579.92471,2,17397051,17397741,690,audio/Or61_17397051.jpg,Or61
4976,1955.566779,1955.612779,1,58667003,58668383,1380,audio/Bl122_58667003.jpg,Bl122
4977,423.835593,423.919593,1,12715067,12717587,2520,audio/Or61_12715067.jpg,Or61
4978,816.526882,816.533882,2,24495806,24496016,210,audio/Or61_24495806.jpg,Or61
4979,502.654221,502.661221,2,15079626,15079836,210,audio/Or61_15079626.jpg,Or61
4980,15329.528625,15329.598625,1,459885858,459887958,2100,audio/Ti81_459885858.jpg,Ti81
4981,15212.38258,15212.572594,1,456371477,456377177,5700,audio/Ti81_456371477.jpg,Ti81
4982,551.575416,551.903416,1,16547262,16557102,9840,audio/Or61_16547262.jpg,Or61
4983,3584.437686,3584.511686,1,107533130,107535350,2220,audio/Li145_107533130.jpg,Li145
4984,541.429416,541.455416,1,16242882,16243662,780,audio/Or61_16242882.jpg,Or61
4985,2205.754183,2205.894183,1,66172625,66176825,4200,audio/Bl122_66172625.jpg,Bl122
4986,15063.775966,15063.792966,1,451913278,451913788,510,audio/Ti81_451913278.jpg,Ti81
4987,15299.126664,15299.189664,1,458973799,458975689,1890,audio/Ti81_458973799.jpg,Ti81
4988,2166.790183,2166.860183,1,65003705,65005805,2100,audio/Bl122_65003705.jpg,Bl122
4989,730.478271,730.500271,1,21914348,21915008,660,audio/Or61_21914348.jpg,Or61
4990,720.929271,720.941271,2,21627878,21628238,360,audio/Or61_21627878.jpg,Or61
4991,179.881971,179.928971,1,5396459,5397869,1410,audio/Or61_5396459.jpg,Or61
4992,9167.996583,9168.005583,1,275039897,275040167,270,audio/Li145_275039897.jpg,Li145
4993,15262.612358,15262.683358,1,457878370,457880500,2130,audio/Ti81_457878370.jpg,Ti81
4994,1961.766779,1961.771779,2,58853003,58853153,150,audio/Bl122_58853003.jpg,Bl122
4995,605.224417,605.274417,2,18156732,18158232,1500,audio/Or61_18156732.jpg,Or61
4996,2223.669183,2223.698183,2,66710075,66710945,870,audio/Bl122_66710075.jpg,Bl122
4997,762.788271,762.803271,1,22883648,22884098,450,audio/Or61_22883648.jpg,Or61
4998,183.053971,183.063971,1,5491619,5491919,300,audio/Or61_5491619.jpg,Or61
4999,2192.470183,2192.473183,2,65774105,65774195,90,audio/Bl122_65774105.jpg,Bl122
5000,6533.305227,6533.461227,1,195999156,196003836,4680,audio/Li145_195999156.jpg,Li145
5001,530.784416,530.788416,2,15923532,15923652,120,audio/Or61_15923532.jpg,Or61
5002,15043.29731,15043.404031,1,451298919,451302120,3201,audio/Ti81_451298919.jpg,Ti81
5003,3.548816,3.560816,2,106464,106824,360,audio/Or61_106464.jpg,Or61
5004,2142.169183,2142.356183,1,64265075,64270685,5610,audio/Bl122_64265075.jpg,Bl122
5005,718.697271,718.882271,1,21560918,21566468,5550,audio/Or61_21560918.jpg,Or61
5006,2150.411183,2150.414183,2,64512335,64512425,90,audio/Bl122_64512335.jpg,Bl122
5007,517.358221,517.362221,2,15520746,15520866,120,audio/Or61_15520746.jpg,Or61
5008,1950.449779,1950.452779,2,58513493,58513583,90,audio/Bl122_58513493.jpg,Bl122
5009,1950.462779,1950.484779,1,58513883,58514543,660,audio/Bl122_58513883.jpg,Bl122
5010,768.189271,768.259271,1,23045678,23047778,2100,audio/Or61_23045678.jpg,Or61
5011,809.460882,809.472882,2,24283826,24284186,360,audio/Or61_24283826.jpg,Or61
5012,844.542484,844.71026,1,25336274,25341307,5033,audio/Ti81_25336274.jpg,Ti81
5013,747.615271,747.661271,1,22428458,22429838,1380,audio/Or61_22428458.jpg,Or61
5014,1970.177779,1970.181779,2,59105333,59105453,120,audio/Bl122_59105333.jpg,Bl122
5015,770.859271,770.862271,2,23125778,23125868,90,audio/Or61_23125778.jpg,Or61
5016,770.368271,770.485271,1,23111048,23114558,3510,audio/Or61_23111048.jpg,Or61
5017,1959.144779,1959.171779,1,58774343,58775153,810,audio/Bl122_58774343.jpg,Bl122
5018,735.821271,736.033271,1,22074638,22080998,6360,audio/Or61_22074638.jpg,Or61
5019,2140.407183,2140.419183,2,64212215,64212575,360,audio/Bl122_64212215.jpg,Bl122
5020,1939.161779,1939.169779,2,58174853,58175093,240,audio/Bl122_58174853.jpg,Bl122
5021,747.214271,747.227271,1,22416428,22416818,390,audio/Or61_22416428.jpg,Or61
5022,385.437161,385.559161,1,11563114,11566774,3660,audio/Or61_11563114.jpg,Or61
5023,1939.500779,1939.604779,2,58185023,58188143,3120,audio/Bl122_58185023.jpg,Bl122
5024,626.589417,626.613417,2,18797682,18798402,720,audio/Or61_18797682.jpg,Or61
5025,2141.368183,2141.413183,2,64241045,64242395,1350,audio/Bl122_64241045.jpg,Bl122
5026,750.908271,750.917271,1,22527248,22527518,270,audio/Or61_22527248.jpg,Or61
5027,2066.748469,2066.784469,1,62002454,62003534,1080,audio/Bl122_62002454.jpg,Bl122
5028,15080.871802,15081.065682,1,452426154,452431970,5816,audio/Ti81_452426154.jpg,Ti81
5029,6286.493659,6286.587659,1,188594809,188597629,2820,audio/Li145_188594809.jpg,Li145
5030,1984.998779,1985.000779,2,59549963,59550023,60,audio/Bl122_59549963.jpg,Bl122
5031,15088.2059,15088.4139,1,452646177,452652417,6240,audio/Ti81_452646177.jpg,Ti81
5032,15204.74858,15204.87858,1,456142457,456146357,3900,audio/Ti81_456142457.jpg,Ti81
5033,752.149271,752.160271,1,22564478,22564808,330,audio/Or61_22564478.jpg,Or61
5034,15055.497966,15055.623966,1,451664938,451668718,3780,audio/Ti81_451664938.jpg,Ti81
5035,1938.788779,1938.793779,2,58163663,58163813,150,audio/Bl122_58163663.jpg,Bl122
5036,8083.272803,8083.288803,2,242498184,242498664,480,audio/Li145_242498184.jpg,Li145
5037,941.327883,941.488091,1,28239836,28244642,4806,audio/Ti81_28239836.jpg,Ti81
5038,2013.270959,2013.303959,2,60398128,60399118,990,audio/Bl122_60398128.jpg,Bl122
5039,622.864417,622.944417,1,18685932,18688332,2400,audio/Or61_18685932.jpg,Or61
5040,6339.080837,6339.092837,1,190172425,190172785,360,audio/Li145_190172425.jpg,Li145
5041,3545.685153,3545.890522,1,106370554,106376715,6161,audio/Ti81_106370554.jpg,Ti81
5042,2168.552183,2168.654183,1,65056565,65059625,3060,audio/Bl122_65056565.jpg,Bl122
5043,2039.920815,2039.932815,1,61197624,61197984,360,audio/Li145_61197624.jpg,Li145
5044,2125.354183,2125.547183,1,63760625,63766415,5790,audio/Bl122_63760625.jpg,Bl122
5045,1969.709779,1969.977779,1,59091293,59099333,8040,audio/Bl122_59091293.jpg,Bl122
5046,15127.508981,15127.649981,1,453825269,453829499,4230,audio/Ti81_453825269.jpg,Ti81
5047,5842.455404,5842.535404,1,175273662,175276062,2400,audio/Li145_175273662.jpg,Li145
5048,15218.82158,15219.20658,1,456564647,456576197,11550,audio/Ti81_456564647.jpg,Ti81
5049,15117.665981,15117.791981,1,453529979,453533759,3780,audio/Ti81_453529979.jpg,Ti81
5050,562.619416,562.695416,1,16878582,16880862,2280,audio/Or61_16878582.jpg,Or61
5051,483.428221,483.463221,2,14502846,14503896,1050,audio/Or61_14502846.jpg,Or61
5052,2076.277823,2076.423823,1,62288334,62292714,4380,audio/Bl122_62288334.jpg,Bl122
5053,1938.937779,1939.013779,2,58168133,58170413,2280,audio/Bl122_58168133.jpg,Bl122
5054,556.742416,556.769416,1,16702272,16703082,810,audio/Or61_16702272.jpg,Or61
5055,547.370416,547.407416,1,16421112,16422222,1110,audio/Or61_16421112.jpg,Or61
5056,406.614692,406.617692,2,12198440,12198530,90,audio/Or61_12198440.jpg,Or61
5057,1787.418115,1787.606115,1,53622543,53628183,5640,audio/Bl122_53622543.jpg,Bl122
5058,15047.330966,15047.359966,1,451419928,451420798,870,audio/Ti81_451419928.jpg,Ti81
5059,2213.675183,2213.694183,2,66410255,66410825,570,audio/Bl122_66410255.jpg,Bl122
5060,15232.345443,15232.666443,1,456970363,456979993,9630,audio/Ti81_456970363.jpg,Ti81
5061,1942.014779,1942.026779,2,58260443,58260803,360,audio/Bl122_58260443.jpg,Bl122
5062,15136.141536,15136.364989,1,454084246,454090949,6703,audio/Ti81_454084246.jpg,Ti81
5063,3580.353097,3580.438097,1,107410592,107413142,2550,audio/Li145_107410592.jpg,Li145
5064,247.249316,247.302316,1,7417479,7419069,1590,audio/Or61_7417479.jpg,Or61
5065,5873.066637,5873.081637,1,176191999,176192449,450,audio/Li145_176191999.jpg,Li145
5066,2225.183183,2225.299183,1,66755495,66758975,3480,audio/Bl122_66755495.jpg,Bl122
5067,530.573416,530.611416,2,15917202,15918342,1140,audio/Or61_15917202.jpg,Or61
5068,1991.312779,1991.318779,2,59739383,59739563,180,audio/Bl122_59739383.jpg,Bl122
5069,554.684416,554.686416,2,16640532,16640592,60,audio/Or61_16640532.jpg,Or61
5070,1975.562779,1975.568779,2,59266883,59267063,180,audio/Bl122_59266883.jpg,Bl122
5071,8865.113987,8865.118987,1,265953419,265953569,150,audio/Li145_265953419.jpg,Li145
5072,1770.760657,1770.789657,1,53122819,53123689,870,audio/Bl122_53122819.jpg,Bl122
5073,2144.302183,2144.311183,2,64329065,64329335,270,audio/Bl122_64329065.jpg,Bl122
5074,728.941271,728.949271,1,21868238,21868478,240,audio/Or61_21868238.jpg,Or61
5075,15117.077981,15117.100981,1,453512339,453513029,690,audio/Ti81_453512339.jpg,Ti81
5076,15127.879981,15127.955981,1,453836399,453838679,2280,audio/Ti81_453836399.jpg,Ti81
5077,762.725271,762.733271,2,22881758,22881998,240,audio/Or61_22881758.jpg,Or61
5078,14902.373294,14902.386161,1,447071198,447071584,386,audio/Ti81_447071198.jpg,Ti81
5079,1970.990779,1971.002779,2,59129723,59130083,360,audio/Bl122_59129723.jpg,Bl122
5080,2146.467183,2146.475183,2,64394015,64394255,240,audio/Bl122_64394015.jpg,Bl122
5081,183.858971,183.866971,2,5515769,5516009,240,audio/Or61_5515769.jpg,Or61
5082,8740.439692,8740.448692,1,262213190,262213460,270,audio/Li145_262213190.jpg,Li145
5083,551.140416,551.233416,1,16534212,16537002,2790,audio/Or61_16534212.jpg,Or61
5084,3439.363736,3439.387704,1,103180912,103181631,719,audio/Ti81_103180912.jpg,Ti81
5085,6286.259659,6286.355659,1,188587789,188590669,2880,audio/Li145_188587789.jpg,Li145
5086,743.143271,743.228271,1,22294298,22296848,2550,audio/Or61_22294298.jpg,Or61
5087,1943.828779,1943.843779,2,58314863,58315313,450,audio/Bl122_58314863.jpg,Bl122
5088,1940.831779,1940.845779,2,58224953,58225373,420,audio/Bl122_58224953.jpg,Bl122
5089,736.875271,736.912271,1,22106258,22107368,1110,audio/Or61_22106258.jpg,Or61
5090,15215.16858,15215.21958,1,456455057,456456587,1530,audio/Ti81_456455057.jpg,Ti81
5091,315.246631,315.310631,1,9457398,9459318,1920,audio/Or61_9457398.jpg,Or61
5092,2177.538183,2177.579183,2,65326145,65327375,1230,audio/Bl122_65326145.jpg,Bl122
5093,15119.398981,15119.452981,1,453581969,453583589,1620,audio/Ti81_453581969.jpg,Ti81
5094,15094.218823,15094.250823,1,452826564,452827524,960,audio/Ti81_452826564.jpg,Ti81
5095,4920.837507,4921.074507,1,147625125,147632235,7110,audio/Li145_147625125.jpg,Li145
5096,2053.451469,2053.486469,1,61603544,61604594,1050,audio/Bl122_61603544.jpg,Bl122
5097,710.819271,710.938271,1,21324578,21328148,3570,audio/Or61_21324578.jpg,Or61
5098,15079.102682,15079.287682,1,452373080,452378630,5550,audio/Ti81_452373080.jpg,Ti81
5099,563.513416,563.574416,1,16905402,16907232,1830,audio/Or61_16905402.jpg,Or61
5100,8083.134803,8083.163803,2,242494044,242494914,870,audio/Li145_242494044.jpg,Li145
5101,15039.16824,15039.194169,1,451175047,451175825,778,audio/Ti81_451175047.jpg,Ti81
5102,762.990271,762.993271,2,22889708,22889798,90,audio/Or61_22889708.jpg,Or61
5103,15227.858443,15228.301443,1,456835753,456849043,13290,audio/Ti81_456835753.jpg,Ti81
5104,499.446221,499.696221,1,14983386,14990886,7500,audio/Or61_14983386.jpg,Or61
5105,764.876271,764.889271,1,22946288,22946678,390,audio/Or61_22946288.jpg,Or61
5106,2153.155183,2153.164183,2,64594655,64594925,270,audio/Bl122_64594655.jpg,Bl122
5107,15315.881428,15316.188428,1,459476442,459485652,9210,audio/Ti81_459476442.jpg,Ti81
5108,2159.206183,2159.214183,2,64776185,64776425,240,audio/Bl122_64776185.jpg,Bl122
5109,601.909417,601.931417,1,18057282,18057942,660,audio/Or61_18057282.jpg,Or61
5110,15125.279981,15125.324981,1,453758399,453759749,1350,audio/Ti81_453758399.jpg,Ti81
5111,766.096271,766.138271,1,22982888,22984148,1260,audio/Or61_22982888.jpg,Or61
5112,1946.205779,1946.242779,2,58386173,58387283,1110,audio/Bl122_58386173.jpg,Bl122
5113,1788.784115,1788.789115,2,53663523,53663673,150,audio/Bl122_53663523.jpg,Bl122
5114,15030.199256,15030.234578,1,450905977,450907037,1060,audio/Ti81_450905977.jpg,Ti81
5115,15077.057682,15077.103721,1,452311730,452313111,1381,audio/Ti81_452311730.jpg,Ti81
5116,15249.296074,15249.476074,1,457478882,457484282,5400,audio/Ti81_457478882.jpg,Ti81
5117,15328.746625,15328.803625,1,459862398,459864108,1710,audio/Ti81_459862398.jpg,Ti81
5118,2123.186183,2123.247183,1,63695585,63697415,1830,audio/Bl122_63695585.jpg,Bl122
5119,2213.393183,2213.558183,1,66401795,66406745,4950,audio/Bl122_66401795.jpg,Bl122
5120,1978.756779,1978.761779,2,59362703,59362853,150,audio/Bl122_59362703.jpg,Bl122
5121,770.941271,770.952271,2,23128238,23128568,330,audio/Or61_23128238.jpg,Or61
5122,509.403221,509.810221,1,15282096,15294306,12210,audio/Or61_15282096.jpg,Or61
5123,2147.539183,2147.542183,2,64426175,64426265,90,audio/Bl122_64426175.jpg,Bl122
5124,478.612221,478.735221,1,14358366,14362056,3690,audio/Or61_14358366.jpg,Or61
5125,488.864221,488.871221,2,14665926,14666136,210,audio/Or61_14665926.jpg,Or61
5126,6953.509285,6953.595285,1,208605278,208607858,2580,audio/Li145_208605278.jpg,Li145
5127,3429.634207,3429.660446,1,102889026,102889813,787,audio/Ti81_102889026.jpg,Ti81
5128,2088.009961,2088.151961,1,62640298,62644558,4260,audio/Bl122_62640298.jpg,Bl122
5129,2059.351469,2059.400469,2,61780544,61782014,1470,audio/Bl122_61780544.jpg,Bl122
5130,2209.482183,2209.693183,1,66284465,66290795,6330,audio/Bl122_66284465.jpg,Bl122
5131,15027.064924,15027.208859,1,450811947,450816265,4318,audio/Ti81_450811947.jpg,Ti81
5132,2125.883183,2125.899183,2,63776495,63776975,480,audio/Bl122_63776495.jpg,Bl122
5133,1969.439779,1969.525779,2,59083193,59085773,2580,audio/Bl122_59083193.jpg,Bl122
5134,2056.653469,2056.702469,1,61699604,61701074,1470,audio/Bl122_61699604.jpg,Bl122
5135,15274.528439,15274.796439,1,458235853,458243893,8040,audio/Ti81_458235853.jpg,Ti81
5136,482.350221,482.378221,1,14470506,14471346,840,audio/Or61_14470506.jpg,Or61
5137,386.062161,386.136161,1,11581864,11584084,2220,audio/Or61_11581864.jpg,Or61
5138,3445.686769,3446.017024,1,103370603,103380510,9907,audio/Ti81_103370603.jpg,Ti81
5139,554.185416,554.449416,1,16625562,16633482,7920,audio/Or61_16625562.jpg,Or61
5140,2226.930183,2227.057183,1,66807905,66811715,3810,audio/Bl122_66807905.jpg,Bl122
5141,1972.817779,1972.884779,1,59184533,59186543,2010,audio/Bl122_59184533.jpg,Bl122
5142,2048.781469,2048.798469,1,61463444,61463954,510,audio/Bl122_61463444.jpg,Bl122
5143,2047.039469,2047.056469,2,61411184,61411694,510,audio/Bl122_61411184.jpg,Bl122
5144,2136.060183,2136.072183,1,64081805,64082165,360,audio/Bl122_64081805.jpg,Bl122
5145,2069.293469,2069.315469,1,62078804,62079464,660,audio/Bl122_62078804.jpg,Bl122
5146,15251.497074,15251.690074,1,457544912,457550702,5790,audio/Ti81_457544912.jpg,Ti81
5147,1941.310779,1941.314779,2,58239323,58239443,120,audio/Bl122_58239323.jpg,Bl122
5148,1977.604779,1977.608779,2,59328143,59328263,120,audio/Bl122_59328143.jpg,Bl122
5149,5842.905404,5842.930404,1,175287162,175287912,750,audio/Li145_175287162.jpg,Li145
5150,15072.707682,15072.743682,1,452181230,452182310,1080,audio/Ti81_452181230.jpg,Ti81
5151,2004.723779,2004.824779,1,60141713,60144743,3030,audio/Bl122_60141713.jpg,Bl122
5152,390.332161,390.398161,1,11709964,11711944,1980,audio/Or61_11709964.jpg,Or61
5153,15049.595966,15049.661966,1,451487878,451489858,1980,audio/Ti81_451487878.jpg,Ti81
5154,2133.889183,2133.894183,2,64016675,64016825,150,audio/Bl122_64016675.jpg,Bl122
5155,546.612416,546.881416,1,16398372,16406442,8070,audio/Or61_16398372.jpg,Or61
5156,1945.739779,1945.810779,1,58372193,58374323,2130,audio/Bl122_58372193.jpg,Bl122
5157,2116.620183,2116.689183,1,63498605,63500675,2070,audio/Bl122_63498605.jpg,Bl122
5158,1962.366779,1962.375779,2,58871003,58871273,270,audio/Bl122_58871003.jpg,Bl122
5159,790.164827,790.175827,2,23704944,23705274,330,audio/Or61_23704944.jpg,Or61
5160,15262.461358,15262.482358,1,457873840,457874470,630,audio/Ti81_457873840.jpg,Ti81
5161,2116.894183,2117.010183,1,63506825,63510305,3480,audio/Bl122_63506825.jpg,Bl122
5162,2180.756183,2180.925183,1,65422685,65427755,5070,audio/Bl122_65422685.jpg,Bl122
5163,730.085271,730.096271,1,21902558,21902888,330,audio/Or61_21902558.jpg,Or61
5164,423.252081,423.455081,1,12697562,12703652,6090,audio/Or61_12697562.jpg,Or61
5165,15032.436362,15032.473323,1,450973090,450974199,1109,audio/Ti81_450973090.jpg,Ti81
5166,2107.351377,2107.361377,1,63220541,63220841,300,audio/Bl122_63220541.jpg,Bl122
5167,747.160271,747.166271,2,22414808,22414988,180,audio/Or61_22414808.jpg,Or61
5168,15053.339966,15053.511966,1,451600198,451605358,5160,audio/Ti81_451600198.jpg,Ti81
5169,2162.990183,2163.004183,2,64889705,64890125,420,audio/Bl122_64889705.jpg,Bl122
5170,2210.134183,2210.147183,2,66304025,66304415,390,audio/Bl122_66304025.jpg,Bl122
5171,5911.251207,5911.368207,1,177337536,177341046,3510,audio/Li145_177337536.jpg,Li145
5172,1975.104779,1975.143779,2,59253143,59254313,1170,audio/Bl122_59253143.jpg,Bl122
5173,1951.724779,1951.755779,1,58551743,58552673,930,audio/Bl122_58551743.jpg,Bl122
5174,6956.778877,6956.786877,1,208703366,208703606,240,audio/Li145_208703366.jpg,Li145
5175,274.872163,274.952163,1,8246164,8248564,2400,audio/Or61_8246164.jpg,Or61
5176,6333.411902,6333.436902,1,190002357,190003107,750,audio/Li145_190002357.jpg,Li145
5177,797.956827,797.964827,2,23938704,23938944,240,audio/Or61_23938704.jpg,Or61
5178,15216.52158,15216.63858,1,456495647,456499157,3510,audio/Ti81_456495647.jpg,Ti81
5179,762.627271,762.659271,2,22878818,22879778,960,audio/Or61_22878818.jpg,Or61
5180,2202.493183,2202.499183,2,66074795,66074975,180,audio/Bl122_66074795.jpg,Bl122
5181,2165.472183,2165.477183,2,64964165,64964315,150,audio/Bl122_64964165.jpg,Bl122
5182,1992.134779,1992.147779,1,59764043,59764433,390,audio/Bl122_59764043.jpg,Bl122
5183,2118.310183,2118.397183,1,63549305,63551915,2610,audio/Bl122_63549305.jpg,Bl122
5184,2165.481183,2165.545183,2,64964435,64966355,1920,audio/Bl122_64964435.jpg,Bl122
5185,724.656271,724.859271,1,21739688,21745778,6090,audio/Or61_21739688.jpg,Or61
5186,1798.292115,1798.467115,1,53948763,53954013,5250,audio/Bl122_53948763.jpg,Bl122
5187,528.866416,528.886416,2,15865992,15866592,600,audio/Or61_15865992.jpg,Or61
5188,2000.640779,2000.653779,2,60019223,60019613,390,audio/Bl122_60019223.jpg,Bl122
5189,3421.827802,3421.835875,1,102654834,102655076,242,audio/Ti81_102654834.jpg,Ti81
5190,392.859161,393.030161,1,11785774,11790904,5130,audio/Or61_11785774.jpg,Or61
5191,727.961271,727.976271,1,21838838,21839288,450,audio/Or61_21838838.jpg,Or61
5192,746.376271,746.418271,1,22391288,22392548,1260,audio/Or61_22391288.jpg,Or61
5193,760.766271,760.769271,2,22822988,22823078,90,audio/Or61_22822988.jpg,Or61
5194,2203.979183,2204.034183,1,66119375,66121025,1650,audio/Bl122_66119375.jpg,Bl122
5195,792.434827,792.437827,2,23773044,23773134,90,audio/Or61_23773044.jpg,Or61
5196,757.849271,757.922271,1,22735478,22737668,2190,audio/Or61_22735478.jpg,Or61
5197,848.575682,848.74371,1,25457270,25462311,5041,audio/Ti81_25457270.jpg,Ti81
5198,735.222271,735.241271,1,22056668,22057238,570,audio/Or61_22056668.jpg,Or61
5199,8864.264987,8864.278987,1,265927949,265928369,420,audio/Li145_265927949.jpg,Li145
5200,2216.720183,2216.942183,1,66501605,66508265,6660,audio/Bl122_66501605.jpg,Bl122
5201,15070.837682,15070.860682,1,452125130,452125820,690,audio/Ti81_452125130.jpg,Ti81
5202,180.554971,180.725971,1,5416649,5421779,5130,audio/Or61_5416649.jpg,Or61
5203,15021.110306,15021.240869,1,450633309,450637226,3917,audio/Ti81_450633309.jpg,Ti81
5204,2223.083183,2223.144183,2,66692495,66694325,1830,audio/Bl122_66692495.jpg,Bl122
5205,2095.609961,2095.808961,1,62868298,62874268,5970,audio/Bl122_62868298.jpg,Bl122
5206,1955.397779,1955.416779,1,58661933,58662503,570,audio/Bl122_58661933.jpg,Bl122
5207,2182.340183,2182.534183,1,65470205,65476025,5820,audio/Bl122_65470205.jpg,Bl122
5208,199.741012,199.771012,1,5992230,5993130,900,audio/Or61_5992230.jpg,Or61
5209,1953.259779,1953.266779,2,58597793,58598003,210,audio/Bl122_58597793.jpg,Bl122
5210,771.358271,771.363271,2,23140748,23140898,150,audio/Or61_23140748.jpg,Or61
5211,4578.223964,4578.34002,1,137346718,137350200,3482,audio/Ti81_137346718.jpg,Ti81
5212,1798.981115,1798.991115,2,53969433,53969733,300,audio/Bl122_53969433.jpg,Bl122
5213,473.299221,473.356221,1,14198976,14200686,1710,audio/Or61_14198976.jpg,Or61
5214,3416.033328,3416.096276,1,102480999,102482888,1889,audio/Ti81_102480999.jpg,Ti81
5215,1941.462779,1941.467779,2,58243883,58244033,150,audio/Bl122_58243883.jpg,Bl122
5216,2051.943469,2052.063469,1,61558304,61561904,3600,audio/Bl122_61558304.jpg,Bl122
5217,1800.625115,1800.667115,2,54018753,54020013,1260,audio/Bl122_54018753.jpg,Bl122
5218,15063.217966,15063.364966,1,451896538,451900948,4410,audio/Ti81_451896538.jpg,Ti81
5219,15111.215256,15111.467256,1,453336457,453344017,7560,audio/Ti81_453336457.jpg,Ti81
5220,2080.747287,2080.974287,1,62422418,62429228,6810,audio/Bl122_62422418.jpg,Bl122
5221,2083.696961,2083.702961,2,62510908,62511088,180,audio/Bl122_62510908.jpg,Bl122
5222,529.506416,529.683416,1,15885192,15890502,5310,audio/Or61_15885192.jpg,Or61
5223,2163.134183,2163.352183,1,64894025,64900565,6540,audio/Bl122_64894025.jpg,Bl122
5224,15304.868373,15304.935373,1,459146051,459148061,2010,audio/Ti81_459146051.jpg,Ti81
5225,1937.734779,1937.742779,2,58132043,58132283,240,audio/Bl122_58132043.jpg,Bl122
5226,816.789882,816.904882,1,24503696,24507146,3450,audio/Or61_24503696.jpg,Or61
5227,2065.740469,2065.798469,1,61972214,61973954,1740,audio/Bl122_61972214.jpg,Bl122
5228,487.777221,487.781221,2,14633316,14633436,120,audio/Or61_14633316.jpg,Or61
5229,6956.788877,6956.800877,1,208703666,208704026,360,audio/Li145_208703666.jpg,Li145
5230,15327.816625,15327.843625,1,459834498,459835308,810,audio/Ti81_459834498.jpg,Ti81
5231,2187.300183,2187.507183,1,65619005,65625215,6210,audio/Bl122_65619005.jpg,Bl122
5232,2057.518469,2057.568469,1,61725554,61727054,1500,audio/Bl122_61725554.jpg,Bl122
5233,15207.18058,15207.21558,1,456215417,456216467,1050,audio/Ti81_456215417.jpg,Ti81
5234,15059.183966,15059.223966,1,451775518,451776718,1200,audio/Ti81_451775518.jpg,Ti81
5235,15139.008989,15139.031989,1,454170269,454170959,690,audio/Ti81_454170269.jpg,Ti81
5236,812.869882,812.946882,1,24386096,24388406,2310,audio/Or61_24386096.jpg,Or61
5237,2088.353961,2088.363961,2,62650618,62650918,300,audio/Bl122_62650618.jpg,Bl122
5238,15314.298428,15314.348428,1,459428952,459430452,1500,audio/Ti81_459428952.jpg,Ti81
5239,3.223816,3.506816,1,96714,105204,8490,audio/Or61_96714.jpg,Or61
5240,608.935417,608.959417,1,18268062,18268782,720,audio/Or61_18268062.jpg,Or61
5241,790.196827,790.204827,2,23705904,23706144,240,audio/Or61_23705904.jpg,Or61
5242,815.258882,815.262882,2,24457766,24457886,120,audio/Or61_24457766.jpg,Or61
5243,15164.520257,15164.579257,1,454935607,454937377,1770,audio/Ti81_454935607.jpg,Ti81
5244,1938.895779,1938.907779,1,58166873,58167233,360,audio/Bl122_58166873.jpg,Bl122
5245,15318.306428,15318.341428,1,459549192,459550242,1050,audio/Ti81_459549192.jpg,Ti81
5246,15086.4629,15086.4959,1,452593887,452594877,990,audio/Ti81_452593887.jpg,Ti81
5247,499.706221,499.739221,2,14991186,14992176,990,audio/Or61_14991186.jpg,Or61
5248,473.707221,474.047221,1,14211216,14221416,10200,audio/Or61_14211216.jpg,Or61
5249,796.058827,796.071827,1,23881764,23882154,390,audio/Or61_23881764.jpg,Or61
5250,15136.526989,15136.714434,1,454095809,454101433,5624,audio/Ti81_454095809.jpg,Ti81
5251,2168.093183,2168.126183,2,65042795,65043785,990,audio/Bl122_65042795.jpg,Bl122
5252,621.673417,621.689417,1,18650202,18650682,480,audio/Or61_18650202.jpg,Or61
5253,15124.127981,15124.172981,1,453723839,453725189,1350,audio/Ti81_453723839.jpg,Ti81
5254,15263.548358,15263.622358,1,457906450,457908670,2220,audio/Ti81_457906450.jpg,Ti81
5255,2213.380183,2213.390183,2,66401405,66401705,300,audio/Bl122_66401405.jpg,Bl122
5256,15132.572989,15132.609989,1,453977189,453978299,1110,audio/Ti81_453977189.jpg,Ti81
5257,2131.074183,2131.083183,2,63932225,63932495,270,audio/Bl122_63932225.jpg,Bl122
5258,1957.870779,1957.914779,1,58736123,58737443,1320,audio/Bl122_58736123.jpg,Bl122
5259,2162.961183,2162.985183,2,64888835,64889555,720,audio/Bl122_64888835.jpg,Bl122
5260,2177.042183,2177.082183,2,65311265,65312465,1200,audio/Bl122_65311265.jpg,Bl122
5261,714.191271,714.206271,1,21425738,21426188,450,audio/Or61_21425738.jpg,Or61
5262,470.855221,470.871221,2,14125656,14126136,480,audio/Or61_14125656.jpg,Or61
5263,723.290271,723.296271,2,21698708,21698888,180,audio/Or61_21698708.jpg,Or61
5264,635.936417,635.943417,1,19078092,19078302,210,audio/Or61_19078092.jpg,Or61
5265,2151.483183,2151.487183,2,64544495,64544615,120,audio/Bl122_64544495.jpg,Bl122
5266,756.022271,756.085271,1,22680668,22682558,1890,audio/Or61_22680668.jpg,Or61
5267,5968.599227,5968.604227,1,179057976,179058126,150,audio/Li145_179057976.jpg,Li145
5268,8097.703141,8097.716141,1,242931094,242931484,390,audio/Li145_242931094.jpg,Li145
5269,604.395417,604.408417,2,18131862,18132252,390,audio/Or61_18131862.jpg,Or61
5270,385.155161,385.320161,1,11554654,11559604,4950,audio/Or61_11554654.jpg,Or61
5271,2055.154469,2055.165469,1,61654634,61654964,330,audio/Bl122_61654634.jpg,Bl122
5272,2156.874183,2156.881183,2,64706225,64706435,210,audio/Bl122_64706225.jpg,Bl122
5273,8096.989141,8096.997141,2,242909674,242909914,240,audio/Li145_242909674.jpg,Li145
5274,2012.022959,2012.026959,2,60360688,60360808,120,audio/Bl122_60360688.jpg,Bl122
5275,2176.606183,2176.858183,1,65298185,65305745,7560,audio/Bl122_65298185.jpg,Bl122
5276,2191.078183,2191.111183,2,65732345,65733335,990,audio/Bl122_65732345.jpg,Bl122
5277,15117.271981,15117.290981,1,453518159,453518729,570,audio/Ti81_453518159.jpg,Ti81
5278,15259.814114,15259.949114,1,457794423,457798473,4050,audio/Ti81_457794423.jpg,Ti81
5279,15032.180052,15032.190144,1,450965401,450965704,303,audio/Ti81_450965401.jpg,Ti81
5280,211.400765,211.474765,1,6342022,6344242,2220,audio/Or61_6342022.jpg,Or61
5281,15262.046358,15262.095358,1,457861390,457862860,1470,audio/Ti81_457861390.jpg,Ti81
5282,2211.818183,2211.914183,1,66354545,66357425,2880,audio/Bl122_66354545.jpg,Bl122
5283,14938.610264,14938.818408,1,448158307,448164552,6245,audio/Ti81_448158307.jpg,Ti81
5284,15318.606428,15318.777428,1,459558192,459563322,5130,audio/Ti81_459558192.jpg,Ti81
5285,2084.146961,2084.169961,1,62524408,62525098,690,audio/Bl122_62524408.jpg,Bl122
5286,2191.275183,2191.289183,2,65738255,65738675,420,audio/Bl122_65738255.jpg,Bl122
5287,752.962271,752.993271,1,22588868,22589798,930,audio/Or61_22588868.jpg,Or61
5288,610.504417,610.762417,1,18315132,18322872,7740,audio/Or61_18315132.jpg,Or61
5289,2161.912183,2161.943183,2,64857365,64858295,930,audio/Bl122_64857365.jpg,Bl122
5290,2168.185183,2168.197183,2,65045555,65045915,360,audio/Bl122_65045555.jpg,Bl122
5291,15342.428971,15342.498971,1,460272869,460274969,2100,audio/Ti81_460272869.jpg,Ti81
5292,15132.436989,15132.454989,1,453973109,453973649,540,audio/Ti81_453973109.jpg,Ti81
5293,762.718271,762.721271,2,22881548,22881638,90,audio/Or61_22881548.jpg,Or61
5294,1963.601779,1963.643779,1,58908053,58909313,1260,audio/Bl122_58908053.jpg,Bl122
5295,2211.085183,2211.089183,2,66332555,66332675,120,audio/Bl122_66332555.jpg,Bl122
5296,14905.021768,14905.181849,1,447150653,447155455,4802,audio/Ti81_447150653.jpg,Ti81
5297,561.498416,561.561416,1,16844952,16846842,1890,audio/Or61_16844952.jpg,Or61
5298,15100.973823,15101.013823,1,453029214,453030414,1200,audio/Ti81_453029214.jpg,Ti81
5299,1770.494657,1770.501657,2,53114839,53115049,210,audio/Bl122_53114839.jpg,Bl122
5300,474.837221,474.931221,1,14245116,14247936,2820,audio/Or61_14245116.jpg,Or61
5301,509.928221,509.989221,1,15297846,15299676,1830,audio/Or61_15297846.jpg,Or61
5302,15215.10858,15215.14858,1,456453257,456454457,1200,audio/Ti81_456453257.jpg,Ti81
5303,549.474416,549.672416,1,16484232,16490172,5940,audio/Or61_16484232.jpg,Or61
5304,2005.703779,2005.773779,1,60171113,60173213,2100,audio/Bl122_60171113.jpg,Bl122
5305,2171.339183,2171.375183,2,65140175,65141255,1080,audio/Bl122_65140175.jpg,Bl122
5306,2000.100779,2000.331779,1,60003023,60009953,6930,audio/Bl122_60003023.jpg,Bl122
5307,2012.696959,2012.733959,2,60380908,60382018,1110,audio/Bl122_60380908.jpg,Bl122
5308,15077.748926,15077.9704,1,452332467,452339112,6645,audio/Ti81_452332467.jpg,Ti81
5309,3418.878592,3418.897199,1,102566357,102566915,558,audio/Ti81_102566357.jpg,Ti81
5310,771.108271,771.115271,2,23133248,23133458,210,audio/Or61_23133248.jpg,Or61
5311,2232.113183,2232.123183,2,66963395,66963695,300,audio/Bl122_66963395.jpg,Bl122
5312,548.830416,549.030416,1,16464912,16470912,6000,audio/Or61_16464912.jpg,Or61
5313,9172.882804,9172.905804,1,275186484,275187174,690,audio/Li145_275186484.jpg,Li145
5314,2062.187469,2062.201469,2,61865624,61866044,420,audio/Bl122_61865624.jpg,Bl122
5315,8742.182692,8742.187692,2,262265480,262265630,150,audio/Li145_262265480.jpg,Li145
5316,6956.945877,6956.955877,1,208708376,208708676,300,audio/Li145_208708376.jpg,Li145
5317,428.654969,428.939969,1,12859649,12868199,8550,audio/Or61_12859649.jpg,Or61
5318,2039.790469,2039.897469,1,61193714,61196924,3210,audio/Bl122_61193714.jpg,Bl122
5319,15343.354971,15343.378971,1,460300649,460301369,720,audio/Ti81_460300649.jpg,Ti81
5320,750.426271,750.528271,1,22512788,22515848,3060,audio/Or61_22512788.jpg,Or61
5321,1944.675779,1944.691779,2,58340273,58340753,480,audio/Bl122_58340273.jpg,Bl122
5322,1997.260779,1997.266779,2,59917823,59918003,180,audio/Bl122_59917823.jpg,Bl122
5323,2174.734183,2174.771183,1,65242025,65243135,1110,audio/Bl122_65242025.jpg,Bl122
5324,15048.117966,15048.160966,1,451443538,451444828,1290,audio/Ti81_451443538.jpg,Ti81
5325,1958.968779,1959.019779,2,58769063,58770593,1530,audio/Bl122_58769063.jpg,Bl122
5326,2059.277469,2059.287469,2,61778324,61778624,300,audio/Bl122_61778324.jpg,Bl122
5327,750.602271,750.669271,1,22518068,22520078,2010,audio/Or61_22518068.jpg,Or61
5328,753.449271,753.706271,1,22603478,22611188,7710,audio/Or61_22603478.jpg,Or61
5329,2193.707183,2193.712183,2,65811215,65811365,150,audio/Bl122_65811215.jpg,Bl122
5330,5695.961353,5696.023353,1,170878840,170880700,1860,audio/Li145_170878840.jpg,Li145
5331,709.375271,709.541271,1,21281258,21286238,4980,audio/Or61_21281258.jpg,Or61
5332,1957.835779,1957.838779,2,58735073,58735163,90,audio/Bl122_58735073.jpg,Bl122
5333,503.217221,503.235221,2,15096516,15097056,540,audio/Or61_15096516.jpg,Or61
5334,2013.385959,2013.418959,2,60401578,60402568,990,audio/Bl122_60401578.jpg,Bl122
5335,15025.295638,15025.314434,1,450758869,450759433,564,audio/Ti81_450758869.jpg,Ti81
5336,1947.472779,1947.489779,2,58424183,58424693,510,audio/Bl122_58424183.jpg,Bl122
5337,2062.988469,2063.159469,1,61889654,61894784,5130,audio/Bl122_61889654.jpg,Bl122
5338,495.072221,495.292221,1,14852166,14858766,6600,audio/Or61_14852166.jpg,Or61
5339,2053.741469,2053.774469,1,61612244,61613234,990,audio/Bl122_61612244.jpg,Bl122
5340,2210.701183,2210.706183,2,66321035,66321185,150,audio/Bl122_66321035.jpg,Bl122
5341,540.824416,540.844416,1,16224732,16225332,600,audio/Or61_16224732.jpg,Or61
5342,758.806271,758.822271,2,22764188,22764668,480,audio/Or61_22764188.jpg,Or61
5343,2225.853183,2225.958183,1,66775595,66778745,3150,audio/Bl122_66775595.jpg,Bl122
5344,6333.552902,6333.608902,1,190006587,190008267,1680,audio/Li145_190006587.jpg,Li145
5345,201.774012,201.791012,1,6053220,6053730,510,audio/Or61_6053220.jpg,Or61
5346,629.624417,629.721417,1,18888732,18891642,2910,audio/Or61_18888732.jpg,Or61
5347,531.775416,531.784416,2,15953262,15953532,270,audio/Or61_15953262.jpg,Or61
5348,2222.493183,2222.707183,1,66674795,66681215,6420,audio/Bl122_66674795.jpg,Bl122
5349,1993.945779,1993.981779,1,59818373,59819453,1080,audio/Bl122_59818373.jpg,Bl122
5350,506.650221,506.730221,1,15199506,15201906,2400,audio/Or61_15199506.jpg,Or61
5351,2174.207183,2174.224183,2,65226215,65226725,510,audio/Bl122_65226215.jpg,Bl122
5352,2071.963469,2072.060469,2,62158904,62161814,2910,audio/Bl122_62158904.jpg,Bl122
5353,2158.261183,2158.276183,2,64747835,64748285,450,audio/Bl122_64747835.jpg,Bl122
5354,547.008416,547.126416,1,16410252,16413792,3540,audio/Or61_16410252.jpg,Or61
5355,3544.234075,3544.257665,1,106327022,106327729,707,audio/Ti81_106327022.jpg,Ti81
5356,750.267271,750.292271,1,22508018,22508768,750,audio/Or61_22508018.jpg,Or61
5357,2214.286183,2214.374183,1,66428585,66431225,2640,audio/Bl122_66428585.jpg,Bl122
5358,9166.398583,9166.444583,1,274991957,274993337,1380,audio/Li145_274991957.jpg,Li145
5359,15076.159682,15076.303682,1,452284790,452289110,4320,audio/Ti81_452284790.jpg,Ti81
5360,15223.950443,15223.981443,1,456718513,456719443,930,audio/Ti81_456718513.jpg,Ti81
5361,636.879417,636.952417,1,19106382,19108572,2190,audio/Or61_19106382.jpg,Or61
5362,792.807827,792.854827,1,23784234,23785644,1410,audio/Or61_23784234.jpg,Or61
5363,599.200417,599.216417,2,17976012,17976492,480,audio/Or61_17976012.jpg,Or61
5364,2049.135469,2049.141469,2,61474064,61474244,180,audio/Bl122_61474064.jpg,Bl122
5365,2098.209961,2098.373961,1,62946298,62951218,4920,audio/Bl122_62946298.jpg,Bl122
5366,2092.616961,2092.649961,2,62778508,62779498,990,audio/Bl122_62778508.jpg,Bl122
5367,9134.719751,9134.744751,1,274041592,274042342,750,audio/Li145_274041592.jpg,Li145
5368,2054.424469,2054.447469,2,61632734,61633424,690,audio/Bl122_61632734.jpg,Bl122
5369,714.209271,714.226271,1,21426278,21426788,510,audio/Or61_21426278.jpg,Or61
5370,1755.91693,1756.08993,1,52677507,52682697,5190,audio/Bl122_52677507.jpg,Bl122
5371,15226.432443,15226.660443,1,456792973,456799813,6840,audio/Ti81_456792973.jpg,Ti81
5372,1945.081779,1945.089779,2,58352453,58352693,240,audio/Bl122_58352453.jpg,Bl122
5373,2153.330183,2153.379183,2,64599905,64601375,1470,audio/Bl122_64599905.jpg,Bl122
5374,6301.645561,6301.669561,1,189049366,189050086,720,audio/Li145_189049366.jpg,Li145
5375,781.023878,781.047878,1,23430716,23431436,720,audio/Or61_23430716.jpg,Or61
5376,2219.657183,2219.666183,2,66589715,66589985,270,audio/Bl122_66589715.jpg,Bl122
5377,2033.214469,2033.241469,2,60996434,60997244,810,audio/Bl122_60996434.jpg,Bl122
5378,729.464271,729.481271,1,21883928,21884438,510,audio/Or61_21883928.jpg,Or61
5379,474.494221,474.508221,2,14234826,14235246,420,audio/Or61_14234826.jpg,Or61
5380,2039.421815,2039.448815,1,61182654,61183464,810,audio/Li145_61182654.jpg,Li145
5381,2134.460183,2134.594183,1,64033805,64037825,4020,audio/Bl122_64033805.jpg,Bl122
5382,2174.662183,2174.678183,2,65239865,65240345,480,audio/Bl122_65239865.jpg,Bl122
5383,9180.623829,9180.627829,1,275418714,275418834,120,audio/Li145_275418714.jpg,Li145
5384,15262.484358,15262.522358,1,457874530,457875670,1140,audio/Ti81_457874530.jpg,Ti81
5385,2077.531823,2077.784823,1,62325954,62333544,7590,audio/Bl122_62325954.jpg,Bl122
5386,717.015271,717.019271,2,21510458,21510578,120,audio/Or61_21510458.jpg,Or61
5387,585.89573,586.13973,1,17576871,17584191,7320,audio/Or61_17576871.jpg,Or61
5388,2081.105287,2081.125287,1,62433158,62433758,600,audio/Bl122_62433158.jpg,Bl122
5389,15224.382443,15224.408443,1,456731473,456732253,780,audio/Ti81_456731473.jpg,Ti81
5390,795.385827,795.435827,1,23861574,23863074,1500,audio/Or61_23861574.jpg,Or61
5391,6287.157659,6287.190659,1,188614729,188615719,990,audio/Li145_188614729.jpg,Li145
5392,1939.402779,1939.414779,2,58182083,58182443,360,audio/Bl122_58182083.jpg,Bl122
5393,757.839271,757.847271,2,22735178,22735418,240,audio/Or61_22735178.jpg,Or61
5394,518.279221,518.348221,1,15548376,15550446,2070,audio/Or61_15548376.jpg,Or61
5395,15221.747443,15221.871443,1,456652423,456656143,3720,audio/Ti81_456652423.jpg,Ti81
5396,1787.076115,1787.080115,2,53612283,53612403,120,audio/Bl122_53612283.jpg,Bl122
5397,518.574221,518.603221,1,15557226,15558096,870,audio/Or61_15557226.jpg,Or61
5398,471.806221,471.820221,1,14154186,14154606,420,audio/Or61_14154186.jpg,Or61
5399,15156.627257,15156.686257,1,454698817,454700587,1770,audio/Ti81_454698817.jpg,Ti81
5400,15157.729257,15157.920257,1,454731877,454737607,5730,audio/Ti81_454731877.jpg,Ti81
5401,1964.438779,1964.507779,1,58933163,58935233,2070,audio/Bl122_58933163.jpg,Bl122
5402,568.452467,568.462467,2,17053574,17053874,300,audio/Or61_17053574.jpg,Or61
5403,2220.129183,2220.135183,2,66603875,66604055,180,audio/Bl122_66603875.jpg,Bl122
5404,15137.149989,15137.294989,1,454114499,454118849,4350,audio/Ti81_454114499.jpg,Ti81
5405,472.567221,472.575221,2,14177016,14177256,240,audio/Or61_14177016.jpg,Or61
5406,15273.952439,15274.041439,1,458218573,458221243,2670,audio/Ti81_458218573.jpg,Ti81
5407,1941.480779,1941.704779,1,58244423,58251143,6720,audio/Bl122_58244423.jpg,Bl122
5408,751.76616,751.78216,2,22552984,22553464,480,audio/Bl122_22552984.jpg,Bl122
5409,1988.953779,1988.998779,1,59668613,59669963,1350,audio/Bl122_59668613.jpg,Bl122
5410,536.634416,536.681416,1,16099032,16100442,1410,audio/Or61_16099032.jpg,Or61
5411,2157.305183,2157.355183,2,64719155,64720655,1500,audio/Bl122_64719155.jpg,Bl122
5412,2166.876183,2166.894183,1,65006285,65006825,540,audio/Bl122_65006285.jpg,Bl122
5413,2155.848183,2156.084183,1,64675445,64682525,7080,audio/Bl122_64675445.jpg,Bl122
5414,15088.9429,15089.0859,1,452668287,452672577,4290,audio/Ti81_452668287.jpg,Ti81
5415,1760.369374,1760.410374,1,52811081,52812311,1230,audio/Bl122_52811081.jpg,Bl122
5416,2191.818183,2192.065183,1,65754545,65761955,7410,audio/Bl122_65754545.jpg,Bl122
5417,2235.058183,2235.070183,2,67051745,67052105,360,audio/Bl122_67051745.jpg,Bl122
5418,2208.924183,2208.927183,2,66267725,66267815,90,audio/Bl122_66267725.jpg,Bl122
5419,2233.993183,2234.115183,1,67019795,67023455,3660,audio/Bl122_67019795.jpg,Bl122
5420,470.622221,470.627221,2,14118666,14118816,150,audio/Or61_14118666.jpg,Or61
5421,574.40571,574.46971,1,17232171,17234091,1920,audio/Or61_17232171.jpg,Or61
5422,101.217905,101.386905,1,3036537,3041607,5070,audio/Bl122_3036537.jpg,Bl122
5423,502.876221,502.880221,2,15086286,15086406,120,audio/Or61_15086286.jpg,Or61
5424,2004.654779,2004.661779,2,60139643,60139853,210,audio/Bl122_60139643.jpg,Bl122
5425,2116.575183,2116.580183,2,63497255,63497405,150,audio/Bl122_63497255.jpg,Bl122
5426,2163.539183,2163.778183,1,64906175,64913345,7170,audio/Bl122_64906175.jpg,Bl122
5427,2195.058183,2195.063183,2,65851745,65851895,150,audio/Bl122_65851745.jpg,Bl122
5428,8091.902536,8091.971536,1,242757076,242759146,2070,audio/Li145_242757076.jpg,Li145
5429,1991.063779,1991.072779,2,59731913,59732183,270,audio/Bl122_59731913.jpg,Bl122
5430,8083.883803,8083.886803,2,242516514,242516604,90,audio/Li145_242516514.jpg,Li145
5431,2205.725183,2205.751183,1,66171755,66172535,780,audio/Bl122_66171755.jpg,Bl122
5432,1984.926779,1984.979779,2,59547803,59549393,1590,audio/Bl122_59547803.jpg,Bl122
5433,2196.590183,2196.743183,1,65897705,65902295,4590,audio/Bl122_65897705.jpg,Bl122
5434,2208.137183,2208.386183,1,66244115,66251585,7470,audio/Bl122_66244115.jpg,Bl122
5435,2231.240183,2231.259183,2,66937205,66937775,570,audio/Bl122_66937205.jpg,Bl122
5436,631.652417,631.659417,2,18949572,18949782,210,audio/Or61_18949572.jpg,Or61
5437,1966.863779,1966.866779,2,59005913,59006003,90,audio/Bl122_59005913.jpg,Bl122
5438,470.636221,470.646221,2,14119086,14119386,300,audio/Or61_14119086.jpg,Or61
5439,2051.646469,2051.793469,1,61549394,61553804,4410,audio/Bl122_61549394.jpg,Bl122
5440,2195.761183,2195.768183,2,65872835,65873045,210,audio/Bl122_65872835.jpg,Bl122
5441,9167.932583,9167.942583,1,275037977,275038277,300,audio/Li145_275037977.jpg,Li145
5442,1980.369779,1980.372779,2,59411093,59411183,90,audio/Bl122_59411093.jpg,Bl122
5443,3464.079626,3464.114442,1,103922388,103923433,1045,audio/Ti81_103922388.jpg,Ti81
5444,767.589271,767.655271,1,23027678,23029658,1980,audio/Or61_23027678.jpg,Or61
5445,183.467971,183.555971,1,5504039,5506679,2640,audio/Or61_5504039.jpg,Or61
5446,15136.888989,15136.924989,1,454106669,454107749,1080,audio/Ti81_454106669.jpg,Ti81
5447,770.251271,770.271271,1,23107538,23108138,600,audio/Or61_23107538.jpg,Or61
5448,2185.985183,2186.002183,2,65579555,65580065,510,audio/Bl122_65579555.jpg,Bl122
5449,2068.164469,2068.170469,2,62044934,62045114,180,audio/Bl122_62044934.jpg,Bl122
5450,14941.716275,14941.74756,1,448251488,448252426,938,audio/Ti81_448251488.jpg,Ti81
5451,1972.928779,1972.949779,1,59187863,59188493,630,audio/Bl122_59187863.jpg,Bl122
5452,2044.760469,2044.903469,1,61342814,61347104,4290,audio/Bl122_61342814.jpg,Bl122
5453,6952.983285,6952.999285,1,208589498,208589978,480,audio/Li145_208589498.jpg,Li145
5454,15276.695439,15276.997439,1,458300863,458309923,9060,audio/Ti81_458300863.jpg,Ti81
5455,15084.0059,15084.2529,1,452520177,452527587,7410,audio/Ti81_452520177.jpg,Ti81
5456,1975.439779,1975.443779,2,59263193,59263313,120,audio/Bl122_59263193.jpg,Bl122
5457,1988.711779,1988.718779,2,59661353,59661563,210,audio/Bl122_59661353.jpg,Bl122
5458,730.979271,731.220271,1,21929378,21936608,7230,audio/Or61_21929378.jpg,Or61
5459,186.595971,186.600971,2,5597879,5598029,150,audio/Or61_5597879.jpg,Or61
5460,2069.091469,2069.288469,1,62072744,62078654,5910,audio/Bl122_62072744.jpg,Bl122
5461,2072.660469,2072.667469,2,62179814,62180024,210,audio/Bl122_62179814.jpg,Bl122
5462,488.356221,488.360221,2,14650686,14650806,120,audio/Or61_14650686.jpg,Or61
5463,2219.129183,2219.173183,1,66573875,66575195,1320,audio/Bl122_66573875.jpg,Bl122
5464,751.086271,751.267271,1,22532588,22538018,5430,audio/Or61_22532588.jpg,Or61
5465,2040.856469,2040.861469,2,61225694,61225844,150,audio/Bl122_61225694.jpg,Bl122
5466,768.366271,768.541271,1,23050988,23056238,5250,audio/Or61_23050988.jpg,Or61
5467,2223.146183,2223.192183,2,66694385,66695765,1380,audio/Bl122_66694385.jpg,Bl122
5468,15259.418114,15259.551114,1,457782543,457786533,3990,audio/Ti81_457782543.jpg,Ti81
5469,15343.150971,15343.200971,1,460294529,460296029,1500,audio/Ti81_460294529.jpg,Ti81
5470,503.957221,504.152221,1,15118716,15124566,5850,audio/Or61_15118716.jpg,Or61
5471,770.360271,770.365271,1,23110808,23110958,150,audio/Or61_23110808.jpg,Or61
5472,2223.207183,2223.222183,2,66696215,66696665,450,audio/Bl122_66696215.jpg,Bl122
5473,925.398693,925.633076,1,27761960,27768992,7032,audio/Ti81_27761960.jpg,Ti81
5474,1963.261779,1963.278779,2,58897853,58898363,510,audio/Bl122_58897853.jpg,Bl122
5475,549.868416,549.955416,1,16496052,16498662,2610,audio/Or61_16496052.jpg,Or61
5476,796.569827,796.577827,1,23897094,23897334,240,audio/Or61_23897094.jpg,Or61
5477,2226.915183,2226.919183,2,66807455,66807575,120,audio/Bl122_66807455.jpg,Bl122
5478,6332.705902,6332.795902,1,189981177,189983877,2700,audio/Li145_189981177.jpg,Li145
5479,2157.188183,2157.195183,2,64715645,64715855,210,audio/Bl122_64715645.jpg,Bl122
5480,15133.523989,15133.547989,1,454005719,454006439,720,audio/Ti81_454005719.jpg,Ti81
5481,2038.642469,2038.648469,2,61159274,61159454,180,audio/Bl122_61159274.jpg,Bl122
5482,15155.410257,15155.530257,1,454662307,454665907,3600,audio/Ti81_454662307.jpg,Ti81
5483,611.915417,611.925417,2,18357462,18357762,300,audio/Or61_18357462.jpg,Or61
5484,945.568973,945.736749,1,28367069,28372102,5033,audio/Ti81_28367069.jpg,Ti81
5485,528.055416,528.060416,2,15841662,15841812,150,audio/Or61_15841662.jpg,Or61
5486,473.595221,473.620221,1,14207856,14208606,750,audio/Or61_14207856.jpg,Or61
5487,3465.670854,3465.78136,1,103970125,103973440,3315,audio/Ti81_103970125.jpg,Ti81
5488,1987.567779,1987.571779,2,59627033,59627153,120,audio/Bl122_59627033.jpg,Bl122
5489,793.495827,793.520827,1,23804874,23805624,750,audio/Or61_23804874.jpg,Or61
5490,15103.662256,15103.853256,1,453109867,453115597,5730,audio/Ti81_453109867.jpg,Ti81
5491,15022.382254,15022.746695,1,450671467,450682400,10933,audio/Ti81_450671467.jpg,Ti81
5492,3424.076134,3424.147282,1,102722284,102724418,2134,audio/Ti81_102722284.jpg,Ti81
5493,4.39915,4.42015,1,131974,132604,630,audio/Or61_131974.jpg,Or61
5494,4892.981007,4893.154007,1,146789430,146794620,5190,audio/Li145_146789430.jpg,Li145
5495,2161.600183,2161.887183,1,64848005,64856615,8610,audio/Bl122_64848005.jpg,Bl122
5496,565.983416,565.986416,2,16979502,16979592,90,audio/Or61_16979502.jpg,Or61
5497,8096.960141,8096.985141,1,242908804,242909554,750,audio/Li145_242908804.jpg,Li145
5498,2006.296779,2006.404779,2,60188903,60192143,3240,audio/Bl122_60188903.jpg,Bl122
5499,247.045316,247.244316,1,7411359,7417329,5970,audio/Or61_7411359.jpg,Or61
5500,2057.250469,2057.260469,2,61717514,61717814,300,audio/Bl122_61717514.jpg,Bl122
5501,3429.546706,3429.565706,1,102886401,102886971,570,audio/Ti81_102886401.jpg,Ti81
5502,619.814417,619.838417,1,18594432,18595152,720,audio/Or61_18594432.jpg,Or61
5503,2092.675961,2092.681961,2,62780278,62780458,180,audio/Bl122_62780278.jpg,Bl122
5504,1989.648779,1989.659779,2,59689463,59689793,330,audio/Bl122_59689463.jpg,Bl122
5505,1785.32943,1785.46343,1,53559882,53563902,4020,audio/Bl122_53559882.jpg,Bl122
5506,2044.090469,2044.093469,2,61322714,61322804,90,audio/Bl122_61322714.jpg,Bl122
5507,758.825271,759.047271,1,22764758,22771418,6660,audio/Or61_22764758.jpg,Or61
5508,477.081221,477.103221,1,14312436,14313096,660,audio/Or61_14312436.jpg,Or61
5509,1977.864779,1978.092779,1,59335943,59342783,6840,audio/Bl122_59335943.jpg,Bl122
5510,2188.845183,2189.012183,1,65665355,65670365,5010,audio/Bl122_65665355.jpg,Bl122
5511,3471.262735,3471.309409,1,104137882,104139282,1400,audio/Ti81_104137882.jpg,Ti81
5512,616.285417,616.474417,1,18488562,18494232,5670,audio/Or61_18488562.jpg,Or61
5513,470.755221,470.759221,2,14122656,14122776,120,audio/Or61_14122656.jpg,Or61
5514,15230.061443,15230.200443,1,456901843,456906013,4170,audio/Ti81_456901843.jpg,Ti81
5515,612.573417,612.609417,2,18377202,18378282,1080,audio/Or61_18377202.jpg,Or61
5516,14945.899842,14946.244982,1,448376995,448387349,10354,audio/Ti81_448376995.jpg,Ti81
5517,2223.877183,2223.883183,2,66716315,66716495,180,audio/Bl122_66716315.jpg,Bl122
5518,14755.286011,14755.454607,1,442658580,442663638,5058,audio/Ti81_442658580.jpg,Ti81
5519,2007.083779,2007.096779,2,60212513,60212903,390,audio/Bl122_60212513.jpg,Bl122
5520,8092.044536,8092.066536,1,242761336,242761996,660,audio/Li145_242761336.jpg,Li145
5521,15083.2319,15083.4169,1,452496957,452502507,5550,audio/Ti81_452496957.jpg,Ti81
5522,179.302971,179.306971,2,5379089,5379209,120,audio/Or61_5379089.jpg,Or61
5523,14941.693064,14941.705427,1,448250791,448251162,371,audio/Ti81_448250791.jpg,Ti81
5524,749.450271,749.496271,1,22483508,22484888,1380,audio/Or61_22483508.jpg,Or61
5525,2012.477959,2012.547959,2,60374338,60376438,2100,audio/Bl122_60374338.jpg,Bl122
5526,2147.330183,2147.333183,2,64419905,64419995,90,audio/Bl122_64419905.jpg,Bl122
5527,2183.819183,2183.827183,2,65514575,65514815,240,audio/Bl122_65514575.jpg,Bl122
5528,1801.340115,1801.488115,1,54040203,54044643,4440,audio/Bl122_54040203.jpg,Bl122
5529,488.162221,488.168221,2,14644866,14645046,180,audio/Or61_14644866.jpg,Or61
5530,1991.623779,1991.642779,2,59748713,59749283,570,audio/Bl122_59748713.jpg,Bl122
5531,2011.148959,2011.434959,1,60334468,60343048,8580,audio/Bl122_60334468.jpg,Bl122
5532,1989.128779,1989.184779,1,59673863,59675543,1680,audio/Bl122_59673863.jpg,Bl122
5533,844.982992,845.153291,1,25349489,25354598,5109,audio/Ti81_25349489.jpg,Ti81
5534,559.567416,559.607416,1,16787022,16788222,1200,audio/Or61_16787022.jpg,Or61
5535,7569.614558,7569.760558,1,227088436,227092816,4380,audio/Li145_227088436.jpg,Li145
5536,2165.580183,2165.584183,2,64967405,64967525,120,audio/Bl122_64967405.jpg,Bl122
5537,399.725529,399.903529,1,11991765,11997105,5340,audio/Or61_11991765.jpg,Or61
5538,1992.829779,1992.856779,1,59784893,59785703,810,audio/Bl122_59784893.jpg,Bl122
5539,730.400271,730.423271,1,21912008,21912698,690,audio/Or61_21912008.jpg,Or61
5540,1804.60405,1804.76105,1,54138121,54142831,4710,audio/Bl122_54138121.jpg,Bl122
5541,1991.834779,1991.836779,2,59755043,59755103,60,audio/Bl122_59755043.jpg,Bl122
5542,2038.142469,2038.158469,2,61144274,61144754,480,audio/Bl122_61144274.jpg,Bl122
5543,1985.531779,1985.547779,2,59565953,59566433,480,audio/Bl122_59565953.jpg,Bl122
5544,2154.920183,2155.336183,1,64647605,64660085,12480,audio/Bl122_64647605.jpg,Bl122
5545,15032.584585,15032.623313,1,450977537,450978699,1162,audio/Ti81_450977537.jpg,Ti81
5546,2115.786183,2115.844183,1,63473585,63475325,1740,audio/Bl122_63473585.jpg,Bl122
5547,15063.366966,15063.390966,1,451901008,451901728,720,audio/Ti81_451901008.jpg,Ti81
5548,2014.472959,2014.618959,1,60434188,60438568,4380,audio/Bl122_60434188.jpg,Bl122
5549,1956.918779,1957.007779,1,58707563,58710233,2670,audio/Bl122_58707563.jpg,Bl122
5550,716.639271,716.664271,1,21499178,21499928,750,audio/Or61_21499178.jpg,Or61
5551,2084.742961,2084.750961,2,62542288,62542528,240,audio/Bl122_62542288.jpg,Bl122
5552,2047.987469,2048.023469,1,61439624,61440704,1080,audio/Bl122_61439624.jpg,Bl122
5553,819.163882,819.248882,1,24574916,24577466,2550,audio/Or61_24574916.jpg,Or61
5554,2062.445469,2062.588469,1,61873364,61877654,4290,audio/Bl122_61873364.jpg,Bl122
5555,2071.577469,2071.581469,2,62147324,62147444,120,audio/Bl122_62147324.jpg,Bl122
5556,5843.838404,5843.862404,1,175315152,175315872,720,audio/Li145_175315152.jpg,Li145
5557,2152.819183,2153.033183,1,64584575,64590995,6420,audio/Bl122_64584575.jpg,Bl122
5558,2141.078183,2141.111183,2,64232345,64233335,990,audio/Bl122_64232345.jpg,Bl122
5559,15335.23001,15335.57601,1,460056900,460067280,10380,audio/Ti81_460056900.jpg,Ti81
5560,2219.613183,2219.617183,2,66588395,66588515,120,audio/Bl122_66588395.jpg,Bl122
5561,2220.512183,2220.566183,1,66615365,66616985,1620,audio/Bl122_66615365.jpg,Bl122
5562,2037.351469,2037.482469,2,61120544,61124474,3930,audio/Bl122_61120544.jpg,Bl122
5563,1954.258779,1954.268779,2,58627763,58628063,300,audio/Bl122_58627763.jpg,Bl122
5564,2153.381183,2153.388183,2,64601435,64601645,210,audio/Bl122_64601435.jpg,Bl122
5565,2031.640469,2031.892469,1,60949214,60956774,7560,audio/Bl122_60949214.jpg,Bl122
5566,818.000882,818.219882,1,24540026,24546596,6570,audio/Or61_24540026.jpg,Or61
5567,532.091416,532.105416,2,15962742,15963162,420,audio/Or61_15962742.jpg,Or61
5568,3422.06723,3422.100533,1,102662016,102663015,999,audio/Ti81_102662016.jpg,Ti81
5569,2121.973183,2122.006183,1,63659195,63660185,990,audio/Bl122_63659195.jpg,Bl122
5570,2174.955183,2174.980183,2,65248655,65249405,750,audio/Bl122_65248655.jpg,Bl122
5571,1801.210115,1801.220115,2,54036303,54036603,300,audio/Bl122_54036303.jpg,Bl122
5572,1957.671779,1957.791779,1,58730153,58733753,3600,audio/Bl122_58730153.jpg,Bl122
5573,729.368271,729.389271,1,21881048,21881678,630,audio/Or61_21881048.jpg,Or61
5574,2213.265183,2213.333183,2,66397955,66399995,2040,audio/Bl122_66397955.jpg,Bl122
5575,3584.309686,3584.314686,2,107529290,107529440,150,audio/Li145_107529290.jpg,Li145
5576,15037.93073,15038.148461,1,451137921,451144453,6532,audio/Ti81_451137921.jpg,Ti81
5577,470.329221,470.353221,1,14109876,14110596,720,audio/Or61_14109876.jpg,Or61
5578,9182.135829,9182.299829,1,275464074,275468994,4920,audio/Li145_275464074.jpg,Li145
5579,15221.898443,15222.025443,1,456656953,456660763,3810,audio/Ti81_456656953.jpg,Ti81
5580,629.723417,629.754417,1,18891702,18892632,930,audio/Or61_18891702.jpg,Or61
5581,632.198417,632.353417,1,18965952,18970602,4650,audio/Or61_18965952.jpg,Or61
5582,2125.961183,2125.965183,2,63778835,63778955,120,audio/Bl122_63778835.jpg,Bl122
5583,428.330969,428.337969,2,12849929,12850139,210,audio/Or61_12849929.jpg,Or61
5584,15086.268571,15086.4529,1,452588057,452593587,5530,audio/Ti81_452588057.jpg,Ti81
5585,2132.096183,2132.105183,2,63962885,63963155,270,audio/Bl122_63962885.jpg,Bl122
5586,866.854602,866.862602,2,26005638,26005878,240,audio/Bl122_26005638.jpg,Bl122
5587,2125.638183,2125.653183,2,63769145,63769595,450,audio/Bl122_63769145.jpg,Bl122
5588,8888.227716,8888.233716,1,266646831,266647011,180,audio/Li145_266646831.jpg,Li145
5589,15096.177823,15096.245823,1,452885334,452887374,2040,audio/Ti81_452885334.jpg,Ti81
5590,2222.019183,2222.027183,2,66660575,66660815,240,audio/Bl122_66660575.jpg,Bl122
5591,15156.707257,15156.730257,1,454701217,454701907,690,audio/Ti81_454701217.jpg,Ti81
5592,7566.371558,7566.378558,2,226991146,226991356,210,audio/Li145_226991146.jpg,Li145
5593,1785.46743,1785.48543,1,53564022,53564562,540,audio/Bl122_53564022.jpg,Bl122
5594,729.562271,729.646271,1,21886868,21889388,2520,audio/Or61_21886868.jpg,Or61
5595,15302.761373,15302.891373,1,459082841,459086741,3900,audio/Ti81_459082841.jpg,Ti81
5596,488.630221,488.639221,2,14658906,14659176,270,audio/Or61_14658906.jpg,Or61
5597,104.482362,104.486362,2,3134470,3134590,120,audio/Bl122_3134470.jpg,Bl122
5598,14946.768748,14946.793725,1,448403062,448403811,749,audio/Ti81_448403062.jpg,Ti81
5599,477.866221,477.886221,1,14335986,14336586,600,audio/Or61_14335986.jpg,Or61
5600,2057.801469,2057.816469,2,61734044,61734494,450,audio/Bl122_61734044.jpg,Bl122
5601,2153.784183,2154.008183,1,64613525,64620245,6720,audio/Bl122_64613525.jpg,Bl122
5602,492.789221,492.792221,2,14783676,14783766,90,audio/Or61_14783676.jpg,Or61
5603,2211.505183,2211.508183,2,66345155,66345245,90,audio/Bl122_66345155.jpg,Bl122
5604,9172.670804,9172.672804,2,275180124,275180184,60,audio/Li145_275180124.jpg,Li145
5605,2152.092183,2152.098183,2,64562765,64562945,180,audio/Bl122_64562765.jpg,Bl122
5606,1939.426779,1939.431779,2,58182803,58182953,150,audio/Bl122_58182803.jpg,Bl122
5607,15098.309823,15098.514328,1,452949294,452955429,6135,audio/Ti81_452949294.jpg,Ti81
5608,15021.485596,15021.574908,1,450644567,450647247,2680,audio/Ti81_450644567.jpg,Ti81
5609,1983.150779,1983.156779,2,59494523,59494703,180,audio/Bl122_59494523.jpg,Bl122
5610,15240.127874,15240.180874,1,457203836,457205426,1590,audio/Ti81_457203836.jpg,Ti81
5611,487.667221,487.721221,1,14630016,14631636,1620,audio/Or61_14630016.jpg,Or61
5612,2136.022183,2136.048183,1,64080665,64081445,780,audio/Bl122_64080665.jpg,Bl122
5613,5888.260515,5888.291515,1,176647815,176648745,930,audio/Li145_176647815.jpg,Li145
5614,790.306827,790.314827,2,23709204,23709444,240,audio/Or61_23709204.jpg,Or61
5615,15252.079074,15252.170074,1,457562372,457565102,2730,audio/Ti81_457562372.jpg,Ti81
5616,3539.902159,3539.944292,1,106197064,106198328,1264,audio/Ti81_106197064.jpg,Ti81
5617,5969.916227,5969.922227,1,179097486,179097666,180,audio/Li145_179097486.jpg,Li145
5618,1951.053779,1951.060779,1,58531613,58531823,210,audio/Bl122_58531613.jpg,Bl122
5619,6953.208285,6953.460285,1,208596248,208603808,7560,audio/Li145_208596248.jpg,Li145
5620,770.280271,770.336271,1,23108408,23110088,1680,audio/Or61_23108408.jpg,Or61
5621,500.487221,500.520221,2,15014616,15015606,990,audio/Or61_15014616.jpg,Or61
5622,2013.936959,2013.966959,2,60418108,60419008,900,audio/Bl122_60418108.jpg,Bl122
5623,397.863529,397.941529,1,11935905,11938245,2340,audio/Or61_11935905.jpg,Or61
5624,2048.121469,2048.132469,1,61443644,61443974,330,audio/Bl122_61443644.jpg,Bl122
5625,510.975221,511.090221,1,15329256,15332706,3450,audio/Or61_15329256.jpg,Or61
5626,9172.927804,9172.950804,1,275187834,275188524,690,audio/Li145_275187834.jpg,Li145
5627,469.379221,469.710221,1,14081376,14091306,9930,audio/Or61_14081376.jpg,Or61
5628,2092.577961,2092.594961,2,62777338,62777848,510,audio/Bl122_62777338.jpg,Bl122
5629,2204.359183,2204.362183,2,66130775,66130865,90,audio/Bl122_66130775.jpg,Bl122
5630,2051.802469,2051.805469,2,61554074,61554164,90,audio/Bl122_61554074.jpg,Bl122
5631,15128.119981,15128.184981,1,453843599,453845549,1950,audio/Ti81_453843599.jpg,Ti81
5632,15279.746439,15280.045439,1,458392393,458401363,8970,audio/Ti81_458392393.jpg,Ti81
5633,7565.773558,7565.937558,1,226973206,226978126,4920,audio/Li145_226973206.jpg,Li145
5634,704.196271,704.305271,1,21125888,21129158,3270,audio/Or61_21125888.jpg,Or61
5635,2014.073959,2014.337959,1,60422218,60430138,7920,audio/Bl122_60422218.jpg,Bl122
5636,497.926221,497.953221,1,14937786,14938596,810,audio/Or61_14937786.jpg,Or61
5637,2083.034961,2083.040961,2,62491048,62491228,180,audio/Bl122_62491048.jpg,Bl122
5638,1984.463779,1984.491779,2,59533913,59534753,840,audio/Bl122_59533913.jpg,Bl122
5639,729.295271,729.353271,1,21878858,21880598,1740,audio/Or61_21878858.jpg,Or61
5640,15299.675664,15299.713664,1,458990269,458991409,1140,audio/Ti81_458990269.jpg,Ti81
5641,15054.72025,15054.947966,1,451641607,451648438,6831,audio/Ti81_451641607.jpg,Ti81
5642,15127.233981,15127.304981,1,453817019,453819149,2130,audio/Ti81_453817019.jpg,Ti81
5643,1941.417779,1941.429779,2,58242533,58242893,360,audio/Bl122_58242533.jpg,Bl122
5644,2128.339183,2128.409183,1,63850175,63852275,2100,audio/Bl122_63850175.jpg,Bl122
5645,15224.416443,15224.507443,1,456732493,456735223,2730,audio/Ti81_456732493.jpg,Ti81
5646,2120.360183,2120.451183,1,63610805,63613535,2730,audio/Bl122_63610805.jpg,Bl122
5647,1788.512115,1788.534115,2,53655363,53656023,660,audio/Bl122_53655363.jpg,Bl122
5648,8097.834141,8097.851141,1,242935024,242935534,510,audio/Li145_242935024.jpg,Li145
5649,616.001417,616.006417,2,18480042,18480192,150,audio/Or61_18480042.jpg,Or61
5650,1979.100779,1979.216779,1,59373023,59376503,3480,audio/Bl122_59373023.jpg,Bl122
5651,1938.445779,1938.587779,1,58153373,58157633,4260,audio/Bl122_58153373.jpg,Bl122
5652,603.206417,603.378417,1,18096192,18101352,5160,audio/Or61_18096192.jpg,Or61
5653,483.977221,484.156221,1,14519316,14524686,5370,audio/Or61_14519316.jpg,Or61
5654,197.179012,197.212012,1,5915370,5916360,990,audio/Or61_5915370.jpg,Or61
5655,1968.063779,1968.092779,1,59041913,59042783,870,audio/Bl122_59041913.jpg,Bl122
5656,2202.900183,2202.906183,2,66087005,66087185,180,audio/Bl122_66087005.jpg,Bl122
5657,15339.917971,15339.960971,1,460197539,460198829,1290,audio/Ti81_460197539.jpg,Ti81
5658,2199.153183,2199.365183,1,65974595,65980955,6360,audio/Bl122_65974595.jpg,Bl122
5659,1812.367013,1812.402013,1,54371010,54372060,1050,audio/Bl122_54371010.jpg,Bl122
5660,492.443221,492.486221,2,14773296,14774586,1290,audio/Or61_14773296.jpg,Or61
5661,1960.044779,1960.050779,2,58801343,58801523,180,audio/Bl122_58801343.jpg,Bl122
5662,2121.515183,2121.788183,1,63645455,63653645,8190,audio/Bl122_63645455.jpg,Bl122
5663,6332.339902,6332.347902,2,189970197,189970437,240,audio/Li145_189970197.jpg,Li145
5664,1811.979013,1812.046013,1,54359370,54361380,2010,audio/Bl122_54359370.jpg,Bl122
5665,2151.491183,2151.533183,2,64544735,64545995,1260,audio/Bl122_64544735.jpg,Bl122
5666,504.507221,504.519221,2,15135216,15135576,360,audio/Or61_15135216.jpg,Or61
5667,2153.166183,2153.172183,2,64594985,64595165,180,audio/Bl122_64594985.jpg,Bl122
5668,6947.441821,6947.461821,1,208423254,208423854,600,audio/Li145_208423254.jpg,Li145
5669,7563.020654,7563.069654,1,226890619,226892089,1470,audio/Li145_226890619.jpg,Li145
5670,2114.326183,2114.335183,1,63429785,63430055,270,audio/Bl122_63429785.jpg,Bl122
5671,15043.634693,15043.661751,1,451309040,451309852,812,audio/Ti81_451309040.jpg,Ti81
5672,2040.215815,2040.223815,1,61206474,61206714,240,audio/Li145_61206474.jpg,Li145
5673,1967.748779,1967.784779,1,59032463,59033543,1080,audio/Bl122_59032463.jpg,Bl122
5674,6287.777659,6287.779659,2,188633329,188633389,60,audio/Li145_188633329.jpg,Li145
5675,717.401271,717.433271,1,21522038,21522998,960,audio/Or61_21522038.jpg,Or61
5676,2013.875959,2013.896959,2,60416278,60416908,630,audio/Bl122_60416278.jpg,Bl122
5677,720.762271,720.926271,1,21622868,21627788,4920,audio/Or61_21622868.jpg,Or61
5678,750.136271,750.142271,2,22504088,22504268,180,audio/Or61_22504088.jpg,Or61
5679,15053.746966,15054.041966,1,451612408,451621258,8850,audio/Ti81_451612408.jpg,Ti81
5680,5888.490515,5888.517515,1,176654715,176655525,810,audio/Li145_176654715.jpg,Li145
5681,2134.348183,2134.357183,2,64030445,64030715,270,audio/Bl122_64030445.jpg,Bl122
5682,546.023416,546.029416,2,16380702,16380882,180,audio/Or61_16380702.jpg,Or61
5683,186.015971,186.221971,1,5580479,5586659,6180,audio/Or61_5580479.jpg,Or61
5684,533.831416,533.844416,1,16014942,16015332,390,audio/Or61_16014942.jpg,Or61
5685,527.687416,527.711416,1,15830622,15831342,720,audio/Or61_15830622.jpg,Or61
5686,1949.848779,1949.874779,2,58495463,58496243,780,audio/Bl122_58495463.jpg,Bl122
5687,15074.350682,15074.370682,1,452230520,452231120,600,audio/Ti81_452230520.jpg,Ti81
5688,1942.156779,1942.172779,2,58264703,58265183,480,audio/Bl122_58264703.jpg,Bl122
5689,737.188271,737.305271,1,22115648,22119158,3510,audio/Or61_22115648.jpg,Or61
5690,15340.982971,15341.004971,1,460229489,460230149,660,audio/Ti81_460229489.jpg,Ti81
5691,15317.383428,15317.401428,1,459521502,459522042,540,audio/Ti81_459521502.jpg,Ti81
5692,15032.026949,15032.03395,1,450960808,450961018,210,audio/Ti81_450960808.jpg,Ti81
5693,1792.988115,1793.025115,1,53789643,53790753,1110,audio/Bl122_53789643.jpg,Bl122
5694,818.225882,818.337882,1,24546776,24550136,3360,audio/Or61_24546776.jpg,Or61
5695,1945.912779,1945.922779,2,58377383,58377683,300,audio/Bl122_58377383.jpg,Bl122
5696,2126.317183,2126.332183,2,63789515,63789965,450,audio/Bl122_63789515.jpg,Bl122
5697,2158.428183,2158.498183,2,64752845,64754945,2100,audio/Bl122_64752845.jpg,Bl122
5698,1799.705115,1799.759115,1,53991153,53992773,1620,audio/Bl122_53991153.jpg,Bl122
5699,14928.905712,14929.05936,1,447867171,447871780,4609,audio/Ti81_447867171.jpg,Ti81
5700,614.685417,614.692417,2,18440562,18440772,210,audio/Or61_18440562.jpg,Or61
5701,1997.974779,1997.997779,1,59939243,59939933,690,audio/Bl122_59939243.jpg,Bl122
5702,15028.407579,15028.433818,1,450852227,450853014,787,audio/Ti81_450852227.jpg,Ti81
5703,2083.069961,2083.079961,2,62492098,62492398,300,audio/Bl122_62492098.jpg,Bl122
5704,8828.984654,8829.019654,1,264869539,264870589,1050,audio/Li145_264869539.jpg,Li145
5705,809.768882,809.806882,1,24293066,24294206,1140,audio/Or61_24293066.jpg,Or61
5706,1964.591779,1964.925779,1,58937753,58947773,10020,audio/Bl122_58937753.jpg,Bl122
5707,1952.337779,1952.353779,2,58570133,58570613,480,audio/Bl122_58570133.jpg,Bl122
5708,2051.634469,2051.640469,2,61549034,61549214,180,audio/Bl122_61549034.jpg,Bl122
5709,2145.910183,2145.913183,2,64377305,64377395,90,audio/Bl122_64377305.jpg,Bl122
5710,2217.058183,2217.071183,2,66511745,66512135,390,audio/Bl122_66511745.jpg,Bl122
5711,15236.808874,15236.880874,1,457104266,457106426,2160,audio/Ti81_457104266.jpg,Ti81
5712,2114.006183,2114.016183,2,63420185,63420485,300,audio/Bl122_63420185.jpg,Bl122
5713,1957.947779,1957.972779,2,58738433,58739183,750,audio/Bl122_58738433.jpg,Bl122
5714,1812.565013,1812.750013,1,54376950,54382500,5550,audio/Bl122_54376950.jpg,Bl122
5715,15206.10858,15206.307628,1,456183257,456189228,5971,audio/Ti81_456183257.jpg,Ti81
5716,613.846417,613.865417,1,18415392,18415962,570,audio/Or61_18415392.jpg,Or61
5717,1943.879779,1943.926779,1,58316393,58317803,1410,audio/Bl122_58316393.jpg,Bl122
5718,730.425271,730.443271,1,21912758,21913298,540,audio/Or61_21912758.jpg,Or61
5719,1779.999538,1780.095538,1,53399986,53402866,2880,audio/Bl122_53399986.jpg,Bl122
5720,2210.717183,2210.972183,1,66321515,66329165,7650,audio/Bl122_66321515.jpg,Bl122
5721,389.796161,389.862161,1,11693884,11695864,1980,audio/Or61_11693884.jpg,Or61
5722,2138.399183,2138.426183,2,64151975,64152785,810,audio/Bl122_64151975.jpg,Bl122
5723,2082.873961,2082.886961,2,62486218,62486608,390,audio/Bl122_62486218.jpg,Bl122
5724,1772.052657,1772.055657,2,53161579,53161669,90,audio/Bl122_53161579.jpg,Bl122
5725,2143.735183,2143.763183,1,64312055,64312895,840,audio/Bl122_64312055.jpg,Bl122
5726,2219.176183,2219.222183,2,66575285,66576665,1380,audio/Bl122_66575285.jpg,Bl122
5727,14944.476768,14944.645302,1,448334303,448339359,5056,audio/Ti81_448334303.jpg,Ti81
5728,2116.599183,2116.608183,2,63497975,63498245,270,audio/Bl122_63497975.jpg,Bl122
5729,3.652816,3.721816,1,109584,111654,2070,audio/Or61_109584.jpg,Or61
5730,2192.978183,2192.999183,2,65789345,65789975,630,audio/Bl122_65789345.jpg,Bl122
5731,83.772272,83.977272,1,2513168,2519318,6150,audio/Bl122_2513168.jpg,Bl122
5732,412.633165,412.791165,1,12378994,12383734,4740,audio/Or61_12378994.jpg,Or61
5733,1982.738779,1982.793779,1,59482163,59483813,1650,audio/Bl122_59482163.jpg,Bl122
5734,14942.697863,14942.738388,1,448280935,448282151,1216,audio/Ti81_448280935.jpg,Ti81
5735,2181.821183,2181.828183,2,65454635,65454845,210,audio/Bl122_65454635.jpg,Bl122
5736,563.323416,563.507416,1,16899702,16905222,5520,audio/Or61_16899702.jpg,Or61
5737,755.367271,755.455271,1,22661018,22663658,2640,audio/Or61_22661018.jpg,Or61
5738,1955.317779,1955.322779,2,58659533,58659683,150,audio/Bl122_58659533.jpg,Bl122
5739,746.195271,746.235271,1,22385858,22387058,1200,audio/Or61_22385858.jpg,Or61
5740,2200.743183,2200.747183,2,66022295,66022415,120,audio/Bl122_66022295.jpg,Bl122
5741,2159.408183,2159.414183,2,64782245,64782425,180,audio/Bl122_64782245.jpg,Bl122
5742,2062.174469,2062.180469,2,61865234,61865414,180,audio/Bl122_61865234.jpg,Bl122
5743,809.479882,809.494882,1,24284396,24284846,450,audio/Or61_24284396.jpg,Or61
5744,3464.916995,3464.932889,1,103947509,103947986,477,audio/Ti81_103947509.jpg,Ti81
5745,1793.629115,1793.633115,2,53808873,53808993,120,audio/Bl122_53808873.jpg,Bl122
5746,1970.090779,1970.121779,1,59102723,59103653,930,audio/Bl122_59102723.jpg,Bl122
5747,6426.071762,6426.246098,1,192782152,192787382,5230,audio/Ti81_192782152.jpg,Ti81
5748,4922.335507,4922.415507,1,147670065,147672465,2400,audio/Li145_147670065.jpg,Li145
5749,773.033271,773.045271,1,23190998,23191358,360,audio/Or61_23190998.jpg,Or61
5750,2125.745183,2125.872183,2,63772355,63776165,3810,audio/Bl122_63772355.jpg,Bl122
5751,15100.779823,15100.971823,1,453023394,453029154,5760,audio/Ti81_453023394.jpg,Ti81
5752,613.535417,613.710417,1,18406062,18411312,5250,audio/Or61_18406062.jpg,Or61
5753,2060.473469,2060.636469,1,61814204,61819094,4890,audio/Bl122_61814204.jpg,Bl122
5754,1788.864115,1788.908115,1,53665923,53667243,1320,audio/Bl122_53665923.jpg,Bl122
5755,497.894221,497.921221,1,14936826,14937636,810,audio/Or61_14936826.jpg,Or61
5756,5843.526404,5843.533404,1,175305792,175306002,210,audio/Li145_175305792.jpg,Li145
5757,15285.121439,15285.158439,1,458553643,458554753,1110,audio/Ti81_458553643.jpg,Ti81
5758,15224.921755,15224.941443,1,456747652,456748243,591,audio/Ti81_456747652.jpg,Ti81
5759,614.711417,614.739417,1,18441342,18442182,840,audio/Or61_18441342.jpg,Or61
5760,2123.538183,2123.716183,1,63706145,63711485,5340,audio/Bl122_63706145.jpg,Bl122
5761,1801.275115,1801.309115,2,54038253,54039273,1020,audio/Bl122_54038253.jpg,Bl122
5762,8084.878803,8085.075803,1,242546364,242552274,5910,audio/Li145_242546364.jpg,Li145
5763,214.895857,214.904857,2,6446875,6447145,270,audio/Or61_6446875.jpg,Or61
5764,797.856827,797.880827,1,23935704,23936424,720,audio/Or61_23935704.jpg,Or61
5765,7553.332715,7553.354715,1,226599981,226600641,660,audio/Li145_226599981.jpg,Li145
5766,560.508416,560.712416,1,16815252,16821372,6120,audio/Or61_16815252.jpg,Or61
5767,1940.904779,1940.907779,2,58227143,58227233,90,audio/Bl122_58227143.jpg,Bl122
5768,1954.643779,1954.845779,1,58639313,58645373,6060,audio/Bl122_58639313.jpg,Bl122
5769,15304.417538,15304.430938,1,459132526,459132928,402,audio/Ti81_459132526.jpg,Ti81
5770,15342.964971,15342.993846,1,460288949,460289815,866,audio/Ti81_460288949.jpg,Ti81
5771,15143.158403,15143.199403,1,454294752,454295982,1230,audio/Ti81_454294752.jpg,Ti81
5772,3413.915684,3413.939148,1,102417470,102418174,704,audio/Ti81_102417470.jpg,Ti81
5773,15239.219874,15239.327874,1,457176596,457179836,3240,audio/Ti81_457176596.jpg,Ti81
5774,1950.438779,1950.442779,2,58513163,58513283,120,audio/Bl122_58513163.jpg,Bl122
5775,2087.901961,2087.928961,1,62637058,62637868,810,audio/Bl122_62637058.jpg,Bl122
5776,2102.252961,2102.610961,1,63067588,63078328,10740,audio/Bl122_63067588.jpg,Bl122
5777,607.192417,607.200417,2,18215772,18216012,240,audio/Or61_18215772.jpg,Or61
5778,9164.970583,9164.986583,1,274949117,274949597,480,audio/Li145_274949117.jpg,Li145
5779,2231.400183,2231.426183,1,66942005,66942785,780,audio/Bl122_66942005.jpg,Bl122
5780,2144.569183,2144.580183,2,64337075,64337405,330,audio/Bl122_64337075.jpg,Bl122
5781,2222.460183,2222.488183,2,66673805,66674645,840,audio/Bl122_66673805.jpg,Bl122
5782,1950.682779,1950.819779,1,58520483,58524593,4110,audio/Bl122_58520483.jpg,Bl122
5783,2201.211183,2201.221183,2,66036335,66036635,300,audio/Bl122_66036335.jpg,Bl122
5784,477.337221,477.343221,2,14320116,14320296,180,audio/Or61_14320116.jpg,Or61
5785,8740.657692,8740.674692,1,262219730,262220240,510,audio/Li145_262219730.jpg,Li145
5786,708.473271,708.607271,1,21254198,21258218,4020,audio/Or61_21254198.jpg,Or61
5787,1962.433779,1962.634779,1,58873013,58879043,6030,audio/Bl122_58873013.jpg,Bl122
5788,15216.23758,15216.36058,1,456487127,456490817,3690,audio/Ti81_456487127.jpg,Ti81
5789,474.286221,474.480221,1,14228586,14234406,5820,audio/Or61_14228586.jpg,Or61
5790,6286.779659,6286.804659,2,188603389,188604139,750,audio/Li145_188603389.jpg,Li145
5791,1992.273779,1992.325779,1,59768213,59769773,1560,audio/Bl122_59768213.jpg,Bl122
5792,1955.221779,1955.227779,2,58656653,58656833,180,audio/Bl122_58656653.jpg,Bl122
5793,1950.185779,1950.193779,2,58505573,58505813,240,audio/Bl122_58505573.jpg,Bl122
5794,449.120725,449.166725,2,13473621,13475001,1380,audio/Li145_13473621.jpg,Li145
5795,6333.340902,6333.374902,1,190000227,190001247,1020,audio/Li145_190000227.jpg,Li145
5796,723.777271,723.807271,1,21713318,21714218,900,audio/Or61_21713318.jpg,Or61
5797,3417.565141,3417.587721,1,102526954,102527631,677,audio/Ti81_102526954.jpg,Ti81
5798,559.610416,559.626416,1,16788312,16788792,480,audio/Or61_16788312.jpg,Or61
5799,2066.336469,2066.553469,2,61990094,61996604,6510,audio/Bl122_61990094.jpg,Bl122
5800,5968.032227,5968.045227,1,179040966,179041356,390,audio/Li145_179040966.jpg,Li145
5801,15235.423874,15235.589874,1,457062716,457067696,4980,audio/Ti81_457062716.jpg,Ti81
5802,15347.805971,15347.824971,1,460434179,460434749,570,audio/Ti81_460434179.jpg,Ti81
5803,2094.007961,2094.101961,1,62820238,62823058,2820,audio/Bl122_62820238.jpg,Bl122
5804,1971.108779,1971.126779,2,59133263,59133803,540,audio/Bl122_59133263.jpg,Bl122
5805,1971.129779,1971.134779,2,59133893,59134043,150,audio/Bl122_59133893.jpg,Bl122
5806,3414.86255,3415.027299,1,102445876,102450818,4942,audio/Ti81_102445876.jpg,Ti81
5807,2099.349961,2099.391961,1,62980498,62981758,1260,audio/Bl122_62980498.jpg,Bl122
5808,2120.586183,2120.600183,1,63617585,63618005,420,audio/Bl122_63617585.jpg,Bl122
5809,2223.224183,2223.229183,2,66696725,66696875,150,audio/Bl122_66696725.jpg,Bl122
5810,5888.729515,5888.870515,1,176661885,176666115,4230,audio/Li145_176661885.jpg,Li145
5811,1982.694779,1982.726779,2,59480843,59481803,960,audio/Bl122_59480843.jpg,Bl122
5812,9164.567583,9164.859583,1,274937027,274945787,8760,audio/Li145_274937027.jpg,Li145
5813,732.519271,732.525271,2,21975578,21975758,180,audio/Or61_21975578.jpg,Or61
5814,702.036271,702.092271,1,21061088,21062768,1680,audio/Or61_21061088.jpg,Or61
5815,625.657417,625.693417,1,18769722,18770802,1080,audio/Or61_18769722.jpg,Or61
5816,15148.528716,15148.594716,1,454455861,454457841,1980,audio/Ti81_454455861.jpg,Ti81
5817,235.732781,235.940781,1,7071983,7078223,6240,audio/Or61_7071983.jpg,Or61
5818,9536.846343,9536.860343,1,286105390,286105810,420,audio/Li145_286105390.jpg,Li145
5819,15057.032966,15057.074966,1,451710988,451712248,1260,audio/Ti81_451710988.jpg,Ti81
5820,187.164971,187.235971,1,5614949,5617079,2130,audio/Or61_5614949.jpg,Or61
5821,1987.651779,1987.656779,2,59629553,59629703,150,audio/Bl122_59629553.jpg,Bl122
5822,761.344271,761.418271,1,22840328,22842548,2220,audio/Or61_22840328.jpg,Or61
5823,3580.088097,3580.137097,1,107402642,107404112,1470,audio/Li145_107402642.jpg,Li145
5824,15117.157981,15117.231981,1,453514739,453516959,2220,audio/Ti81_453514739.jpg,Ti81
5825,7551.600715,7551.701715,1,226548021,226551051,3030,audio/Li145_226548021.jpg,Li145
5826,708.872271,708.925271,1,21266168,21267758,1590,audio/Or61_21266168.jpg,Or61
5827,3470.920874,3470.965296,1,104127626,104128958,1332,audio/Ti81_104127626.jpg,Ti81
5828,2214.135183,2214.141183,2,66424055,66424235,180,audio/Bl122_66424055.jpg,Bl122
5829,2217.942183,2217.949183,2,66538265,66538475,210,audio/Bl122_66538265.jpg,Bl122
5830,546.212416,546.236416,1,16386372,16387092,720,audio/Or61_16386372.jpg,Or61
5831,727.978271,727.992271,1,21839348,21839768,420,audio/Or61_21839348.jpg,Or61
5832,2221.126183,2221.136183,1,66633785,66634085,300,audio/Bl122_66633785.jpg,Bl122
5833,811.841882,811.844882,2,24355256,24355346,90,audio/Or61_24355256.jpg,Or61
5834,1997.162779,1997.166779,2,59914883,59915003,120,audio/Bl122_59914883.jpg,Bl122
5835,15261.734358,15261.810358,1,457852030,457854310,2280,audio/Ti81_457852030.jpg,Ti81
5836,2192.851183,2192.896183,2,65785535,65786885,1350,audio/Bl122_65785535.jpg,Bl122
5837,1977.672779,1977.676779,2,59330183,59330303,120,audio/Bl122_59330183.jpg,Bl122
5838,15314.353428,15314.425428,1,459430602,459432762,2160,audio/Ti81_459430602.jpg,Ti81
5839,764.764271,764.786271,1,22942928,22943588,660,audio/Or61_22942928.jpg,Or61
5840,1949.883779,1949.895779,2,58496513,58496873,360,audio/Bl122_58496513.jpg,Bl122
5841,15134.786989,15134.997989,1,454043609,454049939,6330,audio/Ti81_454043609.jpg,Ti81
5842,509.102221,509.185221,1,15273066,15275556,2490,audio/Or61_15273066.jpg,Or61
5843,2052.991469,2053.021469,1,61589744,61590644,900,audio/Bl122_61589744.jpg,Bl122
5844,5841.150404,5841.154404,1,175234512,175234632,120,audio/Li145_175234512.jpg,Li145
5845,5967.960227,5967.996227,1,179038806,179039886,1080,audio/Li145_179038806.jpg,Li145
5846,494.218221,494.339221,1,14826546,14830176,3630,audio/Or61_14826546.jpg,Or61
5847,2164.167183,2164.178183,2,64925015,64925345,330,audio/Bl122_64925015.jpg,Bl122
5848,2206.258183,2206.366183,2,66187745,66190985,3240,audio/Bl122_66187745.jpg,Bl122
5849,9171.958804,9171.991804,1,275158764,275159754,990,audio/Li145_275158764.jpg,Li145
5850,15222.268443,15222.321443,1,456668053,456669643,1590,audio/Ti81_456668053.jpg,Ti81
5851,1979.286779,1979.539779,1,59378603,59386193,7590,audio/Bl122_59378603.jpg,Bl122
5852,866.865602,867.360602,1,26005968,26020818,14850,audio/Bl122_26005968.jpg,Bl122
5853,14947.095345,14947.199101,1,448412860,448415973,3113,audio/Ti81_448412860.jpg,Ti81
5854,2164.189183,2164.201183,2,64925675,64926035,360,audio/Bl122_64925675.jpg,Bl122
5855,2158.398183,2158.401183,2,64751945,64752035,90,audio/Bl122_64751945.jpg,Bl122
5856,543.408416,543.428416,1,16302252,16302852,600,audio/Or61_16302252.jpg,Or61
5857,606.136417,606.141417,2,18184092,18184242,150,audio/Or61_18184092.jpg,Or61
5858,1969.086779,1969.291779,1,59072603,59078753,6150,audio/Bl122_59072603.jpg,Bl122
5859,7493.230261,7493.240261,1,224796907,224797207,300,audio/Li145_224796907.jpg,Li145
5860,506.096221,506.145221,1,15182886,15184356,1470,audio/Or61_15182886.jpg,Or61
5861,1804.97805,1804.98705,2,54149341,54149611,270,audio/Bl122_54149341.jpg,Bl122
5862,1961.779779,1961.812779,1,58853393,58854383,990,audio/Bl122_58853393.jpg,Bl122
5863,15137.505266,15137.594765,1,454125157,454127842,2685,audio/Ti81_454125157.jpg,Ti81
5864,2153.038183,2153.093183,1,64591145,64592795,1650,audio/Bl122_64591145.jpg,Bl122
5865,809.294882,809.318882,1,24278846,24279566,720,audio/Or61_24278846.jpg,Or61
5866,15021.354528,15021.380515,1,450640635,450641415,780,audio/Ti81_450640635.jpg,Ti81
5867,751.79416,752.00916,1,22553824,22560274,6450,audio/Bl122_22553824.jpg,Bl122
5868,2184.478183,2184.506183,1,65534345,65535185,840,audio/Bl122_65534345.jpg,Bl122
5869,1977.652779,1977.670779,2,59329583,59330123,540,audio/Bl122_59329583.jpg,Bl122
5870,1980.397779,1980.668779,1,59411933,59420063,8130,audio/Bl122_59411933.jpg,Bl122
5871,1991.785779,1991.789779,2,59753573,59753693,120,audio/Bl122_59753573.jpg,Bl122
5872,793.233827,793.236827,2,23797014,23797104,90,audio/Or61_23797014.jpg,Or61
5873,2013.818959,2013.828959,2,60414568,60414868,300,audio/Bl122_60414568.jpg,Bl122
5874,487.831221,487.837221,2,14634936,14635116,180,audio/Or61_14634936.jpg,Or61
5875,15031.73662,15031.76885,1,450952098,450953065,967,audio/Ti81_450952098.jpg,Ti81
5876,15154.763257,15154.836257,1,454642897,454645087,2190,audio/Ti81_454642897.jpg,Ti81
5877,1801.516115,1801.521115,2,54045483,54045633,150,audio/Bl122_54045483.jpg,Bl122
5878,547.487416,547.509416,1,16424622,16425282,660,audio/Or61_16424622.jpg,Or61
5879,2129.996183,2129.999183,2,63899885,63899975,90,audio/Bl122_63899885.jpg,Bl122
5880,2013.231959,2013.263959,2,60396958,60397918,960,audio/Bl122_60396958.jpg,Bl122
5881,2155.375183,2155.411183,2,64661255,64662335,1080,audio/Bl122_64661255.jpg,Bl122
5882,1954.108779,1954.118779,2,58623263,58623563,300,audio/Bl122_58623263.jpg,Bl122
5883,2050.821469,2050.966469,1,61524644,61528994,4350,audio/Bl122_61524644.jpg,Bl122
5884,8740.933692,8740.948692,1,262228010,262228460,450,audio/Li145_262228010.jpg,Li145
5885,548.040416,548.097416,1,16441212,16442922,1710,audio/Or61_16441212.jpg,Or61
5886,2013.307959,2013.318959,2,60399238,60399568,330,audio/Bl122_60399238.jpg,Bl122
5887,15049.359966,15049.423966,1,451480798,451482718,1920,audio/Ti81_451480798.jpg,Ti81
5888,495.789221,495.793221,2,14873676,14873796,120,audio/Or61_14873676.jpg,Or61
5889,5711.835036,5711.839036,2,171355051,171355171,120,audio/Li145_171355051.jpg,Li145
5890,2164.371183,2164.379183,2,64931135,64931375,240,audio/Bl122_64931135.jpg,Bl122
5891,615.281417,615.287417,2,18458442,18458622,180,audio/Or61_18458442.jpg,Or61
5892,1989.078779,1989.123779,1,59672363,59673713,1350,audio/Bl122_59672363.jpg,Bl122
5893,503.256221,503.299221,2,15097686,15098976,1290,audio/Or61_15097686.jpg,Or61
5894,484.404221,484.411221,2,14532126,14532336,210,audio/Or61_14532126.jpg,Or61
5895,747.322271,747.339271,1,22419668,22420178,510,audio/Or61_22419668.jpg,Or61
5896,15031.99497,15032.003107,1,450959849,450960093,244,audio/Ti81_450959849.jpg,Ti81
5897,2126.939183,2127.178183,1,63808175,63815345,7170,audio/Bl122_63808175.jpg,Bl122
5898,606.827417,606.831417,2,18204822,18204942,120,audio/Or61_18204822.jpg,Or61
5899,790.003827,790.011827,2,23700114,23700354,240,audio/Or61_23700114.jpg,Or61
5900,2081.063287,2081.066287,2,62431898,62431988,90,audio/Bl122_62431898.jpg,Bl122
5901,15027.962025,15028.178591,1,450838860,450845357,6497,audio/Ti81_450838860.jpg,Ti81
5902,15105.227256,15105.365256,1,453156817,453160957,4140,audio/Ti81_453156817.jpg,Ti81
5903,605.784417,605.866417,1,18173532,18175992,2460,audio/Or61_18173532.jpg,Or61
5904,2121.323183,2121.328183,2,63639695,63639845,150,audio/Bl122_63639695.jpg,Bl122
5905,1808.567926,1808.570926,2,54257037,54257127,90,audio/Bl122_54257037.jpg,Bl122
5906,2059.293469,2059.317469,2,61778804,61779524,720,audio/Bl122_61778804.jpg,Bl122
5907,2123.339183,2123.535183,1,63700175,63706055,5880,audio/Bl122_63700175.jpg,Bl122
5908,1955.057779,1955.066779,2,58651733,58652003,270,audio/Bl122_58651733.jpg,Bl122
5909,2229.945183,2230.010183,1,66898355,66900305,1950,audio/Bl122_66898355.jpg,Bl122
5910,2156.935183,2156.940183,2,64708055,64708205,150,audio/Bl122_64708055.jpg,Bl122
5911,2133.619183,2133.687183,1,64008575,64010615,2040,audio/Bl122_64008575.jpg,Bl122
5912,9171.357804,9171.495804,1,275140734,275144874,4140,audio/Li145_275140734.jpg,Li145
5913,15042.182164,15042.268449,1,451265464,451268053,2589,audio/Ti81_451265464.jpg,Ti81
5914,7491.211261,7491.254261,1,224736337,224737627,1290,audio/Li145_224736337.jpg,Li145
5915,5697.162353,5697.199353,1,170914870,170915980,1110,audio/Li145_170914870.jpg,Li145
5916,2181.805183,2181.819183,2,65454155,65454575,420,audio/Bl122_65454155.jpg,Bl122
5917,482.657221,482.730221,1,14479716,14481906,2190,audio/Or61_14479716.jpg,Or61
5918,555.299416,555.355416,1,16658982,16660662,1680,audio/Or61_16658982.jpg,Or61
5919,15110.159256,15110.179256,1,453304777,453305377,600,audio/Ti81_453304777.jpg,Ti81
5920,15110.604256,15110.686256,1,453318127,453320587,2460,audio/Ti81_453318127.jpg,Ti81
5921,1952.592779,1952.645779,1,58577783,58579373,1590,audio/Bl122_58577783.jpg,Bl122
5922,504.657221,504.793221,1,15139716,15143796,4080,audio/Or61_15139716.jpg,Or61
5923,2161.076183,2161.450183,1,64832285,64843505,11220,audio/Bl122_64832285.jpg,Bl122
5924,7246.069735,7246.227735,1,217382092,217386832,4740,audio/Li145_217382092.jpg,Li145
5925,398.445529,398.588529,1,11953365,11957655,4290,audio/Or61_11953365.jpg,Or61
5926,4578.349102,4578.361906,1,137350473,137350857,384,audio/Ti81_137350473.jpg,Ti81
5927,598.739417,598.926417,1,17962182,17967792,5610,audio/Or61_17962182.jpg,Or61
5928,2083.110961,2083.149961,2,62493328,62494498,1170,audio/Bl122_62493328.jpg,Bl122
5929,2171.522183,2171.746183,1,65145665,65152385,6720,audio/Bl122_65145665.jpg,Bl122
5930,3418.769348,3418.861436,1,102563080,102565843,2763,audio/Ti81_102563080.jpg,Ti81
5931,2082.633961,2082.726961,2,62479018,62481808,2790,audio/Bl122_62479018.jpg,Bl122
5932,2134.699183,2134.778183,1,64040975,64043345,2370,audio/Bl122_64040975.jpg,Bl122
5933,2223.491183,2223.514183,2,66704735,66705425,690,audio/Bl122_66704735.jpg,Bl122
5934,2155.418183,2155.422183,2,64662545,64662665,120,audio/Bl122_64662545.jpg,Bl122
5935,404.473692,404.677692,1,12134210,12140330,6120,audio/Or61_12134210.jpg,Or61
5936,2033.132469,2033.205469,2,60993974,60996164,2190,audio/Bl122_60993974.jpg,Bl122
5937,14898.615855,14898.677163,1,446958475,446960314,1839,audio/Ti81_446958475.jpg,Ti81
5938,15344.008971,15344.044971,1,460320269,460321349,1080,audio/Ti81_460320269.jpg,Ti81
5939,15072.839682,15072.894682,1,452185190,452186840,1650,audio/Ti81_452185190.jpg,Ti81
5940,8888.722716,8888.729716,1,266661681,266661891,210,audio/Li145_266661681.jpg,Li145
5941,15348.680971,15348.707971,1,460460429,460461239,810,audio/Ti81_460460429.jpg,Ti81
5942,2064.157469,2064.349469,1,61924724,61930484,5760,audio/Bl122_61924724.jpg,Bl122
5943,15206.41758,15206.62258,1,456192527,456198677,6150,audio/Ti81_456192527.jpg,Ti81
5944,15057.285966,15057.380966,1,451718578,451721428,2850,audio/Ti81_451718578.jpg,Ti81
5945,2137.160183,2137.370183,1,64114805,64121105,6300,audio/Bl122_64114805.jpg,Bl122
5946,2156.653183,2156.763183,1,64699595,64702895,3300,audio/Bl122_64699595.jpg,Bl122
5947,1812.887013,1813.131013,1,54386610,54393930,7320,audio/Bl122_54386610.jpg,Bl122
5948,15081.577682,15081.819682,1,452447330,452454590,7260,audio/Ti81_452447330.jpg,Ti81
5949,2215.606183,2215.616183,2,66468185,66468485,300,audio/Bl122_66468185.jpg,Bl122
5950,565.834416,565.857416,2,16975032,16975722,690,audio/Or61_16975032.jpg,Or61
5951,798.300827,798.418827,1,23949024,23952564,3540,audio/Or61_23949024.jpg,Or61
5952,15272.808439,15272.947439,1,458184253,458188423,4170,audio/Ti81_458184253.jpg,Ti81
5953,9537.575343,9537.609343,1,286127260,286128280,1020,audio/Li145_286127260.jpg,Li145
5954,1971.604779,1971.606779,2,59148143,59148203,60,audio/Bl122_59148143.jpg,Bl122
5955,2208.772183,2208.896183,1,66263165,66266885,3720,audio/Bl122_66263165.jpg,Bl122
5956,2083.002961,2083.021961,1,62490088,62490658,570,audio/Bl122_62490088.jpg,Bl122
5957,657.892685,657.934685,1,19736780,19738040,1260,audio/Li145_19736780.jpg,Li145
5958,1756.511261,1756.572261,1,52695337,52697167,1830,audio/Bl122_52695337.jpg,Bl122
5959,485.337221,485.380221,2,14560116,14561406,1290,audio/Or61_14560116.jpg,Or61
5960,1979.919779,1979.923779,2,59397593,59397713,120,audio/Bl122_59397593.jpg,Bl122
5961,717.311271,717.349271,1,21519338,21520478,1140,audio/Or61_21519338.jpg,Or61
5962,599.558417,599.824417,1,17986752,17994732,7980,audio/Or61_17986752.jpg,Or61
5963,9166.064583,9166.068583,1,274981937,274982057,120,audio/Li145_274981937.jpg,Li145
5964,608.963417,608.993417,1,18268902,18269802,900,audio/Or61_18268902.jpg,Or61
5965,198.138012,198.500012,1,5944140,5955000,10860,audio/Or61_5944140.jpg,Or61
5966,1986.368779,1986.378779,2,59591063,59591363,300,audio/Bl122_59591063.jpg,Bl122
5967,1987.240779,1987.483779,1,59617223,59624513,7290,audio/Bl122_59617223.jpg,Bl122
5968,919.250879,919.424837,1,27577526,27582745,5219,audio/Ti81_27577526.jpg,Ti81
5969,2049.498469,2049.526469,2,61484954,61485794,840,audio/Bl122_61484954.jpg,Bl122
5970,2059.874469,2059.930469,1,61796234,61797914,1680,audio/Bl122_61796234.jpg,Bl122
5971,199.518012,199.711012,1,5985540,5991330,5790,audio/Or61_5985540.jpg,Or61
5972,636.340417,636.375417,2,19090212,19091262,1050,audio/Or61_19090212.jpg,Or61
5973,15345.050971,15345.557971,1,460351529,460366739,15210,audio/Ti81_460351529.jpg,Ti81
5974,396.022529,396.026529,1,11880675,11880795,120,audio/Or61_11880675.jpg,Or61
5975,2042.070469,2042.148469,2,61262114,61264454,2340,audio/Bl122_61262114.jpg,Bl122
5976,15165.298257,15165.327257,1,454958947,454959817,870,audio/Ti81_454958947.jpg,Ti81
5977,15223.165443,15223.443443,1,456694963,456703303,8340,audio/Ti81_456694963.jpg,Ti81
5978,1987.582779,1987.611779,2,59627483,59628353,870,audio/Bl122_59627483.jpg,Bl122
5979,2178.129183,2178.132183,2,65343875,65343965,90,audio/Bl122_65343875.jpg,Bl122
5980,543.960416,543.979416,1,16318812,16319382,570,audio/Or61_16318812.jpg,Or61
5981,2069.581469,2069.588469,2,62087444,62087654,210,audio/Bl122_62087444.jpg,Bl122
5982,2033.553469,2033.762469,1,61006604,61012874,6270,audio/Bl122_61006604.jpg,Bl122
5983,6333.479902,6333.510902,1,190004397,190005327,930,audio/Li145_190004397.jpg,Li145
5984,2046.784469,2046.788469,2,61403534,61403654,120,audio/Bl122_61403534.jpg,Bl122
5985,2115.098183,2115.101183,2,63452945,63453035,90,audio/Bl122_63452945.jpg,Bl122
5986,495.055221,495.070221,2,14851656,14852106,450,audio/Or61_14851656.jpg,Or61
5987,3541.379476,3541.415554,1,106241384,106242466,1082,audio/Ti81_106241384.jpg,Ti81
5988,2218.122183,2218.126183,2,66543665,66543785,120,audio/Bl122_66543665.jpg,Bl122
5989,2124.975183,2124.984183,2,63749255,63749525,270,audio/Bl122_63749255.jpg,Bl122
5990,1978.306779,1978.459779,1,59349203,59353793,4590,audio/Bl122_59349203.jpg,Bl122
5991,515.594221,515.876221,1,15467826,15476286,8460,audio/Or61_15467826.jpg,Or61
5992,179.992971,180.015971,1,5399789,5400479,690,audio/Or61_5399789.jpg,Or61
5993,391.921161,392.218161,1,11757634,11766544,8910,audio/Or61_11757634.jpg,Or61
5994,86.591668,86.601668,2,2597750,2598050,300,audio/Bl122_2597750.jpg,Bl122
5995,2131.992183,2132.008183,2,63959765,63960245,480,audio/Bl122_63959765.jpg,Bl122
5996,1975.293779,1975.435779,1,59258813,59263073,4260,audio/Bl122_59258813.jpg,Bl122
5997,2183.653183,2183.687183,2,65509595,65510615,1020,audio/Bl122_65509595.jpg,Bl122
5998,2160.754183,2160.774183,2,64822625,64823225,600,audio/Bl122_64822625.jpg,Bl122
5999,2111.799183,2112.048183,1,63353975,63361445,7470,audio/Bl122_63353975.jpg,Bl122
6000,2064.782469,2064.786469,2,61943474,61943594,120,audio/Bl122_61943474.jpg,Bl122
6001,737.540271,737.611271,1,22126208,22128338,2130,audio/Or61_22126208.jpg,Or61
6002,2111.532183,2111.652183,1,63345965,63349565,3600,audio/Bl122_63345965.jpg,Bl122
6003,554.037416,554.082416,1,16621122,16622472,1350,audio/Or61_16621122.jpg,Or61
6004,15210.48958,15210.87558,1,456314687,456326267,11580,audio/Ti81_456314687.jpg,Ti81
6005,705.028271,705.047271,1,21150848,21151418,570,audio/Or61_21150848.jpg,Or61
6006,2183.627183,2183.631183,2,65508815,65508935,120,audio/Bl122_65508815.jpg,Bl122
6007,1966.362779,1966.432779,1,58990883,58992983,2100,audio/Bl122_58990883.jpg,Bl122
6008,1768.393657,1768.484657,1,53051809,53054539,2730,audio/Bl122_53051809.jpg,Bl122
6009,2092.565961,2092.573961,2,62776978,62777218,240,audio/Bl122_62776978.jpg,Bl122
6010,8083.811803,8083.820803,2,242514354,242514624,270,audio/Li145_242514354.jpg,Li145
6011,754.282271,754.311271,2,22628468,22629338,870,audio/Or61_22628468.jpg,Or61
6012,2167.237183,2167.258183,1,65017115,65017745,630,audio/Bl122_65017115.jpg,Bl122
6013,2189.312183,2189.321183,2,65679365,65679635,270,audio/Bl122_65679365.jpg,Bl122
6014,1982.928779,1982.932779,2,59487863,59487983,120,audio/Bl122_59487863.jpg,Bl122
6015,3418.462052,3418.60359,1,102553861,102558107,4246,audio/Ti81_102553861.jpg,Ti81
6016,1973.364779,1973.371779,2,59200943,59201153,210,audio/Bl122_59200943.jpg,Bl122
6017,406.418692,406.424692,2,12192560,12192740,180,audio/Or61_12192560.jpg,Or61
6018,1486.394018,1486.408018,1,44591820,44592240,420,audio/Li145_44591820.jpg,Li145
6019,2047.889469,2047.929469,1,61436684,61437884,1200,audio/Bl122_61436684.jpg,Bl122
6020,5842.628404,5842.662404,1,175278852,175279872,1020,audio/Li145_175278852.jpg,Li145
6021,1977.635779,1977.647779,2,59329073,59329433,360,audio/Bl122_59329073.jpg,Bl122
6022,614.011417,614.052417,2,18420342,18421572,1230,audio/Or61_18420342.jpg,Or61
6023,715.697271,715.732271,1,21470918,21471968,1050,audio/Or61_21470918.jpg,Or61
6024,713.695271,713.790271,1,21410858,21413708,2850,audio/Or61_21410858.jpg,Or61
6025,513.109221,513.145221,1,15393276,15394356,1080,audio/Or61_15393276.jpg,Or61
6026,2100.853961,2100.862961,2,63025618,63025888,270,audio/Bl122_63025618.jpg,Bl122
6027,560.024416,560.214416,1,16800732,16806432,5700,audio/Or61_16800732.jpg,Or61
6028,96.756568,96.956568,1,2902697,2908697,6000,audio/Bl122_2902697.jpg,Bl122
6029,2039.363815,2039.380815,1,61180914,61181424,510,audio/Li145_61180914.jpg,Li145
6030,613.715417,613.733417,1,18411462,18412002,540,audio/Or61_18411462.jpg,Or61
6031,2053.840469,2053.847469,2,61615214,61615424,210,audio/Bl122_61615214.jpg,Bl122
6032,1972.172779,1972.175779,2,59165183,59165273,90,audio/Bl122_59165183.jpg,Bl122
6033,846.448955,846.70226,1,25393468,25401067,7599,audio/Ti81_25393468.jpg,Ti81
6034,786.434827,786.453827,1,23593044,23593614,570,audio/Or61_23593044.jpg,Or61
6035,179.982971,179.986971,2,5399489,5399609,120,audio/Or61_5399489.jpg,Or61
6036,2131.972183,2131.979183,2,63959165,63959375,210,audio/Bl122_63959165.jpg,Bl122
6037,3545.326389,3545.496689,1,106359791,106364900,5109,audio/Ti81_106359791.jpg,Ti81
6038,15328.710079,15328.723732,1,459861302,459861711,409,audio/Ti81_459861302.jpg,Ti81
6039,2142.769183,2142.962183,1,64283075,64288865,5790,audio/Bl122_64283075.jpg,Bl122
6040,1985.007779,1985.299779,1,59550233,59558993,8760,audio/Bl122_59550233.jpg,Bl122
6041,480.260221,480.487221,1,14407806,14414616,6810,audio/Or61_14407806.jpg,Or61
6042,2174.230183,2174.243183,2,65226905,65227295,390,audio/Bl122_65226905.jpg,Bl122
6043,1963.281779,1963.548779,1,58898453,58906463,8010,audio/Bl122_58898453.jpg,Bl122
6044,1944.255779,1944.269779,2,58327673,58328093,420,audio/Bl122_58327673.jpg,Bl122
6045,467.23511,467.23711,2,14017053,14017113,60,audio/Or61_14017053.jpg,Or61
6046,1787.272115,1787.285115,1,53618163,53618553,390,audio/Bl122_53618163.jpg,Bl122
6047,2125.251183,2125.287183,1,63757535,63758615,1080,audio/Bl122_63757535.jpg,Bl122
6048,3470.993283,3471.053581,1,104129798,104131607,1809,audio/Ti81_104129798.jpg,Ti81
6049,2003.921779,2003.925779,2,60117653,60117773,120,audio/Bl122_60117653.jpg,Bl122
6050,5685.259974,5685.289974,1,170557799,170558699,900,audio/Li145_170557799.jpg,Li145
6051,2126.075183,2126.109183,1,63782255,63783275,1020,audio/Bl122_63782255.jpg,Bl122
6052,7546.775781,7546.879781,1,226403273,226406393,3120,audio/Li145_226403273.jpg,Li145
6053,2173.540183,2173.566183,1,65206205,65206985,780,audio/Bl122_65206205.jpg,Bl122
6054,479.087221,479.206221,1,14372616,14376186,3570,audio/Or61_14372616.jpg,Or61
6055,472.977221,472.985221,2,14189316,14189556,240,audio/Or61_14189316.jpg,Or61
6056,795.924827,795.985827,1,23877744,23879574,1830,audio/Or61_23877744.jpg,Or61
6057,764.523271,764.542271,1,22935698,22936268,570,audio/Or61_22935698.jpg,Or61
6058,429.102969,429.106969,2,12873089,12873209,120,audio/Or61_12873089.jpg,Or61
6059,2158.240183,2158.258183,2,64747205,64747745,540,audio/Bl122_64747205.jpg,Bl122
6060,2013.777959,2013.779959,2,60413338,60413398,60,audio/Bl122_60413338.jpg,Bl122
6061,2089.302961,2089.417961,1,62679088,62682538,3450,audio/Bl122_62679088.jpg,Bl122
6062,5705.083085,5705.143085,1,171152492,171154292,1800,audio/Li145_171152492.jpg,Li145
6063,1801.246115,1801.252115,2,54037383,54037563,180,audio/Bl122_54037383.jpg,Bl122
6064,504.554221,504.557221,2,15136626,15136716,90,audio/Or61_15136626.jpg,Or61
6065,15340.355971,15340.393971,1,460210679,460211819,1140,audio/Ti81_460210679.jpg,Ti81
6066,1798.994115,1799.025115,2,53969823,53970753,930,audio/Bl122_53969823.jpg,Bl122
6067,15272.011439,15272.079439,1,458160343,458162383,2040,audio/Ti81_458160343.jpg,Ti81
6068,487.655221,487.662221,2,14629656,14629866,210,audio/Or61_14629656.jpg,Or61
6069,2125.186183,2125.243183,2,63755585,63757295,1710,audio/Bl122_63755585.jpg,Bl122
6070,15132.929989,15133.121989,1,453987899,453993659,5760,audio/Ti81_453987899.jpg,Ti81
6071,790.240827,790.253827,2,23707224,23707614,390,audio/Or61_23707224.jpg,Or61
6072,1972.600779,1972.630779,2,59178023,59178923,900,audio/Bl122_59178023.jpg,Bl122
6073,754.438271,754.501271,1,22633148,22635038,1890,audio/Or61_22633148.jpg,Or61
6074,7563.796654,7563.800654,2,226913899,226914019,120,audio/Li145_226913899.jpg,Li145
6075,15264.868358,15265.019358,1,457946050,457950580,4530,audio/Ti81_457946050.jpg,Ti81
6076,15329.195625,15329.279625,1,459875868,459878388,2520,audio/Ti81_459875868.jpg,Ti81
6077,816.355882,816.440882,1,24490676,24493226,2550,audio/Or61_24490676.jpg,Or61
6078,2093.133961,2093.218961,1,62794018,62796568,2550,audio/Bl122_62794018.jpg,Bl122
6079,15028.648016,15028.687375,1,450859440,450860621,1181,audio/Ti81_450859440.jpg,Ti81
6080,414.926165,414.930165,2,12447784,12447904,120,audio/Or61_12447784.jpg,Or61
6081,2160.059183,2160.212183,1,64801775,64806365,4590,audio/Bl122_64801775.jpg,Bl122
6082,1952.077779,1952.191779,2,58562333,58565753,3420,audio/Bl122_58562333.jpg,Bl122
6083,2223.538183,2223.649183,1,66706145,66709475,3330,audio/Bl122_66706145.jpg,Bl122
6084,1967.109779,1967.120779,2,59013293,59013623,330,audio/Bl122_59013293.jpg,Bl122
6085,1812.342013,1812.355013,1,54370260,54370650,390,audio/Bl122_54370260.jpg,Bl122
6086,5707.488085,5707.530085,1,171224642,171225902,1260,audio/Li145_171224642.jpg,Li145
6087,2000.541779,2000.565779,2,60016253,60016973,720,audio/Bl122_60016253.jpg,Bl122
6088,629.827417,629.881417,1,18894822,18896442,1620,audio/Or61_18894822.jpg,Or61
6089,15305.295373,15305.348373,1,459158861,459160451,1590,audio/Ti81_459158861.jpg,Ti81
6090,186.404971,186.420971,2,5592149,5592629,480,audio/Or61_5592149.jpg,Or61
6091,2185.771183,2185.785183,2,65573135,65573555,420,audio/Bl122_65573135.jpg,Bl122
6092,1981.555779,1981.560779,2,59446673,59446823,150,audio/Bl122_59446673.jpg,Bl122
6093,3467.511729,3467.566225,1,104025351,104026986,1635,audio/Ti81_104025351.jpg,Ti81
6094,5887.065515,5887.328515,1,176611965,176619855,7890,audio/Li145_176611965.jpg,Li145
6095,9134.758751,9134.764751,1,274042762,274042942,180,audio/Li145_274042762.jpg,Li145
6096,1757.245955,1757.343955,1,52717378,52720318,2940,audio/Bl122_52717378.jpg,Bl122
6097,475.765221,475.776221,2,14272956,14273286,330,audio/Or61_14272956.jpg,Or61
6098,397.660529,397.747529,1,11929815,11932425,2610,audio/Or61_11929815.jpg,Or61
6099,2205.134183,2205.138183,2,66154025,66154145,120,audio/Bl122_66154025.jpg,Bl122
6100,599.050417,599.111417,1,17971512,17973342,1830,audio/Or61_17971512.jpg,Or61
6101,15343.479971,15343.516971,1,460304399,460305509,1110,audio/Ti81_460304399.jpg,Ti81
6102,565.143416,565.146416,2,16954302,16954392,90,audio/Or61_16954302.jpg,Or61
6103,2177.115183,2177.123183,2,65313455,65313695,240,audio/Bl122_65313455.jpg,Bl122
6104,2222.442183,2222.457183,2,66673265,66673715,450,audio/Bl122_66673265.jpg,Bl122
6105,2005.033779,2005.061779,1,60151013,60151853,840,audio/Bl122_60151013.jpg,Bl122
6106,15103.858256,15103.895256,1,453115747,453116857,1110,audio/Ti81_453115747.jpg,Ti81
6107,1956.703779,1956.708779,2,58701113,58701263,150,audio/Bl122_58701113.jpg,Bl122
6108,15303.189373,15303.374373,1,459095681,459101231,5550,audio/Ti81_459095681.jpg,Ti81
6109,2054.005469,2054.015469,2,61620164,61620464,300,audio/Bl122_61620164.jpg,Bl122
6110,480.670221,480.848221,1,14420106,14425446,5340,audio/Or61_14420106.jpg,Or61
6111,2210.985183,2210.993183,2,66329555,66329795,240,audio/Bl122_66329555.jpg,Bl122
6112,1982.728779,1982.732779,2,59481863,59481983,120,audio/Bl122_59481863.jpg,Bl122
6113,2158.049183,2158.058183,2,64741475,64741745,270,audio/Bl122_64741475.jpg,Bl122
6114,547.543416,547.550416,1,16426302,16426512,210,audio/Or61_16426302.jpg,Or61
6115,15093.489823,15093.539823,1,452804694,452806194,1500,audio/Ti81_452804694.jpg,Ti81
6116,815.269882,815.284882,1,24458096,24458546,450,audio/Or61_24458096.jpg,Or61
6117,507.383221,507.438221,1,15221496,15223146,1650,audio/Or61_15221496.jpg,Or61
6118,1973.435779,1973.446779,2,59203073,59203403,330,audio/Bl122_59203073.jpg,Bl122
6119,2057.372469,2057.409469,1,61721174,61722284,1110,audio/Bl122_61721174.jpg,Bl122
6120,2200.049183,2200.064183,2,66001475,66001925,450,audio/Bl122_66001475.jpg,Bl122
6121,388.611161,388.814161,1,11658334,11664424,6090,audio/Or61_11658334.jpg,Or61
6122,1957.645779,1957.667779,1,58729373,58730033,660,audio/Bl122_58729373.jpg,Bl122
6123,472.430221,472.437221,2,14172906,14173116,210,audio/Or61_14172906.jpg,Or61
6124,8084.377803,8084.387803,1,242531334,242531634,300,audio/Li145_242531334.jpg,Li145
6125,1940.797779,1940.816779,2,58223933,58224503,570,audio/Bl122_58223933.jpg,Bl122
6126,414.727165,414.920165,1,12441814,12447604,5790,audio/Or61_12441814.jpg,Or61
6127,15280.537439,15280.732439,1,458416123,458421973,5850,audio/Ti81_458416123.jpg,Ti81
6128,746.860271,746.881271,1,22405808,22406438,630,audio/Or61_22405808.jpg,Or61
6129,9168.102583,9168.237583,1,275043077,275047127,4050,audio/Li145_275043077.jpg,Li145
6130,1941.332779,1941.358779,2,58239983,58240763,780,audio/Bl122_58239983.jpg,Bl122
6131,505.707221,505.748221,1,15171216,15172446,1230,audio/Or61_15171216.jpg,Or61
6132,553.568416,553.571416,2,16607052,16607142,90,audio/Or61_16607052.jpg,Or61
6133,812.773882,812.851882,1,24383216,24385556,2340,audio/Or61_24383216.jpg,Or61
6134,2233.449183,2233.557183,1,67003475,67006715,3240,audio/Bl122_67003475.jpg,Bl122
6135,1766.918823,1766.999823,1,53007564,53009994,2430,audio/Bl122_53007564.jpg,Bl122
6136,708.828271,708.869271,1,21264848,21266078,1230,audio/Or61_21264848.jpg,Or61
6137,15243.568874,15243.606874,1,457307066,457308206,1140,audio/Ti81_457307066.jpg,Ti81
6138,15307.601373,15307.796373,1,459228041,459233891,5850,audio/Ti81_459228041.jpg,Ti81
6139,6296.568561,6296.649561,1,188897056,188899486,2430,audio/Li145_188897056.jpg,Li145
6140,6956.846877,6956.863877,1,208705406,208705916,510,audio/Li145_208705406.jpg,Li145
6141,15121.389981,15121.455981,1,453641699,453643679,1980,audio/Ti81_453641699.jpg,Ti81
6142,563.670416,563.899416,1,16910112,16916982,6870,audio/Or61_16910112.jpg,Or61
6143,602.764417,602.946417,1,18082932,18088392,5460,audio/Or61_18082932.jpg,Or61
6144,15272.534439,15272.574439,1,458176033,458177233,1200,audio/Ti81_458176033.jpg,Ti81
6145,2158.099183,2158.127183,2,64742975,64743815,840,audio/Bl122_64742975.jpg,Bl122
6146,672.591078,672.660078,1,20177732,20179802,2070,audio/Or61_20177732.jpg,Or61
6147,2085.158961,2085.183961,1,62554768,62555518,750,audio/Bl122_62554768.jpg,Bl122
6148,15262.899358,15262.989358,1,457886980,457889680,2700,audio/Ti81_457886980.jpg,Ti81
6149,940.834645,941.003431,1,28225039,28230102,5063,audio/Ti81_28225039.jpg,Ti81
6150,178.774971,178.851971,1,5363249,5365559,2310,audio/Or61_5363249.jpg,Or61
6151,15218.210556,15218.34958,1,456546316,456550487,4171,audio/Ti81_456546316.jpg,Ti81
6152,1935.242613,1935.304613,1,58057278,58059138,1860,audio/Bl122_58057278.jpg,Bl122
6153,1793.904115,1793.908115,2,53817123,53817243,120,audio/Bl122_53817123.jpg,Bl122
6154,6311.686473,6311.987473,1,189350594,189359624,9030,audio/Li145_189350594.jpg,Li145
6155,2039.486469,2039.499469,1,61184594,61184984,390,audio/Bl122_61184594.jpg,Bl122
6156,15118.552981,15118.969981,1,453556589,453569099,12510,audio/Ti81_453556589.jpg,Ti81
6157,15264.173358,15264.201358,1,457925200,457926040,840,audio/Ti81_457925200.jpg,Ti81
6158,8738.953692,8739.041692,1,262168610,262171250,2640,audio/Li145_262168610.jpg,Li145
6159,6289.510659,6289.532659,1,188685319,188685979,660,audio/Li145_188685319.jpg,Li145
6160,1934.094613,1934.097613,2,58022838,58022928,90,audio/Bl122_58022838.jpg,Bl122
6161,786.625827,786.649827,1,23598774,23599494,720,audio/Or61_23598774.jpg,Or61
6162,2207.442183,2207.526183,1,66223265,66225785,2520,audio/Bl122_66223265.jpg,Bl122
6163,15236.964874,15237.031874,1,457108946,457110956,2010,audio/Ti81_457108946.jpg,Ti81
6164,2215.665183,2215.672183,2,66469955,66470165,210,audio/Bl122_66469955.jpg,Bl122
6165,15263.390358,15263.444358,1,457901710,457903330,1620,audio/Ti81_457901710.jpg,Ti81
6166,2150.514183,2150.537183,1,64515425,64516115,690,audio/Bl122_64515425.jpg,Bl122
6167,300.031938,300.117938,1,9000958,9003538,2580,audio/Or61_9000958.jpg,Or61
6168,5840.306404,5840.321404,2,175209192,175209642,450,audio/Li145_175209192.jpg,Li145
6169,2053.419469,2053.426469,2,61602584,61602794,210,audio/Bl122_61602584.jpg,Bl122
6170,1789.081115,1789.114115,1,53672433,53673423,990,audio/Bl122_53672433.jpg,Bl122
6171,318.917638,319.175638,1,9567529,9575269,7740,audio/Or61_9567529.jpg,Or61
6172,3467.220202,3467.256784,1,104016606,104017703,1097,audio/Ti81_104016606.jpg,Ti81
6173,5872.823637,5872.827637,1,176184709,176184829,120,audio/Li145_176184709.jpg,Li145
6174,386.795161,386.806161,1,11603854,11604184,330,audio/Or61_11603854.jpg,Or61
6175,556.835416,557.083416,1,16705062,16712502,7440,audio/Or61_16705062.jpg,Or61
6176,850.628611,850.803704,1,25518858,25524111,5253,audio/Ti81_25518858.jpg,Ti81
6177,3417.361538,3417.546723,1,102520846,102526401,5555,audio/Ti81_102520846.jpg,Ti81
6178,1983.142779,1983.145779,2,59494283,59494373,90,audio/Bl122_59494283.jpg,Bl122
6179,1769.159657,1769.162657,2,53074789,53074879,90,audio/Bl122_53074789.jpg,Bl122
6180,2012.651959,2012.658959,2,60379558,60379768,210,audio/Bl122_60379558.jpg,Bl122
6181,721.372271,721.395271,1,21641168,21641858,690,audio/Or61_21641168.jpg,Or61
6182,553.665416,553.668416,2,16609962,16610052,90,audio/Or61_16609962.jpg,Or61
6183,3465.816429,3465.881016,1,103974492,103976430,1938,audio/Ti81_103974492.jpg,Ti81
6184,2132.717183,2132.861183,1,63981515,63985835,4320,audio/Bl122_63981515.jpg,Bl122
6185,2057.572469,2057.756469,1,61727174,61732694,5520,audio/Bl122_61727174.jpg,Bl122
6186,1788.141115,1788.146115,2,53644233,53644383,150,audio/Bl122_53644233.jpg,Bl122
6187,1947.332779,1947.371779,2,58419983,58421153,1170,audio/Bl122_58419983.jpg,Bl122
6188,766.954271,766.965271,2,23008628,23008958,330,audio/Or61_23008628.jpg,Or61
6189,475.791221,475.815221,2,14273736,14274456,720,audio/Or61_14273736.jpg,Or61
6190,8864.311987,8864.506987,1,265929359,265935209,5850,audio/Li145_265929359.jpg,Li145
6191,2087.695961,2087.892961,1,62630878,62636788,5910,audio/Bl122_62630878.jpg,Bl122
6192,1967.844779,1967.848779,2,59035343,59035463,120,audio/Bl122_59035343.jpg,Bl122
6193,2092.040961,2092.046961,2,62761228,62761408,180,audio/Bl122_62761228.jpg,Bl122
6194,3447.98821,3448.110447,1,103439646,103443313,3667,audio/Ti81_103439646.jpg,Ti81
6195,481.076221,481.095221,2,14432286,14432856,570,audio/Or61_14432286.jpg,Or61
6196,511.613221,511.777221,1,15348396,15353316,4920,audio/Or61_15348396.jpg,Or61
6197,2181.010183,2181.040183,1,65430305,65431205,900,audio/Bl122_65430305.jpg,Bl122
6198,812.952882,812.969882,2,24388586,24389096,510,audio/Or61_24388586.jpg,Or61
6199,293.865896,293.869896,2,8815976,8816096,120,audio/Or61_8815976.jpg,Or61
6200,2038.783469,2038.792469,2,61163504,61163774,270,audio/Bl122_61163504.jpg,Bl122
6201,15067.924682,15067.954682,1,452037740,452038640,900,audio/Ti81_452037740.jpg,Ti81
6202,2193.864183,2193.868183,2,65815925,65816045,120,audio/Bl122_65815925.jpg,Bl122
6203,1790.062115,1790.067115,2,53701863,53702013,150,audio/Bl122_53701863.jpg,Bl122
6204,2000.844779,2000.865779,1,60025343,60025973,630,audio/Bl122_60025343.jpg,Bl122
6205,2126.673183,2126.678183,2,63800195,63800345,150,audio/Bl122_63800195.jpg,Bl122
6206,3468.306082,3468.835296,1,104049182,104065058,15876,audio/Ti81_104049182.jpg,Ti81
6207,3467.35518,3467.381419,1,104020655,104021442,787,audio/Ti81_104020655.jpg,Ti81
6208,1787.609115,1787.613115,2,53628273,53628393,120,audio/Bl122_53628273.jpg,Bl122
6209,187.649971,187.678971,1,5629499,5630369,870,audio/Or61_5629499.jpg,Or61
6210,518.772221,518.792221,1,15563166,15563766,600,audio/Or61_15563166.jpg,Or61
6211,814.480882,814.561882,1,24434426,24436856,2430,audio/Or61_24434426.jpg,Or61
6212,2233.988183,2233.991183,2,67019645,67019735,90,audio/Bl122_67019645.jpg,Bl122
6213,504.386221,504.404221,2,15131586,15132126,540,audio/Or61_15131586.jpg,Or61
6214,2195.200183,2195.334183,1,65856005,65860025,4020,audio/Bl122_65856005.jpg,Bl122
6215,7551.068715,7551.336715,1,226532061,226540101,8040,audio/Li145_226532061.jpg,Li145
6216,2047.760469,2047.768469,2,61432814,61433054,240,audio/Bl122_61432814.jpg,Bl122
6217,748.082271,748.123271,1,22442468,22443698,1230,audio/Or61_22442468.jpg,Or61
6218,15215.93558,15215.97858,1,456478067,456479357,1290,audio/Ti81_456478067.jpg,Ti81
6219,3421.847859,3421.932,1,102655435,102657960,2525,audio/Ti81_102655435.jpg,Ti81
6220,714.295271,714.431271,1,21428858,21432938,4080,audio/Or61_21428858.jpg,Or61
6221,6286.012659,6286.049659,1,188580379,188581489,1110,audio/Li145_188580379.jpg,Li145
6222,15087.3759,15087.5429,1,452621277,452626287,5010,audio/Ti81_452621277.jpg,Ti81
6223,504.851221,504.860221,2,15145536,15145806,270,audio/Or61_15145536.jpg,Or61
6224,2209.464183,2209.470183,2,66283925,66284105,180,audio/Bl122_66283925.jpg,Bl122
6225,2202.871183,2202.879183,2,66086135,66086375,240,audio/Bl122_66086135.jpg,Bl122
6226,15033.952406,15034.024436,1,451018572,451020733,2161,audio/Ti81_451018572.jpg,Ti81
6227,2082.862961,2082.866961,2,62485888,62486008,120,audio/Bl122_62485888.jpg,Bl122
6228,2201.816183,2201.821183,2,66054485,66054635,150,audio/Bl122_66054485.jpg,Bl122
6229,1945.678779,1945.712779,2,58370363,58371383,1020,audio/Bl122_58370363.jpg,Bl122
6230,768.328271,768.350271,1,23049848,23050508,660,audio/Or61_23049848.jpg,Or61
6231,3466.48476,3466.515918,1,103994542,103995477,935,audio/Ti81_103994542.jpg,Ti81
6232,1956.530779,1956.539779,2,58695923,58696193,270,audio/Bl122_58695923.jpg,Bl122
6233,395.919529,395.989529,1,11877585,11879685,2100,audio/Or61_11877585.jpg,Or61
6234,507.755221,507.797221,1,15232656,15233916,1260,audio/Or61_15232656.jpg,Or61
6235,9620.427674,9620.598226,1,288612830,288617946,5116,audio/Ti81_288612830.jpg,Ti81
6236,2128.628183,2128.748183,1,63858845,63862445,3600,audio/Bl122_63858845.jpg,Bl122
6237,5.186509,5.193509,2,155595,155805,210,audio/Or61_155595.jpg,Or61
6238,817.116882,817.182882,1,24513506,24515486,1980,audio/Or61_24513506.jpg,Or61
6239,2067.825469,2067.915469,1,62034764,62037464,2700,audio/Bl122_62034764.jpg,Bl122
6240,495.841221,495.858221,2,14875236,14875746,510,audio/Or61_14875236.jpg,Or61
6241,622.214417,622.260417,2,18666432,18667812,1380,audio/Or61_18666432.jpg,Or61
6242,726.964271,726.967271,2,21808928,21809018,90,audio/Or61_21808928.jpg,Or61
6243,15042.474827,15042.544965,1,451274244,451276348,2104,audio/Ti81_451274244.jpg,Ti81
6244,1757.487955,1757.673955,1,52724638,52730218,5580,audio/Bl122_52724638.jpg,Bl122
6245,619.703417,619.712417,2,18591102,18591372,270,audio/Or61_18591102.jpg,Or61
6246,2130.213183,2130.219183,2,63906395,63906575,180,audio/Bl122_63906395.jpg,Bl122
6247,8864.787987,8864.809987,1,265943639,265944299,660,audio/Li145_265943639.jpg,Li145
6248,2138.684183,2138.730183,2,64160525,64161905,1380,audio/Bl122_64160525.jpg,Bl122
6249,1770.518657,1770.577657,2,53115559,53117329,1770,audio/Bl122_53115559.jpg,Bl122
6250,14941.19169,14941.223605,1,448235750,448236708,958,audio/Ti81_448235750.jpg,Ti81
6251,15309.443373,15309.490373,1,459283301,459284711,1410,audio/Ti81_459283301.jpg,Ti81
6252,2176.287183,2176.319183,2,65288615,65289575,960,audio/Bl122_65288615.jpg,Bl122
6253,2219.668183,2219.889183,1,66590045,66596675,6630,audio/Bl122_66590045.jpg,Bl122
6254,2128.802183,2128.812183,2,63864065,63864365,300,audio/Bl122_63864065.jpg,Bl122
6255,1944.715779,1944.731779,2,58341473,58341953,480,audio/Bl122_58341473.jpg,Bl122
6256,2126.173183,2126.191183,1,63785195,63785735,540,audio/Bl122_63785195.jpg,Bl122
6257,2166.558183,2166.638183,2,64996745,64999145,2400,audio/Bl122_64996745.jpg,Bl122
6258,2035.388469,2035.470469,1,61061654,61064114,2460,audio/Bl122_61061654.jpg,Bl122
6259,15127.966981,15128.026981,1,453839009,453840809,1800,audio/Ti81_453839009.jpg,Ti81
6260,2040.394815,2040.402815,1,61211844,61212084,240,audio/Li145_61211844.jpg,Li145
6261,2036.526469,2036.583469,1,61095794,61097504,1710,audio/Bl122_61095794.jpg,Bl122
6262,1798.003115,1798.235115,1,53940093,53947053,6960,audio/Bl122_53940093.jpg,Bl122
6263,3450.728645,3451.050827,1,103521859,103531524,9665,audio/Ti81_103521859.jpg,Ti81
6264,2171.207183,2171.238183,2,65136215,65137145,930,audio/Bl122_65136215.jpg,Bl122
6265,490.051221,490.057221,2,14701536,14701716,180,audio/Or61_14701536.jpg,Or61
6266,2169.041183,2169.070183,2,65071235,65072105,870,audio/Bl122_65071235.jpg,Bl122
6267,2226.573183,2226.623183,2,66797195,66798695,1500,audio/Bl122_66797195.jpg,Bl122
6268,2220.023183,2220.053183,2,66600695,66601595,900,audio/Bl122_66600695.jpg,Bl122
6269,9046.925911,9046.943911,1,271407777,271408317,540,audio/Li145_271407777.jpg,Li145
6270,2185.746183,2185.765183,2,65572385,65572955,570,audio/Bl122_65572385.jpg,Bl122
6271,508.896221,509.024221,1,15266886,15270726,3840,audio/Or61_15266886.jpg,Or61
6272,386.673161,386.711161,1,11600194,11601334,1140,audio/Or61_11600194.jpg,Or61
6273,2131.755183,2131.766183,2,63952655,63952985,330,audio/Bl122_63952655.jpg,Bl122
6274,2177.906183,2177.973183,2,65337185,65339195,2010,audio/Bl122_65337185.jpg,Bl122
6275,2185.375183,2185.404183,1,65561255,65562125,870,audio/Bl122_65561255.jpg,Bl122
6276,496.219221,496.256221,2,14886576,14887686,1110,audio/Or61_14886576.jpg,Or61
6277,611.681417,611.699417,2,18350442,18350982,540,audio/Or61_18350442.jpg,Or61
6278,2047.775469,2047.798469,1,61433264,61433954,690,audio/Bl122_61433264.jpg,Bl122
6279,15204.98058,15205.01558,1,456149417,456150467,1050,audio/Ti81_456149417.jpg,Ti81
6280,15096.652823,15096.694823,1,452899584,452900844,1260,audio/Ti81_452899584.jpg,Ti81
6281,808.564882,808.681882,1,24256946,24260456,3510,audio/Or61_24256946.jpg,Or61
6282,15024.398601,15024.523866,1,450731958,450735715,3757,audio/Ti81_450731958.jpg,Ti81
6283,15259.762114,15259.801114,1,457792863,457794033,1170,audio/Ti81_457792863.jpg,Ti81
6284,537.861416,537.984416,1,16135842,16139532,3690,audio/Or61_16135842.jpg,Or61
6285,734.397271,734.403271,2,22031918,22032098,180,audio/Or61_22031918.jpg,Or61
6286,2029.588908,2029.602908,2,60887667,60888087,420,audio/Bl122_60887667.jpg,Bl122
6287,15071.088682,15071.142682,1,452132660,452134280,1620,audio/Ti81_452132660.jpg,Ti81
6288,15298.265664,15298.294664,1,458947969,458948839,870,audio/Ti81_458947969.jpg,Ti81
6289,2059.644469,2059.649469,2,61789334,61789484,150,audio/Bl122_61789334.jpg,Bl122
6290,15096.285823,15096.392823,1,452888574,452891784,3210,audio/Ti81_452888574.jpg,Ti81
6291,2220.429183,2220.432183,2,66612875,66612965,90,audio/Bl122_66612875.jpg,Bl122
6292,487.299221,487.302221,2,14618976,14619066,90,audio/Or61_14618976.jpg,Or61
6293,505.113221,505.156221,2,15153396,15154686,1290,audio/Or61_15153396.jpg,Or61
6294,15178.552145,15178.753145,1,455356564,455362594,6030,audio/Ti81_455356564.jpg,Ti81
6295,510.086221,510.116221,1,15302586,15303486,900,audio/Or61_15302586.jpg,Or61
6296,5888.451515,5888.474515,1,176653545,176654235,690,audio/Li145_176653545.jpg,Li145
6297,757.147271,757.343271,1,22714418,22720298,5880,audio/Or61_22714418.jpg,Or61
6298,2112.940183,2113.173183,1,63388205,63395195,6990,audio/Bl122_63388205.jpg,Bl122
6299,1949.821779,1949.828779,2,58494653,58494863,210,audio/Bl122_58494653.jpg,Bl122
6300,227.467275,227.490275,1,6824018,6824708,690,audio/Or61_6824018.jpg,Or61
6301,2037.484469,2037.522469,2,61124534,61125674,1140,audio/Bl122_61124534.jpg,Bl122
6302,710.556271,710.683271,1,21316688,21320498,3810,audio/Or61_21316688.jpg,Or61
6303,1979.978779,1980.334779,1,59399363,59410043,10680,audio/Bl122_59399363.jpg,Bl122
6304,3580.052097,3580.062097,2,107401562,107401862,300,audio/Li145_107401562.jpg,Li145
6305,6524.323903,6524.476903,1,195729717,195734307,4590,audio/Li145_195729717.jpg,Li145
6306,390.181161,390.262161,1,11705434,11707864,2430,audio/Or61_11705434.jpg,Or61
6307,2217.958183,2217.964183,2,66538745,66538925,180,audio/Bl122_66538745.jpg,Bl122
6308,2140.441183,2140.491183,2,64213235,64214735,1500,audio/Bl122_64213235.jpg,Bl122
6309,1970.007779,1970.023779,2,59100233,59100713,480,audio/Bl122_59100233.jpg,Bl122
6310,472.162221,472.170221,2,14164866,14165106,240,audio/Or61_14164866.jpg,Or61
6311,771.089271,771.092271,2,23132678,23132768,90,audio/Or61_23132678.jpg,Or61
6312,764.788271,764.798271,1,22943648,22943948,300,audio/Or61_22943648.jpg,Or61
6313,1983.285779,1983.506779,1,59498573,59505203,6630,audio/Bl122_59498573.jpg,Bl122
6314,1972.952779,1972.966779,1,59188583,59189003,420,audio/Bl122_59188583.jpg,Bl122
6315,538.954416,538.980416,1,16168632,16169412,780,audio/Or61_16168632.jpg,Or61
6316,397.579529,397.650529,1,11927385,11929515,2130,audio/Or61_11927385.jpg,Or61
6317,1788.796115,1788.826115,1,53663883,53664783,900,audio/Bl122_53663883.jpg,Bl122
6318,699.664271,699.734271,1,20989928,20992028,2100,audio/Or61_20989928.jpg,Or61
6319,485.197221,485.215221,1,14555916,14556456,540,audio/Or61_14555916.jpg,Or61
6320,9167.226583,9167.424583,1,275016797,275022737,5940,audio/Li145_275016797.jpg,Li145
6321,2166.487183,2166.495183,2,64994615,64994855,240,audio/Bl122_64994615.jpg,Bl122
6322,15231.658443,15231.695443,1,456949753,456950863,1110,audio/Ti81_456949753.jpg,Ti81
6323,2037.912469,2037.921469,2,61137374,61137644,270,audio/Bl122_61137374.jpg,Bl122
6324,563.576416,563.668416,1,16907292,16910052,2760,audio/Or61_16907292.jpg,Or61
6325,15106.790256,15106.938256,1,453203707,453208147,4440,audio/Ti81_453203707.jpg,Ti81
6326,610.126417,610.172417,1,18303792,18305172,1380,audio/Or61_18303792.jpg,Or61
6327,3451.579891,3451.73941,1,103547396,103552182,4786,audio/Ti81_103547396.jpg,Ti81
6328,15143.735403,15143.779403,1,454312062,454313382,1320,audio/Ti81_454312062.jpg,Ti81
6329,2227.571183,2227.624183,2,66827135,66828725,1590,audio/Bl122_66827135.jpg,Bl122
6330,2228.295183,2228.483183,1,66848855,66854495,5640,audio/Bl122_66848855.jpg,Bl122
6331,1815.427379,1815.430379,2,54462821,54462911,90,audio/Bl122_54462821.jpg,Bl122
6332,743.582271,743.594271,1,22307468,22307828,360,audio/Or61_22307468.jpg,Or61
6333,2162.839183,2162.843183,2,64885175,64885295,120,audio/Bl122_64885175.jpg,Bl122
6334,15208.83558,15208.87658,1,456265067,456266297,1230,audio/Ti81_456265067.jpg,Ti81
6335,765.298271,765.339271,1,22958948,22960178,1230,audio/Or61_22958948.jpg,Or61
6336,748.697271,748.763271,1,22460918,22462898,1980,audio/Or61_22460918.jpg,Or61
6337,15165.624257,15165.691257,1,454968727,454970737,2010,audio/Ti81_454968727.jpg,Ti81
6338,471.053221,471.075221,1,14131596,14132256,660,audio/Or61_14131596.jpg,Or61
6339,1974.063779,1974.103779,1,59221913,59223113,1200,audio/Bl122_59221913.jpg,Bl122
6340,2213.026183,2213.075183,1,66390785,66392255,1470,audio/Bl122_66390785.jpg,Bl122
6341,3583.396686,3583.414686,1,107501900,107502440,540,audio/Li145_107501900.jpg,Li145
6342,600.033417,600.126417,1,18001002,18003792,2790,audio/Or61_18001002.jpg,Or61
6343,15042.569942,15042.602169,1,451277098,451278065,967,audio/Ti81_451277098.jpg,Ti81
6344,1768.515657,1768.519657,2,53055469,53055589,120,audio/Bl122_53055469.jpg,Bl122
6345,792.993827,793.048827,1,23789814,23791464,1650,audio/Or61_23789814.jpg,Or61
6346,179.157971,179.295971,1,5374739,5378879,4140,audio/Or61_5374739.jpg,Or61
6347,3580.002097,3580.028097,1,107400062,107400842,780,audio/Li145_107400062.jpg,Li145
6348,805.378882,805.539882,1,24161366,24166196,4830,audio/Or61_24161366.jpg,Or61
6349,2110.090082,2110.277082,1,63302702,63308312,5610,audio/Bl122_63302702.jpg,Bl122
6350,2054.706469,2054.712469,2,61641194,61641374,180,audio/Bl122_61641194.jpg,Bl122
6351,514.695221,514.711221,2,15440856,15441336,480,audio/Or61_15440856.jpg,Or61
6352,526.820416,526.824416,2,15804612,15804732,120,audio/Or61_15804612.jpg,Or61
6353,209.475642,209.867642,1,6284269,6296029,11760,audio/Or61_6284269.jpg,Or61
6354,2231.176183,2231.180183,2,66935285,66935405,120,audio/Bl122_66935285.jpg,Bl122
6355,754.634271,754.640271,2,22639028,22639208,180,audio/Or61_22639028.jpg,Or61
6356,529.171416,529.181416,2,15875142,15875442,300,audio/Or61_15875142.jpg,Or61
6357,1983.762779,1983.833779,1,59512883,59515013,2130,audio/Bl122_59512883.jpg,Bl122
6358,726.988271,727.158271,1,21809648,21814748,5100,audio/Or61_21809648.jpg,Or61
6359,2227.069183,2227.073183,2,66812075,66812195,120,audio/Bl122_66812075.jpg,Bl122
6360,2137.134183,2137.142183,2,64114025,64114265,240,audio/Bl122_64114025.jpg,Bl122
6361,15264.340358,15264.365358,1,457930210,457930960,750,audio/Ti81_457930210.jpg,Ti81
6362,547.437416,547.478416,1,16423122,16424352,1230,audio/Or61_16423122.jpg,Or61
6363,15164.415257,15164.432257,1,454932457,454932967,510,audio/Ti81_454932457.jpg,Ti81
6364,2211.618183,2211.623183,2,66348545,66348695,150,audio/Bl122_66348545.jpg,Bl122
6365,621.479417,621.543417,1,18644382,18646302,1920,audio/Or61_18644382.jpg,Or61
6366,1969.534779,1969.545779,2,59086043,59086373,330,audio/Bl122_59086043.jpg,Bl122
6367,15207.70758,15207.76458,1,456231227,456232937,1710,audio/Ti81_456231227.jpg,Ti81
6368,4921.813507,4921.924507,1,147654405,147657735,3330,audio/Li145_147654405.jpg,Li145
6369,1804.99105,1805.09505,1,54149731,54152851,3120,audio/Bl122_54149731.jpg,Bl122
6370,15316.448428,15316.508428,1,459493452,459495252,1800,audio/Ti81_459493452.jpg,Ti81
6371,482.815221,482.823221,2,14484456,14484696,240,audio/Or61_14484456.jpg,Or61
6372,15063.571966,15063.751966,1,451907158,451912558,5400,audio/Ti81_451907158.jpg,Ti81
6373,2151.388183,2151.428183,2,64541645,64542845,1200,audio/Bl122_64541645.jpg,Bl122
6374,2181.780183,2181.786183,2,65453405,65453585,180,audio/Bl122_65453405.jpg,Bl122
6375,2129.446183,2129.513183,1,63883385,63885395,2010,audio/Bl122_63883385.jpg,Bl122
6376,657.994685,658.038685,1,19739840,19741160,1320,audio/Li145_19739840.jpg,Li145
6377,1966.014779,1966.025779,1,58980443,58980773,330,audio/Bl122_58980443.jpg,Bl122
6378,1984.354779,1984.368779,2,59530643,59531063,420,audio/Bl122_59530643.jpg,Bl122
6379,15036.069923,15036.146243,1,451082097,451084387,2290,audio/Ti81_451082097.jpg,Ti81
6380,2145.486183,2145.505183,1,64364585,64365155,570,audio/Bl122_64364585.jpg,Bl122
6381,1987.845779,1987.850779,2,59635373,59635523,150,audio/Bl122_59635373.jpg,Bl122
6382,2221.806183,2221.828183,2,66654185,66654845,660,audio/Bl122_66654185.jpg,Bl122
6383,2086.766961,2086.904961,1,62603008,62607148,4140,audio/Bl122_62603008.jpg,Bl122
6384,3412.24637,3412.263526,1,102367391,102367905,514,audio/Ti81_102367391.jpg,Ti81
6385,471.961221,472.022221,2,14158836,14160666,1830,audio/Or61_14158836.jpg,Or61
6386,620.131417,620.207417,1,18603942,18606222,2280,audio/Or61_18603942.jpg,Or61
6387,2083.651961,2083.689961,2,62509558,62510698,1140,audio/Bl122_62509558.jpg,Bl122
6388,560.315416,560.393416,1,16809462,16811802,2340,audio/Or61_16809462.jpg,Or61
6389,1937.744779,1937.915779,1,58132343,58137473,5130,audio/Bl122_58132343.jpg,Bl122
6390,6947.039821,6947.101821,1,208411194,208413054,1860,audio/Li145_208411194.jpg,Li145
6391,390.265161,390.315161,1,11707954,11709454,1500,audio/Or61_11707954.jpg,Or61
6392,1962.219779,1962.343779,1,58866593,58870313,3720,audio/Bl122_58866593.jpg,Bl122
6393,2040.515815,2040.528815,2,61215474,61215864,390,audio/Li145_61215474.jpg,Li145
6394,563.284416,563.295416,2,16898532,16898862,330,audio/Or61_16898532.jpg,Or61
6395,530.999416,531.159416,1,15929982,15934782,4800,audio/Or61_15929982.jpg,Or61
6396,1985.483779,1985.486779,2,59564513,59564603,90,audio/Bl122_59564513.jpg,Bl122
6397,15215.24658,15215.34558,1,456457397,456460367,2970,audio/Ti81_456457397.jpg,Ti81
6398,15096.102823,15096.168823,1,452883084,452885064,1980,audio/Ti81_452883084.jpg,Ti81
6399,2140.663183,2140.722183,1,64219895,64221665,1770,audio/Bl122_64219895.jpg,Bl122
6400,2181.471183,2181.637183,1,65444135,65449115,4980,audio/Bl122_65444135.jpg,Bl122
6401,502.508221,502.514221,1,15075246,15075426,180,audio/Or61_15075246.jpg,Or61
6402,549.280416,549.287416,2,16478412,16478622,210,audio/Or61_16478412.jpg,Or61
6403,15049.236966,15049.299966,1,451477108,451478998,1890,audio/Ti81_451477108.jpg,Ti81
6404,15119.538981,15119.717981,1,453586169,453591539,5370,audio/Ti81_453586169.jpg,Ti81
6405,15049.431966,15049.585966,1,451482958,451487578,4620,audio/Ti81_451482958.jpg,Ti81
6406,589.403867,589.512867,1,17682116,17685386,3270,audio/Or61_17682116.jpg,Or61
6407,750.320271,750.379271,1,22509608,22511378,1770,audio/Or61_22509608.jpg,Or61
6408,5872.947637,5872.967637,1,176188429,176189029,600,audio/Li145_176188429.jpg,Li145
6409,505.257221,505.367221,1,15157716,15161016,3300,audio/Or61_15157716.jpg,Or61
6410,600.405417,600.408417,2,18012162,18012252,90,audio/Or61_18012162.jpg,Or61
6411,2121.790183,2121.822183,1,63653705,63654665,960,audio/Bl122_63653705.jpg,Bl122
6412,187.485971,187.514971,1,5624579,5625449,870,audio/Or61_5624579.jpg,Or61
6413,502.729221,502.740221,2,15081876,15082206,330,audio/Or61_15081876.jpg,Or61
6414,947.717774,947.985208,1,28431533,28439556,8023,audio/Ti81_28431533.jpg,Ti81
6415,600.131417,600.206417,1,18003942,18006192,2250,audio/Or61_18003942.jpg,Or61
6416,15039.660469,15039.69024,1,451189814,451190707,893,audio/Ti81_451189814.jpg,Ti81
6417,534.130416,534.311416,1,16023912,16029342,5430,audio/Or61_16023912.jpg,Or61
6418,15221.878519,15221.894826,1,456656355,456656844,489,audio/Ti81_456656355.jpg,Ti81
6419,542.878416,542.895416,1,16286352,16286862,510,audio/Or61_16286352.jpg,Or61
6420,5911.083207,5911.105207,1,177332496,177333156,660,audio/Li145_177332496.jpg,Li145
6421,15116.730981,15116.795981,1,453501929,453503879,1950,audio/Ti81_453501929.jpg,Ti81
6422,15340.025971,15340.043971,1,460200779,460201319,540,audio/Ti81_460200779.jpg,Ti81
6423,3418.004135,3418.138609,1,102540124,102544158,4034,audio/Ti81_102540124.jpg,Ti81
6424,1939.965779,1940.292779,1,58198973,58208783,9810,audio/Bl122_58198973.jpg,Bl122
6425,15036.545248,15036.60088,1,451096357,451098026,1669,audio/Ti81_451096357.jpg,Ti81
6426,15116.863981,15116.913981,1,453505919,453507419,1500,audio/Ti81_453505919.jpg,Ti81
6427,1951.381779,1951.422779,2,58541453,58542683,1230,audio/Bl122_58541453.jpg,Bl122
6428,816.907882,817.021882,1,24507236,24510656,3420,audio/Or61_24507236.jpg,Or61
6429,15159.388257,15159.583257,1,454781647,454787497,5850,audio/Ti81_454781647.jpg,Ti81
6430,542.402416,542.437416,1,16272072,16273122,1050,audio/Or61_16272072.jpg,Or61
6431,385.324161,385.381161,1,11559724,11561434,1710,audio/Or61_11559724.jpg,Or61
6432,5696.997353,5697.120353,1,170909920,170913610,3690,audio/Li145_170909920.jpg,Li145
6433,1791.510115,1791.767115,1,53745303,53753013,7710,audio/Bl122_53745303.jpg,Bl122
6434,2038.740469,2038.755469,2,61162214,61162664,450,audio/Bl122_61162214.jpg,Bl122
6435,5690.535388,5690.696388,1,170716061,170720891,4830,audio/Li145_170716061.jpg,Li145
6436,2180.564183,2180.652183,1,65416925,65419565,2640,audio/Bl122_65416925.jpg,Bl122
6437,756.437271,756.578271,1,22693118,22697348,4230,audio/Or61_22693118.jpg,Or61
6438,542.153416,542.399416,1,16264602,16271982,7380,audio/Or61_16264602.jpg,Or61
6439,494.040221,494.092221,2,14821206,14822766,1560,audio/Or61_14821206.jpg,Or61
6440,9181.040829,9181.044829,1,275431224,275431344,120,audio/Li145_275431224.jpg,Li145
6441,2099.182961,2099.346961,1,62975488,62980408,4920,audio/Bl122_62975488.jpg,Bl122
6442,15073.576682,15073.858682,1,452207300,452215760,8460,audio/Ti81_452207300.jpg,Ti81
6443,2195.561183,2195.630183,2,65866835,65868905,2070,audio/Bl122_65866835.jpg,Bl122
6444,2209.700183,2209.709183,2,66291005,66291275,270,audio/Bl122_66291005.jpg,Bl122
6445,2006.819779,2006.822779,2,60204593,60204683,90,audio/Bl122_60204593.jpg,Bl122
6446,2070.185469,2070.188469,2,62105564,62105654,90,audio/Bl122_62105564.jpg,Bl122
6447,2039.494815,2039.518815,1,61184844,61185564,720,audio/Li145_61184844.jpg,Li145
6448,3628.552671,3628.718671,1,108856580,108861560,4980,audio/Li145_108856580.jpg,Li145
6449,3541.43044,3541.49528,1,106242913,106244858,1945,audio/Ti81_106242913.jpg,Ti81
6450,2194.817183,2194.902183,1,65844515,65847065,2550,audio/Bl122_65844515.jpg,Bl122
6451,2092.237961,2092.241961,2,62767138,62767258,120,audio/Bl122_62767138.jpg,Bl122
6452,626.742417,626.783417,2,18802272,18803502,1230,audio/Or61_18802272.jpg,Or61
6453,7554.937715,7555.102715,1,226648131,226653081,4950,audio/Li145_226648131.jpg,Li145
6454,2234.532183,2234.537183,2,67035965,67036115,150,audio/Bl122_67035965.jpg,Bl122
6455,2234.497183,2234.502183,2,67034915,67035065,150,audio/Bl122_67034915.jpg,Bl122
6456,5720.001018,5720.240018,1,171600030,171607200,7170,audio/Li145_171600030.jpg,Li145
6457,15043.668185,15043.708678,1,451310045,451311260,1215,audio/Ti81_451310045.jpg,Ti81
6458,550.335416,550.414416,1,16510062,16512432,2370,audio/Or61_16510062.jpg,Or61
6459,755.770271,755.797271,1,22673108,22673918,810,audio/Or61_22673108.jpg,Or61
6460,3579.726097,3579.746097,1,107391782,107392382,600,audio/Li145_107391782.jpg,Li145
6461,1956.116779,1956.279779,1,58683503,58688393,4890,audio/Bl122_58683503.jpg,Bl122
6462,2211.608183,2211.611183,2,66348245,66348335,90,audio/Bl122_66348245.jpg,Bl122
6463,15034.514521,15034.596769,1,451035435,451037903,2468,audio/Ti81_451035435.jpg,Ti81
6464,1784.77843,1785.12943,1,53543352,53553882,10530,audio/Bl122_53543352.jpg,Bl122
6465,15299.264664,15299.451664,1,458977939,458983549,5610,audio/Ti81_458977939.jpg,Ti81
6466,8097.070141,8097.095141,1,242912104,242912854,750,audio/Li145_242912104.jpg,Li145
6467,2200.442183,2200.722183,1,66013265,66021665,8400,audio/Bl122_66013265.jpg,Bl122
6468,615.259417,615.266417,2,18457782,18457992,210,audio/Or61_18457782.jpg,Or61
6469,475.282221,475.329221,1,14258466,14259876,1410,audio/Or61_14258466.jpg,Or61
6470,5719.817018,5719.878018,1,171594510,171596340,1830,audio/Li145_171594510.jpg,Li145
6471,2183.066183,2183.095183,1,65491985,65492855,870,audio/Bl122_65491985.jpg,Bl122
6472,1973.450779,1973.463779,2,59203523,59203913,390,audio/Bl122_59203523.jpg,Bl122
6473,2069.318469,2069.346469,1,62079554,62080394,840,audio/Bl122_62079554.jpg,Bl122
6474,1987.489779,1987.506779,2,59624693,59625203,510,audio/Bl122_59624693.jpg,Bl122
6475,2226.634183,2226.658183,2,66799025,66799745,720,audio/Bl122_66799025.jpg,Bl122
6476,15334.89101,15334.96001,1,460046730,460048800,2070,audio/Ti81_460046730.jpg,Ti81
6477,2139.678183,2139.686183,2,64190345,64190585,240,audio/Bl122_64190345.jpg,Bl122
6478,15132.460989,15132.546989,1,453973829,453976409,2580,audio/Ti81_453973829.jpg,Ti81
6479,2159.223183,2159.248183,2,64776695,64777445,750,audio/Bl122_64776695.jpg,Bl122
6480,1938.835779,1938.889779,1,58165073,58166693,1620,audio/Bl122_58165073.jpg,Bl122
6481,2152.738183,2152.745183,2,64582145,64582355,210,audio/Bl122_64582145.jpg,Bl122
6482,1938.158779,1938.164779,2,58144763,58144943,180,audio/Bl122_58144763.jpg,Bl122
6483,1972.640779,1972.661779,2,59179223,59179853,630,audio/Bl122_59179223.jpg,Bl122
6484,772.994271,773.017271,1,23189828,23190518,690,audio/Or61_23189828.jpg,Or61
6485,505.791221,505.824221,1,15173736,15174726,990,audio/Or61_15173736.jpg,Or61
6486,2221.208183,2221.216183,2,66636245,66636485,240,audio/Bl122_66636245.jpg,Bl122
6487,3439.604931,3439.65766,1,103188147,103189729,1582,audio/Ti81_103188147.jpg,Ti81
6488,15275.177439,15275.429439,1,458255323,458262883,7560,audio/Ti81_458255323.jpg,Ti81
6489,749.278271,749.286271,2,22478348,22478588,240,audio/Or61_22478348.jpg,Or61
6490,2229.246183,2229.252183,2,66877385,66877565,180,audio/Bl122_66877385.jpg,Bl122
6491,185.299971,185.340971,1,5558999,5560229,1230,audio/Or61_5558999.jpg,Or61
6492,15075.386682,15075.450682,1,452261600,452263520,1920,audio/Ti81_452261600.jpg,Ti81
6493,2132.320183,2132.339183,2,63969605,63970175,570,audio/Bl122_63969605.jpg,Bl122
6494,2096.078961,2096.081961,2,62882368,62882458,90,audio/Bl122_62882368.jpg,Bl122
6495,1971.146779,1971.189779,1,59134403,59135693,1290,audio/Bl122_59134403.jpg,Bl122
6496,15326.027488,15326.104488,1,459780824,459783134,2310,audio/Ti81_459780824.jpg,Ti81
6497,2177.596183,2177.625183,2,65327885,65328755,870,audio/Bl122_65327885.jpg,Bl122
6498,1774.566974,1774.573974,2,53237009,53237219,210,audio/Bl122_53237009.jpg,Bl122
6499,386.736161,386.783161,1,11602084,11603494,1410,audio/Or61_11602084.jpg,Or61
6500,7546.254781,7546.258781,2,226387643,226387763,120,audio/Li145_226387643.jpg,Li145
6501,2196.762183,2196.850183,1,65902865,65905505,2640,audio/Bl122_65902865.jpg,Bl122
6502,2154.390183,2154.397183,2,64631705,64631915,210,audio/Bl122_64631705.jpg,Bl122
6503,15273.043439,15273.112439,1,458191303,458193373,2070,audio/Ti81_458191303.jpg,Ti81
6504,14945.097352,14945.365732,1,448352920,448360971,8051,audio/Ti81_448352920.jpg,Ti81
6505,15057.500966,15057.529966,1,451725028,451725898,870,audio/Ti81_451725028.jpg,Ti81
6506,2222.798183,2223.080183,1,66683945,66692405,8460,audio/Bl122_66683945.jpg,Bl122
6507,771.391271,771.402271,2,23141738,23142068,330,audio/Or61_23141738.jpg,Or61
6508,813.575882,813.583882,2,24407276,24407516,240,audio/Or61_24407276.jpg,Or61
6509,753.207271,753.302271,1,22596218,22599068,2850,audio/Or61_22596218.jpg,Or61
6510,14929.48246,14929.696911,1,447884473,447890907,6434,audio/Ti81_447884473.jpg,Ti81
6511,15069.393682,15069.457682,1,452081810,452083730,1920,audio/Ti81_452081810.jpg,Ti81
6512,756.227271,756.308271,1,22686818,22689248,2430,audio/Or61_22686818.jpg,Or61
6513,2193.728183,2193.823183,1,65811845,65814695,2850,audio/Bl122_65811845.jpg,Bl122
6514,15138.376989,15138.452989,1,454151309,454153589,2280,audio/Ti81_454151309.jpg,Ti81
6515,2198.771183,2198.941183,1,65963135,65968235,5100,audio/Bl122_65963135.jpg,Bl122
6516,2100.572961,2100.574961,2,63017188,63017248,60,audio/Bl122_63017188.jpg,Bl122
6517,720.943271,720.949271,2,21628298,21628478,180,audio/Or61_21628298.jpg,Or61
6518,489.730221,489.770221,2,14691906,14693106,1200,audio/Or61_14691906.jpg,Or61
6519,2099.559961,2099.566961,2,62986798,62987008,210,audio/Bl122_62986798.jpg,Bl122
6520,2175.463183,2175.514183,2,65263895,65265425,1530,audio/Bl122_65263895.jpg,Bl122
6521,2143.821183,2144.061183,1,64314635,64321835,7200,audio/Bl122_64314635.jpg,Bl122
6522,609.094417,609.277417,1,18272832,18278322,5490,audio/Or61_18272832.jpg,Or61
6523,2151.581183,2151.588183,2,64547435,64547645,210,audio/Bl122_64547435.jpg,Bl122
6524,1984.292779,1984.305779,2,59528783,59529173,390,audio/Bl122_59528783.jpg,Bl122
6525,2212.355183,2212.522183,1,66370655,66375665,5010,audio/Bl122_66370655.jpg,Bl122
6526,1999.071779,1999.123779,1,59972153,59973713,1560,audio/Bl122_59972153.jpg,Bl122
6527,2171.030183,2171.033183,2,65130905,65130995,90,audio/Bl122_65130905.jpg,Bl122
6528,2140.725183,2140.767183,1,64221755,64223015,1260,audio/Bl122_64221755.jpg,Bl122
6529,1942.795779,1942.799779,2,58283873,58283993,120,audio/Bl122_58283873.jpg,Bl122
6530,1981.779779,1981.784779,2,59453393,59453543,150,audio/Bl122_59453393.jpg,Bl122
6531,2013.619959,2013.625959,2,60408598,60408778,180,audio/Bl122_60408598.jpg,Bl122
6532,1947.244779,1947.256779,2,58417343,58417703,360,audio/Bl122_58417343.jpg,Bl122
6533,2125.302183,2125.321183,2,63759065,63759635,570,audio/Bl122_63759065.jpg,Bl122
6534,15128.383981,15128.404981,1,453851519,453852149,630,audio/Ti81_453851519.jpg,Ti81
6535,725.121271,725.135271,1,21753638,21754058,420,audio/Or61_21753638.jpg,Or61
6536,719.775271,719.779271,2,21593258,21593378,120,audio/Or61_21593258.jpg,Or61
6537,632.184417,632.195417,2,18965532,18965862,330,audio/Or61_18965532.jpg,Or61
6538,2006.651779,2006.761779,2,60199553,60202853,3300,audio/Bl122_60199553.jpg,Bl122
6539,3446.565767,3446.866251,1,103396973,103405987,9014,audio/Ti81_103396973.jpg,Ti81
6540,2173.860183,2173.934183,1,65215805,65218025,2220,audio/Bl122_65215805.jpg,Bl122
6541,722.304271,722.573271,1,21669128,21677198,8070,audio/Or61_21669128.jpg,Or61
6542,15252.197074,15252.322074,1,457565912,457569662,3750,audio/Ti81_457565912.jpg,Ti81
6543,2119.637183,2119.719183,1,63589115,63591575,2460,audio/Bl122_63589115.jpg,Bl122
6544,2215.598183,2215.604183,2,66467945,66468125,180,audio/Bl122_66467945.jpg,Bl122
6545,9180.728829,9180.740829,1,275421864,275422224,360,audio/Li145_275421864.jpg,Li145
6546,2136.444183,2136.449183,2,64093325,64093475,150,audio/Bl122_64093325.jpg,Bl122
6547,6334.201902,6334.219902,1,190026057,190026597,540,audio/Li145_190026057.jpg,Li145
6548,528.679416,528.857416,2,15860382,15865722,5340,audio/Or61_15860382.jpg,Or61
6549,2122.276183,2122.412183,1,63668285,63672365,4080,audio/Bl122_63668285.jpg,Bl122
6550,9537.295343,9537.311343,1,286118860,286119340,480,audio/Li145_286118860.jpg,Li145
6551,15298.603664,15298.664664,1,458958109,458959939,1830,audio/Ti81_458958109.jpg,Ti81
6552,2211.530183,2211.540183,2,66345905,66346205,300,audio/Bl122_66345905.jpg,Bl122
6553,2013.320959,2013.369959,2,60399628,60401098,1470,audio/Bl122_60399628.jpg,Bl122
6554,2139.933183,2140.148183,1,64197995,64204445,6450,audio/Bl122_64197995.jpg,Bl122
6555,2181.459183,2181.464183,2,65443775,65443925,150,audio/Bl122_65443775.jpg,Bl122
6556,1988.009779,1988.060779,1,59640293,59641823,1530,audio/Bl122_59640293.jpg,Bl122
6557,2139.749183,2139.754183,2,64192475,64192625,150,audio/Bl122_64192475.jpg,Bl122
6558,494.646221,494.673221,1,14839386,14840196,810,audio/Or61_14839386.jpg,Or61
6559,554.476416,554.567416,1,16634292,16637022,2730,audio/Or61_16634292.jpg,Or61
6560,751.270271,751.486271,1,22538108,22544588,6480,audio/Or61_22538108.jpg,Or61
6561,7546.982781,7547.024781,1,226409483,226410743,1260,audio/Li145_226409483.jpg,Li145
6562,5888.591515,5888.715515,1,176657745,176661465,3720,audio/Li145_176657745.jpg,Li145
6563,498.511221,498.763221,1,14955336,14962896,7560,audio/Or61_14955336.jpg,Or61
6564,2038.214469,2038.233469,2,61146434,61147004,570,audio/Bl122_61146434.jpg,Bl122
6565,2100.251961,2100.334961,1,63007558,63010048,2490,audio/Bl122_63007558.jpg,Bl122
6566,2152.410183,2152.414183,2,64572305,64572425,120,audio/Bl122_64572305.jpg,Bl122
6567,2159.435183,2159.465183,2,64783055,64783955,900,audio/Bl122_64783055.jpg,Bl122
6568,2134.444183,2134.455183,2,64033325,64033655,330,audio/Bl122_64033325.jpg,Bl122
6569,1993.313779,1993.612779,1,59799413,59808383,8970,audio/Bl122_59799413.jpg,Bl122
6570,737.310271,737.337271,1,22119308,22120118,810,audio/Or61_22119308.jpg,Or61
6571,15328.987625,15329.011625,1,459869628,459870348,720,audio/Ti81_459869628.jpg,Ti81
6572,387.562161,387.652161,1,11626864,11629564,2700,audio/Or61_11626864.jpg,Or61
6573,2173.082183,2173.383183,1,65192465,65201495,9030,audio/Bl122_65192465.jpg,Bl122
6574,1770.690657,1770.719657,1,53120719,53121589,870,audio/Bl122_53120719.jpg,Bl122
6575,2197.783183,2197.791183,2,65933495,65933735,240,audio/Bl122_65933495.jpg,Bl122
6576,770.923271,770.930271,2,23127698,23127908,210,audio/Or61_23127698.jpg,Or61
6577,507.186221,507.297221,1,15215586,15218916,3330,audio/Or61_15215586.jpg,Or61
6578,2038.050469,2038.055469,2,61141514,61141664,150,audio/Bl122_61141514.jpg,Bl122
6579,748.449271,748.483271,1,22453478,22454498,1020,audio/Or61_22453478.jpg,Or61
6580,15314.658428,15314.708428,1,459439752,459441252,1500,audio/Ti81_459439752.jpg,Ti81
6581,15036.810537,15037.102191,1,451104316,451113065,8749,audio/Ti81_451104316.jpg,Ti81
6582,1976.765779,1976.768779,2,59302973,59303063,90,audio/Bl122_59302973.jpg,Bl122
6583,8083.956803,8083.958803,2,242518704,242518764,60,audio/Li145_242518704.jpg,Li145
6584,619.051417,619.059417,2,18571542,18571782,240,audio/Or61_18571542.jpg,Or61
6585,748.605271,748.630271,1,22458158,22458908,750,audio/Or61_22458158.jpg,Or61
6586,15238.289874,15238.431874,1,457148696,457152956,4260,audio/Ti81_457148696.jpg,Ti81
6587,2202.507183,2202.724183,1,66075215,66081725,6510,audio/Bl122_66075215.jpg,Bl122
6588,658.136685,658.382685,1,19744100,19751480,7380,audio/Li145_19744100.jpg,Li145
6589,612.681417,612.718417,2,18380442,18381552,1110,audio/Or61_18380442.jpg,Or61
6590,2167.971183,2168.007183,2,65039135,65040215,1080,audio/Bl122_65039135.jpg,Bl122
6591,15297.962664,15298.022664,1,458938879,458940679,1800,audio/Ti81_458938879.jpg,Ti81
6592,2174.608183,2174.619183,2,65238245,65238575,330,audio/Bl122_65238245.jpg,Bl122
6593,575.69871,575.72971,1,17270961,17271891,930,audio/Or61_17270961.jpg,Or61
6594,5717.788253,5718.015253,1,171533647,171540457,6810,audio/Li145_171533647.jpg,Li145
6595,1939.435779,1939.438779,2,58183073,58183163,90,audio/Bl122_58183073.jpg,Bl122
6596,2111.222183,2111.232183,2,63336665,63336965,300,audio/Bl122_63336665.jpg,Bl122
6597,472.394221,472.404221,2,14171826,14172126,300,audio/Or61_14171826.jpg,Or61
6598,15029.734149,15029.764425,1,450892024,450892932,908,audio/Ti81_450892024.jpg,Ti81
6599,15040.018602,15040.042192,1,451200558,451201265,707,audio/Ti81_451200558.jpg,Ti81
6600,9537.065343,9537.086343,1,286111960,286112590,630,audio/Li145_286111960.jpg,Li145
6601,3414.736907,3414.761632,1,102442107,102442848,741,audio/Ti81_102442107.jpg,Ti81
6602,2065.926469,2066.077469,1,61977794,61982324,4530,audio/Bl122_61977794.jpg,Bl122
6603,1999.013779,1999.025779,2,59970413,59970773,360,audio/Bl122_59970413.jpg,Bl122
6604,6333.377902,6333.382902,1,190001337,190001487,150,audio/Li145_190001337.jpg,Li145
6605,4905.954385,4905.994385,1,147178631,147179831,1200,audio/Li145_147178631.jpg,Li145
6606,15275.674439,15275.850439,1,458270233,458275513,5280,audio/Ti81_458270233.jpg,Ti81
6607,757.665271,757.683271,1,22729958,22730498,540,audio/Or61_22729958.jpg,Or61
6608,2202.099183,2202.104183,2,66062975,66063125,150,audio/Bl122_66062975.jpg,Bl122
6609,2122.066183,2122.075183,2,63661985,63662255,270,audio/Bl122_63661985.jpg,Bl122
6610,15328.682625,15328.704625,1,459860478,459861138,660,audio/Ti81_459860478.jpg,Ti81
6611,15033.753219,15033.833323,1,451012596,451014999,2403,audio/Ti81_451012596.jpg,Ti81
6612,2154.707183,2154.734183,1,64641215,64642025,810,audio/Bl122_64641215.jpg,Bl122
6613,15121.549981,15121.988981,1,453646499,453659669,13170,audio/Ti81_453646499.jpg,Ti81
6614,2039.509469,2039.612469,1,61185284,61188374,3090,audio/Bl122_61185284.jpg,Bl122
6615,1814.393379,1814.585379,1,54431801,54437561,5760,audio/Bl122_54431801.jpg,Bl122
6616,2067.737469,2067.741469,2,62032124,62032244,120,audio/Bl122_62032124.jpg,Bl122
6617,6953.038285,6953.205285,1,208591148,208596158,5010,audio/Li145_208591148.jpg,Li145
6618,15120.750909,15120.799981,1,453622527,453623999,1472,audio/Ti81_453622527.jpg,Ti81
6619,2126.702183,2126.729183,1,63801065,63801875,810,audio/Bl122_63801065.jpg,Bl122
6620,2141.817183,2141.843183,2,64254515,64255295,780,audio/Bl122_64254515.jpg,Bl122
6621,2076.087823,2076.140823,1,62282634,62284224,1590,audio/Bl122_62282634.jpg,Bl122
6622,757.624271,757.662271,1,22728728,22729868,1140,audio/Or61_22728728.jpg,Or61
6623,1800.502115,1800.620115,1,54015063,54018603,3540,audio/Bl122_54015063.jpg,Bl122
6624,15052.237966,15052.300966,1,451567138,451569028,1890,audio/Ti81_451567138.jpg,Ti81
6625,2125.588183,2125.635183,2,63767645,63769055,1410,audio/Bl122_63767645.jpg,Bl122
6626,504.309221,504.316221,2,15129276,15129486,210,audio/Or61_15129276.jpg,Or61
6627,1978.772779,1979.093779,1,59363183,59372813,9630,audio/Bl122_59363183.jpg,Bl122
6628,7492.496261,7492.586261,1,224774887,224777587,2700,audio/Li145_224774887.jpg,Li145
6629,828.52827,828.745245,1,24855848,24862357,6509,audio/Ti81_24855848.jpg,Ti81
6630,2124.585183,2124.592183,2,63737555,63737765,210,audio/Bl122_63737555.jpg,Bl122
6631,389.082161,389.086161,2,11672464,11672584,120,audio/Or61_11672464.jpg,Or61
6632,2112.664183,2112.667183,2,63379925,63380015,90,audio/Bl122_63379925.jpg,Bl122
6633,2095.973961,2095.986961,2,62879218,62879608,390,audio/Bl122_62879218.jpg,Bl122
6634,2061.347469,2061.656469,1,61840424,61849694,9270,audio/Bl122_61840424.jpg,Bl122
6635,471.637221,471.672221,1,14149116,14150166,1050,audio/Or61_14149116.jpg,Or61
6636,501.721221,501.727221,2,15051636,15051816,180,audio/Or61_15051636.jpg,Or61
6637,793.194827,793.201827,2,23795844,23796054,210,audio/Or61_23795844.jpg,Or61
6638,15043.968038,15044.12976,1,451319041,451323892,4851,audio/Ti81_451319041.jpg,Ti81
6639,493.396221,493.496221,2,14801886,14804886,3000,audio/Or61_14801886.jpg,Or61
6640,798.887827,798.952827,1,23966634,23968584,1950,audio/Or61_23966634.jpg,Or61
6641,353.114993,353.302993,1,10593449,10599089,5640,audio/Or61_10593449.jpg,Or61
6642,490.773221,490.777221,2,14723196,14723316,120,audio/Or61_14723196.jpg,Or61
6643,1794.781115,1794.784115,2,53843433,53843523,90,audio/Bl122_53843433.jpg,Bl122
6644,1966.030779,1966.229779,1,58980923,58986893,5970,audio/Bl122_58980923.jpg,Bl122
6645,15237.958874,15238.069874,1,457138766,457142096,3330,audio/Ti81_457138766.jpg,Ti81
6646,2001.080779,2001.099779,2,60032423,60032993,570,audio/Bl122_60032423.jpg,Bl122
6647,627.035417,627.038417,2,18811062,18811152,90,audio/Or61_18811062.jpg,Or61
6648,3416.197068,3416.365223,1,102485912,102490956,5044,audio/Ti81_102485912.jpg,Ti81
6649,721.982271,722.228271,1,21659468,21666848,7380,audio/Or61_21659468.jpg,Or61
6650,15069.679682,15070.064682,1,452090390,452101940,11550,audio/Ti81_452090390.jpg,Ti81
6651,631.384417,631.404417,1,18941532,18942132,600,audio/Or61_18941532.jpg,Or61
6652,15223.7125,15223.722866,1,456711375,456711685,310,audio/Ti81_456711375.jpg,Ti81
6653,2185.435183,2185.511183,2,65563055,65565335,2280,audio/Bl122_65563055.jpg,Bl122
6654,1975.145779,1975.158779,2,59254373,59254763,390,audio/Bl122_59254373.jpg,Bl122
6655,399.245529,399.255529,2,11977365,11977665,300,audio/Or61_11977365.jpg,Or61
6656,631.793417,631.814417,2,18953802,18954432,630,audio/Or61_18953802.jpg,Or61
6657,543.346416,543.376416,1,16300392,16301292,900,audio/Or61_16300392.jpg,Or61
6658,766.349271,766.382271,1,22990478,22991468,990,audio/Or61_22990478.jpg,Or61
6659,2167.196183,2167.208183,1,65015885,65016245,360,audio/Bl122_65015885.jpg,Bl122
6660,717.737271,717.776271,1,21532118,21533288,1170,audio/Or61_21532118.jpg,Or61
6661,2200.010183,2200.015183,2,66000305,66000455,150,audio/Bl122_66000305.jpg,Bl122
6662,1783.340323,1783.386323,1,53500209,53501589,1380,audio/Bl122_53500209.jpg,Bl122
6663,1958.592779,1958.743779,1,58757783,58762313,4530,audio/Bl122_58757783.jpg,Bl122
6664,749.741271,749.744271,2,22492238,22492328,90,audio/Or61_22492238.jpg,Or61
6665,86.604668,86.792668,1,2598140,2603780,5640,audio/Bl122_2598140.jpg,Bl122
6666,217.675413,217.722413,1,6530262,6531672,1410,audio/Or61_6530262.jpg,Or61
6667,733.989271,734.033271,1,22019678,22020998,1320,audio/Or61_22019678.jpg,Or61
6668,1946.348779,1946.355779,2,58390463,58390673,210,audio/Bl122_58390463.jpg,Bl122
6669,89.274871,89.477871,1,2678246,2684336,6090,audio/Bl122_2678246.jpg,Bl122
6670,605.383417,605.665417,1,18161502,18169962,8460,audio/Or61_18161502.jpg,Or61
6671,1981.176779,1981.435779,1,59435303,59443073,7770,audio/Bl122_59435303.jpg,Bl122
6672,2170.984183,2170.994183,2,65129525,65129825,300,audio/Bl122_65129525.jpg,Bl122
6673,406.520692,406.525692,2,12195620,12195770,150,audio/Or61_12195620.jpg,Or61
6674,1992.964779,1992.982779,2,59788943,59789483,540,audio/Bl122_59788943.jpg,Bl122
6675,2170.517183,2170.762183,1,65115515,65122865,7350,audio/Bl122_65115515.jpg,Bl122
6676,1798.969115,1798.972115,2,53969073,53969163,90,audio/Bl122_53969073.jpg,Bl122
6677,15034.62326,15034.663501,1,451038697,451039905,1208,audio/Ti81_451038697.jpg,Ti81
6678,2003.660779,2003.664779,2,60109823,60109943,120,audio/Bl122_60109823.jpg,Bl122
6679,2195.439183,2195.451183,2,65863175,65863535,360,audio/Bl122_65863175.jpg,Bl122
6680,7220.219918,7220.258918,1,216606597,216607767,1170,audio/Li145_216606597.jpg,Li145
6681,15118.385981,15118.450981,1,453551579,453553529,1950,audio/Ti81_453551579.jpg,Ti81
6682,2156.765183,2156.800183,1,64702955,64704005,1050,audio/Bl122_64702955.jpg,Bl122
6683,5707.165085,5707.172085,2,171214952,171215162,210,audio/Li145_171214952.jpg,Li145
6684,2039.791815,2039.809815,1,61193754,61194294,540,audio/Li145_61193754.jpg,Li145
6685,2168.153183,2168.182183,2,65044595,65045465,870,audio/Bl122_65044595.jpg,Bl122
6686,701.277271,701.294271,1,21038318,21038828,510,audio/Or61_21038318.jpg,Or61
6687,2066.092469,2066.102469,1,61982774,61983074,300,audio/Bl122_61982774.jpg,Bl122
6688,15259.556114,15259.582114,1,457786683,457787463,780,audio/Ti81_457786683.jpg,Ti81
6689,2151.007183,2151.015183,2,64530215,64530455,240,audio/Bl122_64530215.jpg,Bl122
6690,2180.670183,2180.745183,1,65420105,65422355,2250,audio/Bl122_65420105.jpg,Bl122
6691,15047.224966,15047.252966,1,451416748,451417588,840,audio/Ti81_451416748.jpg,Ti81
6692,2037.938469,2037.948469,2,61138154,61138454,300,audio/Bl122_61138154.jpg,Bl122
6693,3579.656097,3579.659097,1,107389682,107389772,90,audio/Li145_107389682.jpg,Li145
6694,7565.961558,7566.074558,1,226978846,226982236,3390,audio/Li145_226978846.jpg,Li145
6695,763.087271,763.407271,1,22892618,22902218,9600,audio/Or61_22892618.jpg,Or61
6696,15151.830716,15151.915716,1,454554921,454557471,2550,audio/Ti81_454554921.jpg,Ti81
6697,2153.454183,2153.508183,1,64603625,64605245,1620,audio/Bl122_64603625.jpg,Bl122
6698,2120.097183,2120.194183,1,63602915,63605825,2910,audio/Bl122_63602915.jpg,Bl122
6699,5705.989085,5706.015085,1,171179672,171180452,780,audio/Li145_171179672.jpg,Li145
6700,2087.118961,2087.154961,2,62613568,62614648,1080,audio/Bl122_62613568.jpg,Bl122
6701,611.751417,611.756417,2,18352542,18352692,150,audio/Or61_18352542.jpg,Or61
6702,2183.783183,2183.792183,2,65513495,65513765,270,audio/Bl122_65513495.jpg,Bl122
6703,704.918271,704.941271,1,21147548,21148238,690,audio/Or61_21147548.jpg,Or61
6704,15155.970257,15156.129257,1,454679107,454683877,4770,audio/Ti81_454679107.jpg,Ti81
6705,2161.533183,2161.549183,2,64845995,64846475,480,audio/Bl122_64845995.jpg,Bl122
6706,9172.869804,9172.875804,1,275186094,275186274,180,audio/Li145_275186094.jpg,Li145
6707,499.003221,499.030221,2,14970096,14970906,810,audio/Or61_14970096.jpg,Or61
6708,781.122878,781.156878,1,23433686,23434706,1020,audio/Or61_23433686.jpg,Or61
6709,2055.135469,2055.150469,1,61654064,61654514,450,audio/Bl122_61654064.jpg,Bl122
6710,329.017967,329.029967,1,9870539,9870899,360,audio/Or61_9870539.jpg,Or61
6711,815.287882,815.334882,1,24458636,24460046,1410,audio/Or61_24458636.jpg,Or61
6712,2136.809183,2136.868183,1,64104275,64106045,1770,audio/Bl122_64104275.jpg,Bl122
6713,2004.320779,2004.324779,2,60129623,60129743,120,audio/Bl122_60129623.jpg,Bl122
6714,15094.483823,15094.507823,1,452834514,452835234,720,audio/Ti81_452834514.jpg,Ti81
6715,1796.613115,1796.879115,1,53898393,53906373,7980,audio/Bl122_53898393.jpg,Bl122
6716,1769.715657,1769.824657,2,53091469,53094739,3270,audio/Bl122_53091469.jpg,Bl122
6717,2065.899469,2065.920469,1,61976984,61977614,630,audio/Bl122_61976984.jpg,Bl122
6718,773.074271,773.120271,1,23192228,23193608,1380,audio/Or61_23192228.jpg,Or61
6719,2226.678183,2226.688183,2,66800345,66800645,300,audio/Bl122_66800345.jpg,Bl122
6720,5888.526515,5888.581515,1,176655795,176657445,1650,audio/Li145_176655795.jpg,Li145
6721,803.785882,803.804882,1,24113576,24114146,570,audio/Or61_24113576.jpg,Or61
6722,491.112221,491.154221,2,14733366,14734626,1260,audio/Or61_14733366.jpg,Or61
6723,1784.63043,1784.70743,1,53538912,53541222,2310,audio/Bl122_53538912.jpg,Bl122
6724,792.918827,792.990827,1,23787564,23789724,2160,audio/Or61_23787564.jpg,Or61
6725,606.638417,606.708417,1,18199152,18201252,2100,audio/Or61_18199152.jpg,Or61
6726,2035.140469,2035.148469,2,61054214,61054454,240,audio/Bl122_61054214.jpg,Bl122
6727,2120.210183,2120.315183,1,63606305,63609455,3150,audio/Bl122_63606305.jpg,Bl122
6728,15094.631823,15094.846823,1,452838954,452845404,6450,audio/Ti81_452838954.jpg,Ti81
6729,15078.239682,15078.281682,1,452347190,452348450,1260,audio/Ti81_452347190.jpg,Ti81
6730,2128.761183,2128.765183,2,63862835,63862955,120,audio/Bl122_63862835.jpg,Bl122
6731,487.859221,487.865221,2,14635776,14635956,180,audio/Or61_14635776.jpg,Or61
6732,720.611271,720.623271,1,21618338,21618698,360,audio/Or61_21618338.jpg,Or61
6733,15215.38958,15215.43258,1,456461687,456462977,1290,audio/Ti81_456461687.jpg,Ti81
6734,2213.594183,2213.650183,1,66407825,66409505,1680,audio/Bl122_66407825.jpg,Bl122
6735,15070.234682,15070.291682,1,452107040,452108750,1710,audio/Ti81_452107040.jpg,Ti81
6736,2231.451183,2231.456183,2,66943535,66943685,150,audio/Bl122_66943535.jpg,Bl122
6737,15071.915682,15071.939682,1,452157470,452158190,720,audio/Ti81_452157470.jpg,Ti81
6738,737.416271,737.422271,1,22122488,22122668,180,audio/Or61_22122488.jpg,Or61
6739,3424.694511,3424.872127,1,102740835,102746163,5328,audio/Ti81_102740835.jpg,Ti81
6740,2189.099183,2189.188183,2,65672975,65675645,2670,audio/Bl122_65672975.jpg,Bl122
6741,1981.000779,1981.089779,1,59430023,59432693,2670,audio/Bl122_59430023.jpg,Bl122
6742,2070.195469,2070.260469,1,62105864,62107814,1950,audio/Bl122_62105864.jpg,Bl122
6743,551.928416,552.023416,1,16557852,16560702,2850,audio/Or61_16557852.jpg,Or61
6744,552.377416,552.495416,1,16571322,16574862,3540,audio/Or61_16571322.jpg,Or61
6745,535.267416,535.346416,1,16058022,16060392,2370,audio/Or61_16058022.jpg,Or61
6746,614.094417,614.173417,1,18422832,18425202,2370,audio/Or61_18422832.jpg,Or61
6747,490.430221,490.481221,2,14712906,14714436,1530,audio/Or61_14712906.jpg,Or61
6748,1938.916779,1938.928779,2,58167503,58167863,360,audio/Bl122_58167503.jpg,Bl122
6749,2226.734183,2226.739183,2,66802025,66802175,150,audio/Bl122_66802025.jpg,Bl122
6750,2133.398183,2133.425183,2,64001945,64002755,810,audio/Bl122_64001945.jpg,Bl122
6751,187.614971,187.635971,1,5628449,5629079,630,audio/Or61_5628449.jpg,Or61
6752,487.446221,487.449221,2,14623386,14623476,90,audio/Or61_14623386.jpg,Or61
6753,1950.644779,1950.675779,1,58519343,58520273,930,audio/Bl122_58519343.jpg,Bl122
6754,507.305221,507.377221,1,15219156,15221316,2160,audio/Or61_15219156.jpg,Or61
6755,1768.529657,1768.592657,1,53055889,53057779,1890,audio/Bl122_53055889.jpg,Bl122
6756,1958.329779,1958.358779,2,58749893,58750763,870,audio/Bl122_58749893.jpg,Bl122
6757,1808.854926,1808.880926,1,54265647,54266427,780,audio/Bl122_54265647.jpg,Bl122
6758,2185.672183,2185.712183,2,65570165,65571365,1200,audio/Bl122_65570165.jpg,Bl122
6759,728.374271,728.394271,1,21851228,21851828,600,audio/Or61_21851228.jpg,Or61
6760,2029.072908,2029.242908,1,60872187,60877287,5100,audio/Bl122_60872187.jpg,Bl122
6761,15165.442257,15165.511257,1,454963267,454965337,2070,audio/Ti81_454963267.jpg,Ti81
6762,499.253221,499.283221,1,14977596,14978496,900,audio/Or61_14977596.jpg,Or61
6763,2126.334183,2126.405183,2,63790025,63792155,2130,audio/Bl122_63790025.jpg,Bl122
6764,609.603417,609.605417,2,18288102,18288162,60,audio/Or61_18288102.jpg,Or61
6765,554.692416,554.767416,1,16640772,16643022,2250,audio/Or61_16640772.jpg,Or61
6766,472.581221,472.588221,2,14177436,14177646,210,audio/Or61_14177436.jpg,Or61
6767,6299.191561,6299.196561,2,188975746,188975896,150,audio/Li145_188975746.jpg,Li145
6768,201.541012,201.543012,2,6046230,6046290,60,audio/Or61_6046230.jpg,Or61
6769,2195.903183,2195.922183,1,65877095,65877665,570,audio/Bl122_65877095.jpg,Bl122
6770,316.054384,316.301384,1,9481631,9489041,7410,audio/Or61_9481631.jpg,Or61
6771,3419.844569,3419.960688,1,102595337,102598820,3483,audio/Ti81_102595337.jpg,Ti81
6772,559.178416,559.408416,1,16775352,16782252,6900,audio/Or61_16775352.jpg,Or61
6773,2147.105183,2147.125183,2,64413155,64413755,600,audio/Bl122_64413155.jpg,Bl122
6774,2145.394183,2145.411183,2,64361825,64362335,510,audio/Bl122_64361825.jpg,Bl122
6775,566.146416,566.355416,1,16984392,16990662,6270,audio/Or61_16984392.jpg,Or61
6776,15066.234682,15066.498682,1,451987040,451994960,7920,audio/Ti81_451987040.jpg,Ti81
6777,2148.233183,2148.267183,1,64446995,64448015,1020,audio/Bl122_64446995.jpg,Bl122
6778,747.815271,747.835271,1,22434458,22435058,600,audio/Or61_22434458.jpg,Or61
6779,2085.771961,2085.847961,1,62573158,62575438,2280,audio/Bl122_62573158.jpg,Bl122
6780,562.855416,563.051416,1,16885662,16891542,5880,audio/Or61_16885662.jpg,Or61
6781,2119.264183,2119.496183,1,63577925,63584885,6960,audio/Bl122_63577925.jpg,Bl122
6782,15033.090186,15033.194888,1,450992705,450995846,3141,audio/Ti81_450992705.jpg,Ti81
6783,2215.742183,2215.747183,2,66472265,66472415,150,audio/Bl122_66472265.jpg,Bl122
6784,2156.455183,2156.601183,1,64693655,64698035,4380,audio/Bl122_64693655.jpg,Bl122
6785,1950.507779,1950.510779,2,58515233,58515323,90,audio/Bl122_58515233.jpg,Bl122
6786,815.911882,815.914882,2,24477356,24477446,90,audio/Or61_24477356.jpg,Or61
6787,626.716417,626.720417,2,18801492,18801612,120,audio/Or61_18801492.jpg,Or61
6788,14768.693316,14768.870554,1,443060799,443066116,5317,audio/Ti81_443060799.jpg,Ti81
6789,8740.746692,8740.764692,1,262222400,262222940,540,audio/Li145_262222400.jpg,Li145
6790,15156.757257,15156.816257,1,454702717,454704487,1770,audio/Ti81_454702717.jpg,Ti81
6791,497.616221,497.677221,2,14928486,14930316,1830,audio/Or61_14928486.jpg,Or61
6792,636.442417,636.450417,2,19093272,19093512,240,audio/Or61_19093272.jpg,Or61
6793,15050.695966,15050.928909,1,451520878,451527867,6989,audio/Ti81_451520878.jpg,Ti81
6794,2216.043183,2216.065183,1,66481295,66481955,660,audio/Bl122_66481295.jpg,Bl122
6795,15026.838048,15026.859367,1,450805141,450805781,640,audio/Ti81_450805141.jpg,Ti81
6796,211.778765,211.783765,2,6353362,6353512,150,audio/Or61_6353362.jpg,Or61
6797,2119.501183,2119.613183,1,63585035,63588395,3360,audio/Bl122_63585035.jpg,Bl122
6798,1960.642779,1960.655779,2,58819283,58819673,390,audio/Bl122_58819283.jpg,Bl122
6799,275.514949,275.597949,1,8265448,8267938,2490,audio/Or61_8265448.jpg,Or61
6800,1960.411779,1960.471779,1,58812353,58814153,1800,audio/Bl122_58812353.jpg,Bl122
6801,15031.797297,15031.815021,1,450953918,450954450,532,audio/Ti81_450953918.jpg,Ti81
6802,2107.480377,2107.603377,1,63224411,63228101,3690,audio/Bl122_63224411.jpg,Bl122
6803,2224.558183,2224.563183,2,66736745,66736895,150,audio/Bl122_66736745.jpg,Bl122
6804,1801.665115,1801.691115,1,54049953,54050733,780,audio/Bl122_54049953.jpg,Bl122
6805,2083.226961,2083.413961,1,62496808,62502418,5610,audio/Bl122_62496808.jpg,Bl122
6806,2201.225183,2201.401183,1,66036755,66042035,5280,audio/Bl122_66036755.jpg,Bl122
6807,475.388221,475.439221,2,14261646,14263176,1530,audio/Or61_14261646.jpg,Or61
6808,1978.609779,1978.629779,2,59358293,59358893,600,audio/Bl122_59358293.jpg,Bl122
6809,756.594271,756.682271,1,22697828,22700468,2640,audio/Or61_22697828.jpg,Or61
6810,15265.628358,15265.810358,1,457968850,457974310,5460,audio/Ti81_457968850.jpg,Ti81
6811,764.389271,764.415271,1,22931678,22932458,780,audio/Or61_22931678.jpg,Or61
6812,15042.283334,15042.355995,1,451268500,451270679,2179,audio/Ti81_451268500.jpg,Ti81
6813,1968.968779,1968.983779,2,59069063,59069513,450,audio/Bl122_59069063.jpg,Bl122
6814,795.030827,795.123827,1,23850924,23853714,2790,audio/Or61_23850924.jpg,Or61
6815,2111.069183,2111.092183,1,63332075,63332765,690,audio/Bl122_63332075.jpg,Bl122
6816,3.583816,3.595816,2,107514,107874,360,audio/Or61_107514.jpg,Or61
6817,7569.371558,7569.390558,1,227081146,227081716,570,audio/Li145_227081146.jpg,Li145
6818,200.360012,200.362012,2,6010800,6010860,60,audio/Or61_6010800.jpg,Or61
6819,7568.267558,7568.269558,2,227048026,227048086,60,audio/Li145_227048026.jpg,Li145
6820,797.730827,797.848827,1,23931924,23935464,3540,audio/Or61_23931924.jpg,Or61
6821,403.204692,403.252692,2,12096140,12097580,1440,audio/Or61_12096140.jpg,Or61
6822,632.779417,632.786417,2,18983382,18983592,210,audio/Or61_18983382.jpg,Or61
6823,789.364827,789.452827,1,23680944,23683584,2640,audio/Or61_23680944.jpg,Or61
6824,2170.915183,2170.918183,2,65127455,65127545,90,audio/Bl122_65127455.jpg,Bl122
6825,214.059857,214.139857,1,6421795,6424195,2400,audio/Or61_6421795.jpg,Or61
6826,2209.720183,2209.723183,2,66291605,66291695,90,audio/Bl122_66291605.jpg,Bl122
6827,750.186271,750.231271,1,22505588,22506938,1350,audio/Or61_22505588.jpg,Or61
6828,5873.148637,5873.169637,1,176194459,176195089,630,audio/Li145_176194459.jpg,Li145
6829,2192.119183,2192.223183,1,65763575,65766695,3120,audio/Bl122_65763575.jpg,Bl122
6830,615.510417,615.693417,1,18465312,18470802,5490,audio/Or61_18465312.jpg,Or61
6831,3624.532464,3624.551464,1,108735973,108736543,570,audio/Li145_108735973.jpg,Li145
6832,810.071882,810.076882,2,24302156,24302306,150,audio/Or61_24302156.jpg,Or61
6833,1786.08743,1786.31043,1,53582622,53589312,6690,audio/Bl122_53582622.jpg,Bl122
6834,526.621416,526.648416,1,15798642,15799452,810,audio/Or61_15798642.jpg,Or61
6835,2139.129183,2139.138183,2,64173875,64174145,270,audio/Bl122_64173875.jpg,Bl122
6836,2133.591183,2133.608183,1,64007735,64008245,510,audio/Bl122_64007735.jpg,Bl122
6837,2219.329183,2219.595183,1,66579875,66587855,7980,audio/Bl122_66579875.jpg,Bl122
6838,511.786221,511.883221,1,15353586,15356496,2910,audio/Or61_15353586.jpg,Or61
6839,491.462221,491.746221,1,14743866,14752386,8520,audio/Or61_14743866.jpg,Or61
6840,550.982416,551.007416,1,16529472,16530222,750,audio/Or61_16529472.jpg,Or61
6841,15036.152172,15036.210578,1,451084565,451086317,1752,audio/Ti81_451084565.jpg,Ti81
6842,395.772529,395.823529,1,11873175,11874705,1530,audio/Or61_11873175.jpg,Or61
6843,414.714165,414.716165,2,12441424,12441484,60,audio/Or61_12441424.jpg,Or61
6844,2038.728469,2038.735469,2,61161854,61162064,210,audio/Bl122_61161854.jpg,Bl122
6845,2123.973183,2124.216183,1,63719195,63726485,7290,audio/Bl122_63719195.jpg,Bl122
6846,484.386221,484.400221,2,14531586,14532006,420,audio/Or61_14531586.jpg,Or61
6847,2162.341183,2162.433183,2,64870235,64872995,2760,audio/Bl122_64870235.jpg,Bl122
6848,2042.585469,2042.738469,1,61277564,61282154,4590,audio/Bl122_61277564.jpg,Bl122
6849,793.611827,793.730827,1,23808354,23811924,3570,audio/Or61_23808354.jpg,Or61
6850,2038.675469,2038.692469,2,61160264,61160774,510,audio/Bl122_61160264.jpg,Bl122
6851,15306.603373,15306.893373,1,459198101,459206801,8700,audio/Ti81_459198101.jpg,Ti81
6852,2136.431183,2136.442183,2,64092935,64093265,330,audio/Bl122_64092935.jpg,Bl122
6853,483.161221,483.408221,1,14494836,14502246,7410,audio/Or61_14494836.jpg,Or61
6854,2132.913183,2132.952183,1,63987395,63988565,1170,audio/Bl122_63987395.jpg,Bl122
6855,494.969221,494.994221,1,14849076,14849826,750,audio/Or61_14849076.jpg,Or61
6856,9166.794583,9166.819583,1,275003837,275004587,750,audio/Li145_275003837.jpg,Li145
6857,2013.519959,2013.603959,1,60405598,60408118,2520,audio/Bl122_60405598.jpg,Bl122
6858,2226.533183,2226.552183,2,66795995,66796565,570,audio/Bl122_66795995.jpg,Bl122
6859,28.535557,28.652557,1,856066,859576,3510,audio/Li145_856066.jpg,Li145
6860,2190.891183,2190.913183,2,65726735,65727395,660,audio/Bl122_65726735.jpg,Bl122
6861,499.039221,499.251221,1,14971176,14977536,6360,audio/Or61_14971176.jpg,Or61
6862,3449.236064,3449.470329,1,103477081,103484109,7028,audio/Ti81_103477081.jpg,Ti81
6863,2098.671961,2098.698961,1,62960158,62960968,810,audio/Bl122_62960158.jpg,Bl122
6864,512.094221,512.131221,1,15362826,15363936,1110,audio/Or61_15362826.jpg,Or61
6865,2210.153183,2210.199183,2,66304595,66305975,1380,audio/Bl122_66304595.jpg,Bl122
6866,1940.501779,1940.603779,1,58215053,58218113,3060,audio/Bl122_58215053.jpg,Bl122
6867,1797.802115,1797.929115,1,53934063,53937873,3810,audio/Bl122_53934063.jpg,Bl122
6868,1994.660779,1994.972779,1,59839823,59849183,9360,audio/Bl122_59839823.jpg,Bl122
6869,2121.286183,2121.319183,2,63638585,63639575,990,audio/Bl122_63638585.jpg,Bl122
6870,430.285962,430.370962,1,12908578,12911128,2550,audio/Or61_12908578.jpg,Or61
6871,9164.310583,9164.493583,1,274929317,274934807,5490,audio/Li145_274929317.jpg,Li145
6872,1969.639779,1969.645779,2,59089193,59089373,180,audio/Bl122_59089193.jpg,Bl122
6873,2137.872183,2137.943183,1,64136165,64138295,2130,audio/Bl122_64136165.jpg,Bl122
6874,483.490221,483.526221,2,14504706,14505786,1080,audio/Or61_14504706.jpg,Or61
6875,1960.691779,1960.900779,1,58820753,58827023,6270,audio/Bl122_58820753.jpg,Bl122
6876,1799.666115,1799.669115,2,53989983,53990073,90,audio/Bl122_53989983.jpg,Bl122
6877,804.411882,804.441882,1,24132356,24133256,900,audio/Or61_24132356.jpg,Or61
6878,2061.661469,2061.764469,1,61849844,61852934,3090,audio/Bl122_61849844.jpg,Bl122
6879,793.353827,793.363827,2,23800614,23800914,300,audio/Or61_23800614.jpg,Or61
6880,2039.645815,2039.659815,1,61189374,61189794,420,audio/Li145_61189374.jpg,Li145
6881,2129.656183,2129.751183,1,63889685,63892535,2850,audio/Bl122_63889685.jpg,Bl122
6882,2095.531961,2095.567961,2,62865958,62867038,1080,audio/Bl122_62865958.jpg,Bl122
6883,15138.092989,15138.167989,1,454142789,454145039,2250,audio/Ti81_454142789.jpg,Ti81
6884,15238.115874,15238.186874,1,457143476,457145606,2130,audio/Ti81_457143476.jpg,Ti81
6885,485.001221,485.098221,1,14550036,14552946,2910,audio/Or61_14550036.jpg,Or61
6886,632.082417,632.149417,2,18962472,18964482,2010,audio/Or61_18962472.jpg,Or61
6887,1965.302779,1965.306779,2,58959083,58959203,120,audio/Bl122_58959083.jpg,Bl122
6888,15070.377682,15070.573682,1,452111330,452117210,5880,audio/Ti81_452111330.jpg,Ti81
6889,15160.272257,15160.474257,1,454808167,454814227,6060,audio/Ti81_454808167.jpg,Ti81
6890,2126.013183,2126.031183,2,63780395,63780935,540,audio/Bl122_63780395.jpg,Bl122
6891,753.424271,753.441271,2,22602728,22603238,510,audio/Or61_22602728.jpg,Or61
6892,3471.593494,3471.614182,1,104147804,104148425,621,audio/Ti81_104147804.jpg,Ti81
6893,578.03071,578.05571,1,17340921,17341671,750,audio/Or61_17340921.jpg,Or61
6894,227.493275,227.524275,1,6824798,6825728,930,audio/Or61_6824798.jpg,Or61
6895,505.926221,505.937221,1,15177786,15178116,330,audio/Or61_15177786.jpg,Or61
6896,2182.326183,2182.330183,2,65469785,65469905,120,audio/Bl122_65469785.jpg,Bl122
6897,15096.051823,15096.081823,1,452881554,452882454,900,audio/Ti81_452881554.jpg,Ti81
6898,2053.509469,2053.528469,2,61605284,61605854,570,audio/Bl122_61605284.jpg,Bl122
6899,752.342271,752.407271,1,22570268,22572218,1950,audio/Or61_22570268.jpg,Or61
6900,2072.700469,2072.787469,1,62181014,62183624,2610,audio/Bl122_62181014.jpg,Bl122
6901,2185.001183,2185.006183,2,65550035,65550185,150,audio/Bl122_65550035.jpg,Bl122
6902,2122.493183,2122.522183,1,63674795,63675665,870,audio/Bl122_63674795.jpg,Bl122
6903,487.600221,487.652221,2,14628006,14629566,1560,audio/Or61_14628006.jpg,Or61
6904,489.778221,489.826221,2,14693346,14694786,1440,audio/Or61_14693346.jpg,Or61
6905,1941.438779,1941.458779,2,58243163,58243763,600,audio/Bl122_58243163.jpg,Bl122
6906,1939.941779,1939.945779,2,58198253,58198373,120,audio/Bl122_58198253.jpg,Bl122
6907,15083.4309,15083.4559,1,452502927,452503677,750,audio/Ti81_452502927.jpg,Ti81
6908,2136.472183,2136.493183,2,64094165,64094795,630,audio/Bl122_64094165.jpg,Bl122
6909,2068.720469,2068.813469,2,62061614,62064404,2790,audio/Bl122_62061614.jpg,Bl122
6910,15123.407981,15123.564981,1,453702239,453706949,4710,audio/Ti81_453702239.jpg,Ti81
6911,636.247417,636.304417,1,19087422,19089132,1710,audio/Or61_19087422.jpg,Or61
6912,504.155221,504.269221,2,15124656,15128076,3420,audio/Or61_15124656.jpg,Or61
6913,8865.068987,8865.109987,1,265952069,265953299,1230,audio/Li145_265952069.jpg,Li145
6914,604.922417,604.950417,2,18147672,18148512,840,audio/Or61_18147672.jpg,Or61
6915,213.060857,213.063857,2,6391825,6391915,90,audio/Or61_6391825.jpg,Or61
6916,531.395416,531.418416,2,15941862,15942552,690,audio/Or61_15941862.jpg,Or61
6917,746.077271,746.080271,2,22382318,22382408,90,audio/Or61_22382318.jpg,Or61
6918,15116.958981,15117.003981,1,453508769,453510119,1350,audio/Ti81_453508769.jpg,Ti81
6919,607.285417,607.305417,1,18218562,18219162,600,audio/Or61_18218562.jpg,Or61
6920,1794.638115,1794.669115,1,53839143,53840073,930,audio/Bl122_53839143.jpg,Bl122
6921,2140.176183,2140.181183,2,64205285,64205435,150,audio/Bl122_64205285.jpg,Bl122
6922,2216.663183,2216.666183,2,66499895,66499985,90,audio/Bl122_66499895.jpg,Bl122
6923,477.060221,477.078221,1,14311806,14312346,540,audio/Or61_14311806.jpg,Or61
6924,2095.583961,2095.592961,2,62867518,62867788,270,audio/Bl122_62867518.jpg,Bl122
6925,15165.894257,15165.969257,1,454976827,454979077,2250,audio/Ti81_454976827.jpg,Ti81
6926,552.114416,552.171416,1,16563432,16565142,1710,audio/Or61_16563432.jpg,Or61
6927,534.316416,534.341416,1,16029492,16030242,750,audio/Or61_16029492.jpg,Or61
6928,1971.635779,1971.669779,2,59149073,59150093,1020,audio/Bl122_59149073.jpg,Bl122
6929,2195.453183,2195.553183,1,65863595,65866595,3000,audio/Bl122_65863595.jpg,Bl122
6930,96.745568,96.751568,2,2902367,2902547,180,audio/Bl122_2902367.jpg,Bl122
6931,3470.354218,3470.461444,1,104110626,104113843,3217,audio/Ti81_104110626.jpg,Ti81
6932,2116.184183,2116.189183,2,63485525,63485675,150,audio/Bl122_63485525.jpg,Bl122
6933,2097.113961,2097.242961,1,62913418,62917288,3870,audio/Bl122_62913418.jpg,Bl122
6934,505.237221,505.242221,2,15157116,15157266,150,audio/Or61_15157116.jpg,Or61
6935,1800.077115,1800.086115,2,54002313,54002583,270,audio/Bl122_54002313.jpg,Bl122
6936,716.666271,716.700271,1,21499988,21501008,1020,audio/Or61_21499988.jpg,Or61
6937,479.215221,479.236221,1,14376456,14377086,630,audio/Or61_14376456.jpg,Or61
6938,15089.9969,15090.1439,1,452699907,452704317,4410,audio/Ti81_452699907.jpg,Ti81
6939,2062.926469,2062.940469,2,61887794,61888214,420,audio/Bl122_61887794.jpg,Bl122
6940,2202.006183,2202.010183,2,66060185,66060305,120,audio/Bl122_66060185.jpg,Bl122
6941,1981.877779,1982.007779,1,59456333,59460233,3900,audio/Bl122_59456333.jpg,Bl122
6942,15251.793074,15251.837074,1,457553792,457555112,1320,audio/Ti81_457553792.jpg,Ti81
6943,15057.080966,15057.183966,1,451712428,451715518,3090,audio/Ti81_451712428.jpg,Ti81
6944,2164.204183,2164.207183,2,64926125,64926215,90,audio/Bl122_64926125.jpg,Bl122
6945,767.996271,768.024271,1,23039888,23040728,840,audio/Or61_23039888.jpg,Or61
6946,541.643416,541.649416,2,16249302,16249482,180,audio/Or61_16249302.jpg,Or61
6947,602.948417,602.973417,1,18088452,18089202,750,audio/Or61_18088452.jpg,Or61
6948,4578.125821,4578.192931,1,137343774,137345787,2013,audio/Ti81_137343774.jpg,Ti81
6949,757.926271,758.039271,1,22737788,22741178,3390,audio/Or61_22737788.jpg,Or61
6950,7551.038715,7551.061715,1,226531161,226531851,690,audio/Li145_226531161.jpg,Li145
6951,509.348221,509.368221,1,15280446,15281046,600,audio/Or61_15280446.jpg,Or61
6952,199.721012,199.737012,1,5991630,5992110,480,audio/Or61_5991630.jpg,Or61
6953,532.844416,532.848416,2,15985332,15985452,120,audio/Or61_15985332.jpg,Or61
6954,2186.969183,2186.972183,2,65609075,65609165,90,audio/Bl122_65609075.jpg,Bl122
6955,1951.509779,1951.653779,1,58545293,58549613,4320,audio/Bl122_58545293.jpg,Bl122
6956,2184.187183,2184.197183,1,65525615,65525915,300,audio/Bl122_65525615.jpg,Bl122
6957,15084.6819,15084.923045,1,452540457,452547691,7234,audio/Ti81_452540457.jpg,Ti81
6958,15117.118981,15117.141981,1,453513569,453514259,690,audio/Ti81_453513569.jpg,Ti81
6959,15032.494011,15032.577269,1,450974820,450977318,2498,audio/Ti81_450974820.jpg,Ti81
6960,619.003417,619.027417,1,18570102,18570822,720,audio/Or61_18570102.jpg,Or61
6961,2001.221779,2001.228779,2,60036653,60036863,210,audio/Bl122_60036653.jpg,Bl122
6962,552.500416,552.529416,1,16575012,16575882,870,audio/Or61_16575012.jpg,Or61
6963,476.835221,476.963221,1,14305056,14308896,3840,audio/Or61_14305056.jpg,Or61
6964,1960.474779,1960.531779,1,58814243,58815953,1710,audio/Bl122_58814243.jpg,Bl122
6965,2208.540183,2208.761183,1,66256205,66262835,6630,audio/Bl122_66256205.jpg,Bl122
6966,1938.711779,1938.734779,2,58161353,58162043,690,audio/Bl122_58161353.jpg,Bl122
6967,545.800416,545.837416,1,16374012,16375122,1110,audio/Or61_16374012.jpg,Or61
6968,2192.101183,2192.110183,2,65763035,65763305,270,audio/Bl122_65763035.jpg,Bl122
6969,2187.140183,2187.145183,1,65614205,65614355,150,audio/Bl122_65614205.jpg,Bl122
6970,2042.027469,2042.031469,2,61260824,61260944,120,audio/Bl122_61260824.jpg,Bl122
6971,552.903416,553.134416,1,16587102,16594032,6930,audio/Or61_16587102.jpg,Or61
6972,1946.683779,1946.777779,1,58400513,58403333,2820,audio/Bl122_58400513.jpg,Bl122
6973,2179.610183,2179.615183,2,65388305,65388455,150,audio/Bl122_65388305.jpg,Bl122
6974,2230.012183,2230.354183,1,66900365,66910625,10260,audio/Bl122_66900365.jpg,Bl122
6975,6287.299659,6287.671659,1,188618989,188630149,11160,audio/Li145_188618989.jpg,Li145
6976,2048.170469,2048.206469,1,61445114,61446194,1080,audio/Bl122_61445114.jpg,Bl122
6977,5885.183674,5885.190674,1,176555510,176555720,210,audio/Li145_176555510.jpg,Li145
6978,15328.534625,15328.578625,1,459856038,459857358,1320,audio/Ti81_459856038.jpg,Ti81
6979,577.40271,577.48971,1,17322081,17324691,2610,audio/Or61_17322081.jpg,Or61
6980,705.758271,705.769271,1,21172748,21173078,330,audio/Or61_21172748.jpg,Or61
6981,320.992253,321.109253,1,9629767,9633277,3510,audio/Li145_9629767.jpg,Li145
6982,2013.664959,2013.668959,2,60409948,60410068,120,audio/Bl122_60409948.jpg,Bl122
6983,787.546827,787.566827,1,23626404,23627004,600,audio/Or61_23626404.jpg,Or61
6984,5705.145085,5705.225085,1,171154352,171156752,2400,audio/Li145_171154352.jpg,Li145
6985,706.631271,706.639271,2,21198938,21199178,240,audio/Or61_21198938.jpg,Or61
6986,723.848271,723.854271,2,21715448,21715628,180,audio/Or61_21715448.jpg,Or61
6987,2013.431959,2013.482959,1,60402958,60404488,1530,audio/Bl122_60402958.jpg,Bl122
6988,726.404271,726.704271,1,21792128,21801128,9000,audio/Or61_21792128.jpg,Or61
6989,606.426417,606.533417,1,18192792,18196002,3210,audio/Or61_18192792.jpg,Or61
6990,15248.142074,15248.303074,1,457444262,457449092,4830,audio/Ti81_457444262.jpg,Ti81
6991,402.994692,403.136692,1,12089840,12094100,4260,audio/Or61_12089840.jpg,Or61
6992,2226.701183,2226.709183,2,66801035,66801275,240,audio/Bl122_66801035.jpg,Bl122
6993,2200.376183,2200.415183,2,66011285,66012455,1170,audio/Bl122_66011285.jpg,Bl122
6994,223.361983,223.388983,1,6700859,6701669,810,audio/Or61_6700859.jpg,Or61
6995,579.52371,579.79171,1,17385711,17393751,8040,audio/Or61_17385711.jpg,Or61
6996,528.072416,528.081416,2,15842172,15842442,270,audio/Or61_15842172.jpg,Or61
6997,2098.836961,2099.000961,1,62965108,62970028,4920,audio/Bl122_62965108.jpg,Bl122
6998,808.296882,808.341882,1,24248906,24250256,1350,audio/Or61_24248906.jpg,Or61
6999,15032.29331,15032.308069,1,450968799,450969242,443,audio/Ti81_450968799.jpg,Ti81
7000,15164.661257,15164.736257,1,454939837,454942087,2250,audio/Ti81_454939837.jpg,Ti81
7001,15277.626439,15277.715439,1,458328793,458331463,2670,audio/Ti81_458328793.jpg,Ti81
7002,2131.718183,2131.724183,2,63951545,63951725,180,audio/Bl122_63951545.jpg,Bl122
7003,1785.78743,1785.92343,1,53573622,53577702,4080,audio/Bl122_53573622.jpg,Bl122
7004,565.935416,565.959416,2,16978062,16978782,720,audio/Or61_16978062.jpg,Or61
7005,542.003416,542.010416,2,16260102,16260312,210,audio/Or61_16260102.jpg,Or61
7006,1982.234779,1982.285779,1,59467043,59468573,1530,audio/Bl122_59467043.jpg,Bl122
7007,1973.067779,1973.346779,1,59192033,59200403,8370,audio/Bl122_59192033.jpg,Bl122
7008,15105.534256,15105.597256,1,453166027,453167917,1890,audio/Ti81_453166027.jpg,Ti81
7009,2058.238469,2058.326469,1,61747154,61749794,2640,audio/Bl122_61747154.jpg,Bl122
7010,2007.966779,2007.996779,1,60239003,60239903,900,audio/Bl122_60239003.jpg,Bl122
7011,1949.265779,1949.276779,2,58477973,58478303,330,audio/Bl122_58477973.jpg,Bl122
7012,398.114529,398.146529,1,11943435,11944395,960,audio/Or61_11943435.jpg,Or61
7013,3419.695147,3419.808427,1,102590854,102594252,3398,audio/Ti81_102590854.jpg,Ti81
7014,2122.103183,2122.274183,1,63663095,63668225,5130,audio/Bl122_63663095.jpg,Bl122
7015,3446.033045,3446.092587,1,103380991,103382777,1786,audio/Ti81_103380991.jpg,Ti81
7016,2212.676183,2212.684183,2,66380285,66380525,240,audio/Bl122_66380285.jpg,Bl122
7017,2117.971183,2118.082183,1,63539135,63542465,3330,audio/Bl122_63539135.jpg,Bl122
7018,2047.094469,2047.297469,1,61412834,61418924,6090,audio/Bl122_61412834.jpg,Bl122
7019,1978.499779,1978.516779,2,59354993,59355503,510,audio/Bl122_59354993.jpg,Bl122
7020,529.150416,529.157416,2,15874512,15874722,210,audio/Or61_15874512.jpg,Or61
7021,1945.717779,1945.733779,2,58371533,58372013,480,audio/Bl122_58371533.jpg,Bl122
7022,3543.277496,3543.326442,1,106298324,106299793,1469,audio/Ti81_106298324.jpg,Ti81
7023,723.930271,724.180271,1,21717908,21725408,7500,audio/Or61_21717908.jpg,Or61
7024,15138.860989,15138.935989,1,454165829,454168079,2250,audio/Ti81_454165829.jpg,Ti81
7025,6949.559842,6949.563842,2,208486795,208486915,120,audio/Li145_208486795.jpg,Li145
7026,15133.864989,15134.038989,1,454015949,454021169,5220,audio/Ti81_454015949.jpg,Ti81
7027,510.930221,510.973221,1,15327906,15329196,1290,audio/Or61_15327906.jpg,Or61
7028,501.707221,501.712221,2,15051216,15051366,150,audio/Or61_15051216.jpg,Or61
7029,396.291529,396.345529,1,11888745,11890365,1620,audio/Or61_11888745.jpg,Or61
7030,5707.547085,5707.588085,1,171226412,171227642,1230,audio/Li145_171226412.jpg,Li145
7031,199.500012,199.512012,2,5985000,5985360,360,audio/Or61_5985000.jpg,Or61
7032,5911.127207,5911.150207,1,177333816,177334506,690,audio/Li145_177333816.jpg,Li145
7033,15286.997439,15287.054439,1,458609923,458611633,1710,audio/Ti81_458609923.jpg,Ti81
7034,1964.426779,1964.433779,2,58932803,58933013,210,audio/Bl122_58932803.jpg,Bl122
7035,265.049507,265.161507,1,7951485,7954845,3360,audio/Or61_7951485.jpg,Or61
7036,2141.169183,2141.175183,2,64235075,64235255,180,audio/Bl122_64235075.jpg,Bl122
7037,600.746417,600.965417,1,18022392,18028962,6570,audio/Or61_18022392.jpg,Or61
7038,2199.625183,2199.632183,2,65988755,65988965,210,audio/Bl122_65988755.jpg,Bl122
7039,15097.481823,15097.797823,1,452924454,452933934,9480,audio/Ti81_452924454.jpg,Ti81
7040,2094.456961,2094.607961,1,62833708,62838238,4530,audio/Bl122_62833708.jpg,Bl122
7041,4895.874039,4896.032039,1,146876221,146880961,4740,audio/Li145_146876221.jpg,Li145
7042,2216.996183,2216.999183,2,66509885,66509975,90,audio/Bl122_66509885.jpg,Bl122
7043,2095.813961,2095.839961,1,62874418,62875198,780,audio/Bl122_62874418.jpg,Bl122
7044,2002.660779,2002.665779,2,60079823,60079973,150,audio/Bl122_60079823.jpg,Bl122
7045,2038.476469,2038.531469,2,61154294,61155944,1650,audio/Bl122_61154294.jpg,Bl122
7046,405.271692,405.442692,1,12158150,12163280,5130,audio/Or61_12158150.jpg,Or61
7047,1949.576779,1949.595779,2,58487303,58487873,570,audio/Bl122_58487303.jpg,Bl122
7048,2077.520823,2077.528823,2,62325624,62325864,240,audio/Bl122_62325624.jpg,Bl122
7049,1949.049779,1949.071779,2,58471493,58472153,660,audio/Bl122_58471493.jpg,Bl122
7050,15100.372823,15100.624823,1,453011184,453018744,7560,audio/Ti81_453011184.jpg,Ti81
7051,2099.508961,2099.538961,2,62985268,62986168,900,audio/Bl122_62985268.jpg,Bl122
7052,2047.869469,2047.873469,2,61436084,61436204,120,audio/Bl122_61436084.jpg,Bl122
7053,674.250078,674.262078,2,20227502,20227862,360,audio/Or61_20227502.jpg,Or61
7054,6954.325285,6954.461285,1,208629758,208633838,4080,audio/Li145_208629758.jpg,Li145
7055,2155.743183,2155.769183,2,64672295,64673075,780,audio/Bl122_64672295.jpg,Bl122
7056,629.177417,629.203417,1,18875322,18876102,780,audio/Or61_18875322.jpg,Or61
7057,2223.334183,2223.373183,2,66700025,66701195,1170,audio/Bl122_66700025.jpg,Bl122
7058,780.847878,780.900878,1,23425436,23427026,1590,audio/Or61_23425436.jpg,Or61
7059,2058.936469,2058.962469,2,61768094,61768874,780,audio/Bl122_61768094.jpg,Bl122
7060,2008.362779,2008.370779,2,60250883,60251123,240,audio/Bl122_60250883.jpg,Bl122
7061,2178.061183,2178.081183,2,65341835,65342435,600,audio/Bl122_65341835.jpg,Bl122
7062,15288.524298,15288.588439,1,458655728,458657653,1925,audio/Ti81_458655728.jpg,Ti81
7063,2206.213183,2206.254183,2,66186395,66187625,1230,audio/Bl122_66186395.jpg,Bl122
7064,626.169417,626.173417,2,18785082,18785202,120,audio/Or61_18785082.jpg,Or61
7065,807.062882,807.261882,1,24211886,24217856,5970,audio/Or61_24211886.jpg,Or61
7066,2005.824779,2005.827779,2,60174743,60174833,90,audio/Bl122_60174743.jpg,Bl122
7067,722.952271,723.227271,1,21688568,21696818,8250,audio/Or61_21688568.jpg,Or61
7068,599.323417,599.488417,1,17979702,17984652,4950,audio/Or61_17979702.jpg,Or61
7069,2058.999469,2059.002469,2,61769984,61770074,90,audio/Bl122_61769984.jpg,Bl122
7070,2227.647183,2227.651183,2,66829415,66829535,120,audio/Bl122_66829415.jpg,Bl122
7071,2229.234183,2229.238183,2,66877025,66877145,120,audio/Bl122_66877025.jpg,Bl122
7072,15085.4839,15085.5479,1,452564517,452566437,1920,audio/Ti81_452564517.jpg,Ti81
7073,2166.514183,2166.537183,2,64995425,64996115,690,audio/Bl122_64995425.jpg,Bl122
7074,1984.395779,1984.409779,2,59531873,59532293,420,audio/Bl122_59531873.jpg,Bl122
7075,14942.803544,14942.86933,1,448284106,448286079,1973,audio/Ti81_448284106.jpg,Ti81
7076,510.614221,510.739221,1,15318426,15322176,3750,audio/Or61_15318426.jpg,Or61
7077,15031.360699,15031.427305,1,450940820,450942819,1999,audio/Ti81_450940820.jpg,Ti81
7078,409.975602,410.023602,1,12299268,12300708,1440,audio/Or61_12299268.jpg,Or61
7079,1966.675779,1966.701779,2,59000273,59001053,780,audio/Bl122_59000273.jpg,Bl122
7080,15344.241971,15344.786971,1,460327259,460343609,16350,audio/Ti81_460327259.jpg,Ti81
7081,2002.672779,2002.740779,1,60080183,60082223,2040,audio/Bl122_60080183.jpg,Bl122
7082,15138.766989,15138.840989,1,454163009,454165229,2220,audio/Ti81_454163009.jpg,Ti81
7083,2227.088183,2227.326183,1,66812645,66819785,7140,audio/Bl122_66812645.jpg,Bl122
7084,3448.527744,3448.545216,1,103455832,103456356,524,audio/Ti81_103455832.jpg,Ti81
7085,2204.758183,2205.092183,1,66142745,66152765,10020,audio/Bl122_66142745.jpg,Bl122
7086,601.108417,601.143417,1,18033252,18034302,1050,audio/Or61_18033252.jpg,Or61
7087,557.325416,557.328416,2,16719762,16719852,90,audio/Or61_16719762.jpg,Or61
7088,2136.725183,2136.732183,2,64101755,64101965,210,audio/Bl122_64101755.jpg,Bl122
7089,1992.908779,1992.962779,2,59787263,59788883,1620,audio/Bl122_59787263.jpg,Bl122
7090,2172.813183,2172.816183,2,65184395,65184485,90,audio/Bl122_65184395.jpg,Bl122
7091,2004.043779,2004.212779,1,60121313,60126383,5070,audio/Bl122_60121313.jpg,Bl122
7092,2222.287183,2222.429183,1,66668615,66672875,4260,audio/Bl122_66668615.jpg,Bl122
7093,6287.221659,6287.289659,1,188616649,188618689,2040,audio/Li145_188616649.jpg,Li145
7094,636.564417,636.580417,2,19096932,19097412,480,audio/Or61_19096932.jpg,Or61
7095,2200.791183,2200.794183,2,66023735,66023825,90,audio/Bl122_66023735.jpg,Bl122
7096,15095.740823,15095.875823,1,452872224,452876274,4050,audio/Ti81_452872224.jpg,Ti81
7097,479.909221,480.136221,1,14397276,14404086,6810,audio/Or61_14397276.jpg,Or61
7098,2216.980183,2216.993183,2,66509405,66509795,390,audio/Bl122_66509405.jpg,Bl122
7099,535.809416,535.887416,1,16074282,16076622,2340,audio/Or61_16074282.jpg,Or61
7100,1787.197115,1787.246115,1,53615913,53617383,1470,audio/Bl122_53615913.jpg,Bl122
7101,15328.159625,15328.218625,1,459844788,459846558,1770,audio/Ti81_459844788.jpg,Ti81
7102,5873.094637,5873.111637,1,176192839,176193349,510,audio/Li145_176192839.jpg,Li145
7103,531.218416,531.301416,1,15936552,15939042,2490,audio/Or61_15936552.jpg,Or61
7104,2187.133183,2187.138183,1,65613995,65614145,150,audio/Bl122_65613995.jpg,Bl122
7105,1965.313779,1965.335779,1,58959413,58960073,660,audio/Bl122_58959413.jpg,Bl122
7106,2095.115961,2095.149961,1,62853478,62854498,1020,audio/Bl122_62853478.jpg,Bl122
7107,2163.783183,2163.807183,1,64913495,64914215,720,audio/Bl122_64913495.jpg,Bl122
7108,429.040969,429.094969,1,12871229,12872849,1620,audio/Or61_12871229.jpg,Or61
7109,217.952413,217.961413,2,6538572,6538842,270,audio/Or61_6538572.jpg,Or61
7110,3468.287538,3468.300027,1,104048626,104049000,374,audio/Ti81_104048626.jpg,Ti81
7111,1940.912779,1940.917779,2,58227383,58227533,150,audio/Bl122_58227383.jpg,Bl122
7112,718.590271,718.607271,1,21557708,21558218,510,audio/Or61_21557708.jpg,Or61
7113,808.795882,808.807882,2,24263876,24264236,360,audio/Or61_24263876.jpg,Or61
7114,15262.753358,15262.839358,1,457882600,457885180,2580,audio/Ti81_457882600.jpg,Ti81
7115,480.139221,480.192221,2,14404176,14405766,1590,audio/Or61_14404176.jpg,Or61
7116,2044.188469,2044.501469,1,61325654,61335044,9390,audio/Bl122_61325654.jpg,Bl122
7117,15110.228256,15110.256256,1,453306847,453307687,840,audio/Ti81_453306847.jpg,Ti81
7118,753.712271,753.859271,1,22611368,22615778,4410,audio/Or61_22611368.jpg,Or61
7119,1955.483779,1955.486779,2,58664513,58664603,90,audio/Bl122_58664513.jpg,Bl122
7120,790.017827,790.038827,2,23700534,23701164,630,audio/Or61_23700534.jpg,Or61
7121,9046.873911,9046.922911,1,271406217,271407687,1470,audio/Li145_271406217.jpg,Li145
7122,611.150417,611.266417,1,18334512,18337992,3480,audio/Or61_18334512.jpg,Or61
7123,747.168271,747.193271,1,22415048,22415798,750,audio/Or61_22415048.jpg,Or61
7124,533.632416,533.821416,1,16008972,16014642,5670,audio/Or61_16008972.jpg,Or61
7125,2198.970183,2198.998183,1,65969105,65969945,840,audio/Bl122_65969105.jpg,Bl122
7126,15340.209971,15340.254971,1,460206299,460207649,1350,audio/Ti81_460206299.jpg,Ti81
7127,2151.041183,2151.048183,2,64531235,64531445,210,audio/Bl122_64531235.jpg,Bl122
7128,705.744271,705.756271,1,21172328,21172688,360,audio/Or61_21172328.jpg,Or61
7129,7547.663781,7547.768781,1,226429913,226433063,3150,audio/Li145_226429913.jpg,Li145
7130,2040.763815,2040.776815,1,61222914,61223304,390,audio/Li145_61222914.jpg,Li145
7131,8084.037803,8084.054803,1,242521134,242521644,510,audio/Li145_242521134.jpg,Li145
7132,198.015012,198.079012,1,5940450,5942370,1920,audio/Or61_5940450.jpg,Or61
7133,15031.93013,15031.982482,1,450957903,450959474,1571,audio/Ti81_450957903.jpg,Ti81
7134,15124.178981,15124.313981,1,453725369,453729419,4050,audio/Ti81_453725369.jpg,Ti81
7135,2134.934183,2135.117183,1,64048025,64053515,5490,audio/Bl122_64048025.jpg,Bl122
7136,15133.321989,15133.477989,1,453999659,454004339,4680,audio/Ti81_453999659.jpg,Ti81
7137,546.328416,546.340416,1,16389852,16390212,360,audio/Or61_16389852.jpg,Or61
7138,2061.183469,2061.191469,2,61835504,61835744,240,audio/Bl122_61835504.jpg,Bl122
7139,182.078971,182.087971,2,5462369,5462639,270,audio/Or61_5462369.jpg,Or61
7140,2000.059779,2000.068779,2,60001793,60002063,270,audio/Bl122_60001793.jpg,Bl122
7141,2187.546183,2187.549183,2,65626385,65626475,90,audio/Bl122_65626385.jpg,Bl122
7142,811.457882,811.477882,1,24343736,24344336,600,audio/Or61_24343736.jpg,Or61
7143,2202.753183,2202.759183,2,66082595,66082775,180,audio/Bl122_66082595.jpg,Bl122
7144,2164.050183,2164.104183,1,64921505,64923125,1620,audio/Bl122_64921505.jpg,Bl122
7145,752.165271,752.334271,1,22564958,22570028,5070,audio/Or61_22564958.jpg,Or61
7146,3583.662686,3583.667686,2,107509880,107510030,150,audio/Li145_107509880.jpg,Li145
7147,1960.974779,1960.989779,2,58829243,58829693,450,audio/Bl122_58829243.jpg,Bl122
7148,2189.979183,2189.992183,2,65699375,65699765,390,audio/Bl122_65699375.jpg,Bl122
7149,2231.652183,2231.700183,1,66949565,66951005,1440,audio/Bl122_66949565.jpg,Bl122
7150,1966.486779,1966.501779,2,58994603,58995053,450,audio/Bl122_58994603.jpg,Bl122
7151,1942.306779,1942.333779,1,58269203,58270013,810,audio/Bl122_58269203.jpg,Bl122
7152,2217.086183,2217.106183,2,66512585,66513185,600,audio/Bl122_66512585.jpg,Bl122
7153,2057.093469,2057.225469,1,61712804,61716764,3960,audio/Bl122_61712804.jpg,Bl122
7154,719.930271,720.207271,1,21597908,21606218,8310,audio/Or61_21597908.jpg,Or61
7155,1973.379779,1973.430779,2,59201393,59202923,1530,audio/Bl122_59201393.jpg,Bl122
7156,2224.573183,2224.578183,2,66737195,66737345,150,audio/Bl122_66737195.jpg,Bl122
7157,9166.297583,9166.326583,1,274988927,274989797,870,audio/Li145_274988927.jpg,Li145
7158,1956.750779,1956.776779,2,58702523,58703303,780,audio/Bl122_58702523.jpg,Bl122
7159,1783.234323,1783.247323,1,53497029,53497419,390,audio/Bl122_53497029.jpg,Bl122
7160,1942.558779,1942.562779,2,58276763,58276883,120,audio/Bl122_58276763.jpg,Bl122
7161,2212.526183,2212.565183,1,66375785,66376955,1170,audio/Bl122_66375785.jpg,Bl122
7162,2068.194469,2068.201469,2,62045834,62046044,210,audio/Bl122_62045834.jpg,Bl122
7163,15098.732823,15098.962823,1,452961984,452968884,6900,audio/Ti81_452961984.jpg,Ti81
7164,15020.976085,15021.094537,1,450629282,450632836,3554,audio/Ti81_450629282.jpg,Ti81
7165,15327.608625,15327.798625,1,459828258,459833958,5700,audio/Ti81_459828258.jpg,Ti81
7166,265.026507,265.031507,2,7950795,7950945,150,audio/Or61_7950795.jpg,Or61
7167,2197.730183,2197.734183,2,65931905,65932025,120,audio/Bl122_65931905.jpg,Bl122
7168,15161.432257,15161.488257,1,454842967,454844647,1680,audio/Ti81_454842967.jpg,Ti81
7169,2129.755183,2129.924183,1,63892655,63897725,5070,audio/Bl122_63892655.jpg,Bl122
7170,1968.043779,1968.061779,1,59041313,59041853,540,audio/Bl122_59041313.jpg,Bl122
7171,2166.900183,2166.914183,1,65007005,65007425,420,audio/Bl122_65007005.jpg,Bl122
7172,9165.683583,9165.689583,2,274970507,274970687,180,audio/Li145_274970507.jpg,Li145
7173,2235.475183,2235.642183,1,67064255,67069265,5010,audio/Bl122_67064255.jpg,Bl122
7174,717.825271,718.029271,1,21534758,21540878,6120,audio/Or61_21534758.jpg,Or61
7175,185.775971,185.815971,1,5573279,5574479,1200,audio/Or61_5573279.jpg,Or61
7176,2159.250183,2159.281183,1,64777505,64778435,930,audio/Bl122_64777505.jpg,Bl122
7177,453.599219,453.605219,2,13607976,13608156,180,audio/Or61_13607976.jpg,Or61
7178,1993.638779,1993.646779,2,59809163,59809403,240,audio/Bl122_59809163.jpg,Bl122
7179,8829.159654,8829.173654,1,264874789,264875209,420,audio/Li145_264874789.jpg,Li145
7180,593.552457,593.616457,1,17806573,17808493,1920,audio/Or61_17806573.jpg,Or61
7181,627.539417,627.563417,2,18826182,18826902,720,audio/Or61_18826182.jpg,Or61
7182,610.371417,610.397417,1,18311142,18311922,780,audio/Or61_18311142.jpg,Or61
7183,718.676271,718.678271,2,21560288,21560348,60,audio/Or61_21560288.jpg,Or61
7184,4922.428507,4922.499507,1,147672855,147674985,2130,audio/Li145_147672855.jpg,Li145
7185,2183.693183,2183.739183,2,65510795,65512175,1380,audio/Bl122_65510795.jpg,Bl122
7186,544.196416,544.214416,1,16325892,16326432,540,audio/Or61_16325892.jpg,Or61
7187,9172.004804,9172.025804,1,275160144,275160774,630,audio/Li145_275160144.jpg,Li145
7188,2060.653469,2060.657469,1,61819604,61819724,120,audio/Bl122_61819604.jpg,Bl122
7189,2158.356183,2158.392183,2,64750685,64751765,1080,audio/Bl122_64750685.jpg,Bl122
7190,7492.802261,7492.877261,1,224784067,224786317,2250,audio/Li145_224784067.jpg,Li145
7191,15034.13141,15034.208612,1,451023942,451026258,2316,audio/Ti81_451023942.jpg,Ti81
7192,15139.052989,15139.098989,1,454171589,454172969,1380,audio/Ti81_454171589.jpg,Ti81
7193,2080.351287,2080.538287,1,62410538,62416148,5610,audio/Bl122_62410538.jpg,Bl122
7194,1975.456779,1975.459779,2,59263703,59263793,90,audio/Bl122_59263703.jpg,Bl122
7195,5835.328068,5835.364068,1,175059842,175060922,1080,audio/Li145_175059842.jpg,Li145
7196,805.234882,805.350882,1,24157046,24160526,3480,audio/Or61_24157046.jpg,Or61
7197,1978.521779,1978.535779,2,59355653,59356073,420,audio/Bl122_59355653.jpg,Bl122
7198,488.397221,488.421221,2,14651916,14652636,720,audio/Or61_14651916.jpg,Or61
7199,819.499882,819.636882,1,24584996,24589106,4110,audio/Or61_24584996.jpg,Or61
7200,738.972271,739.011271,1,22169168,22170338,1170,audio/Or61_22169168.jpg,Or61
7201,1935.084613,1935.137613,2,58052538,58054128,1590,audio/Bl122_58052538.jpg,Bl122
7202,2192.498183,2192.692183,1,65774945,65780765,5820,audio/Bl122_65774945.jpg,Bl122
7203,2213.660183,2213.670183,2,66409805,66410105,300,audio/Bl122_66409805.jpg,Bl122
7204,489.509221,489.720221,1,14685276,14691606,6330,audio/Or61_14685276.jpg,Or61
7205,2040.865469,2040.915469,1,61225964,61227464,1500,audio/Bl122_61225964.jpg,Bl122
7206,1989.663779,1989.766779,2,59689913,59693003,3090,audio/Bl122_59689913.jpg,Bl122
7207,2191.052183,2191.057183,2,65731565,65731715,150,audio/Bl122_65731565.jpg,Bl122
7208,2068.685469,2068.693469,2,62060564,62060804,240,audio/Bl122_62060564.jpg,Bl122
7209,2162.816183,2162.837183,1,64884485,64885115,630,audio/Bl122_64884485.jpg,Bl122
7210,6956.971877,6956.983877,1,208709156,208709516,360,audio/Li145_208709156.jpg,Li145
7211,15047.574966,15047.612966,1,451427248,451428388,1140,audio/Ti81_451427248.jpg,Ti81
7212,2223.900183,2223.917183,2,66717005,66717515,510,audio/Bl122_66717005.jpg,Bl122
7213,15138.562989,15138.646989,1,454156889,454159409,2520,audio/Ti81_454156889.jpg,Ti81
7214,738.914271,738.938271,1,22167428,22168148,720,audio/Or61_22167428.jpg,Or61
7215,9633.804893,9633.972544,1,289014146,289019176,5030,audio/Ti81_289014146.jpg,Ti81
7216,742.959271,743.029271,1,22288778,22290878,2100,audio/Or61_22288778.jpg,Or61
7217,2128.322183,2128.331183,2,63849665,63849935,270,audio/Bl122_63849665.jpg,Bl122
7218,475.337221,475.356221,1,14260116,14260686,570,audio/Or61_14260116.jpg,Or61
7219,15284.605439,15284.825439,1,458538163,458544763,6600,audio/Ti81_458538163.jpg,Ti81
7220,611.981417,612.045417,1,18359442,18361362,1920,audio/Or61_18359442.jpg,Or61
7221,2068.877469,2068.996469,2,62066324,62069894,3570,audio/Bl122_62066324.jpg,Bl122
7222,492.748221,492.779221,1,14782446,14783376,930,audio/Or61_14782446.jpg,Or61
7223,3419.343951,3419.383814,1,102580318,102581514,1196,audio/Ti81_102580318.jpg,Ti81
7224,2162.095183,2162.218183,1,64862855,64866545,3690,audio/Bl122_64862855.jpg,Bl122
7225,3542.706299,3542.894259,1,106281188,106286827,5639,audio/Ti81_106281188.jpg,Ti81
7226,2145.679183,2145.707183,2,64370375,64371215,840,audio/Bl122_64370375.jpg,Bl122
7227,2202.109183,2202.126183,2,66063275,66063785,510,audio/Bl122_66063275.jpg,Bl122
7228,603.028417,603.047417,2,18090852,18091422,570,audio/Or61_18090852.jpg,Or61
7229,15216.06158,15216.16558,1,456481847,456484967,3120,audio/Ti81_456481847.jpg,Ti81
7230,2211.709183,2211.722183,2,66351275,66351665,390,audio/Bl122_66351275.jpg,Bl122
7231,544.242416,544.347416,1,16327272,16330422,3150,audio/Or61_16327272.jpg,Or61
7232,737.355271,737.410271,1,22120658,22122308,1650,audio/Or61_22120658.jpg,Or61
7233,2134.832183,2134.864183,1,64044965,64045925,960,audio/Bl122_64044965.jpg,Bl122
7234,549.779416,549.817416,1,16493382,16494522,1140,audio/Or61_16493382.jpg,Or61
7235,2215.750183,2215.773183,1,66472505,66473195,690,audio/Bl122_66472505.jpg,Bl122
7236,561.113416,561.390416,1,16833402,16841712,8310,audio/Or61_16833402.jpg,Or61
7237,15215.08058,15215.09858,1,456452417,456452957,540,audio/Ti81_456452417.jpg,Ti81
7238,4.13615,4.24015,1,124084,127204,3120,audio/Or61_124084.jpg,Or61
7239,2233.139183,2233.145183,2,66994175,66994355,180,audio/Bl122_66994175.jpg,Bl122
7240,2184.088183,2184.181183,1,65522645,65525435,2790,audio/Bl122_65522645.jpg,Bl122
7241,548.661416,548.665416,2,16459842,16459962,120,audio/Or61_16459842.jpg,Or61
7242,5696.371353,5696.488353,1,170891140,170894650,3510,audio/Li145_170891140.jpg,Li145
7243,2077.371823,2077.403823,1,62321154,62322114,960,audio/Bl122_62321154.jpg,Bl122
7244,391.150161,391.189161,1,11734504,11735674,1170,audio/Or61_11734504.jpg,Or61
7245,2217.114183,2217.148183,2,66513425,66514445,1020,audio/Bl122_66513425.jpg,Bl122
7246,2147.558183,2148.083183,1,64426745,64442495,15750,audio/Bl122_64426745.jpg,Bl122
7247,15070.874673,15071.086682,1,452126240,452132600,6360,audio/Ti81_452126240.jpg,Ti81
7248,15052.503966,15052.625966,1,451575118,451578778,3660,audio/Ti81_451575118.jpg,Ti81
7249,1954.387779,1954.468779,1,58631633,58634063,2430,audio/Bl122_58631633.jpg,Bl122
7250,2054.270469,2054.294469,1,61628114,61628834,720,audio/Bl122_61628114.jpg,Bl122
7251,504.927221,504.963221,1,15147816,15148896,1080,audio/Or61_15147816.jpg,Or61
7252,180.049971,180.055971,1,5401499,5401679,180,audio/Or61_5401499.jpg,Or61
7253,601.379417,601.441417,1,18041382,18043242,1860,audio/Or61_18041382.jpg,Or61
7254,2231.379183,2231.387183,2,66941375,66941615,240,audio/Bl122_66941375.jpg,Bl122
7255,537.034416,537.067416,1,16111032,16112022,990,audio/Or61_16111032.jpg,Or61
7256,488.079221,488.085221,2,14642376,14642556,180,audio/Or61_14642376.jpg,Or61
7257,6332.664902,6332.700902,1,189979947,189981027,1080,audio/Li145_189979947.jpg,Li145
7258,1952.725779,1952.968779,1,58581773,58589063,7290,audio/Bl122_58581773.jpg,Bl122
7259,565.962416,565.969416,2,16978872,16979082,210,audio/Or61_16978872.jpg,Or61
7260,564.882416,564.885416,2,16946472,16946562,90,audio/Or61_16946472.jpg,Or61
7261,2193.080183,2193.148183,1,65792405,65794445,2040,audio/Bl122_65792405.jpg,Bl122
7262,1949.636779,1949.816779,1,58489103,58494503,5400,audio/Bl122_58489103.jpg,Bl122
7263,500.180221,500.394221,1,15005406,15011826,6420,audio/Or61_15005406.jpg,Or61
7264,1995.779779,1995.818779,1,59873393,59874563,1170,audio/Bl122_59873393.jpg,Bl122
7265,2072.489469,2072.495469,2,62174684,62174864,180,audio/Bl122_62174684.jpg,Bl122
7266,1989.358779,1989.380779,2,59680763,59681423,660,audio/Bl122_59680763.jpg,Bl122
7267,2114.614183,2114.617183,2,63438425,63438515,90,audio/Bl122_63438425.jpg,Bl122
7268,2001.763779,2001.886779,1,60052913,60056603,3690,audio/Bl122_60052913.jpg,Bl122
7269,2192.485183,2192.488183,2,65774555,65774645,90,audio/Bl122_65774555.jpg,Bl122
7270,748.535271,748.561271,1,22456058,22456838,780,audio/Or61_22456058.jpg,Or61
7271,1783.287323,1783.292323,2,53498619,53498769,150,audio/Bl122_53498619.jpg,Bl122
7272,1967.132779,1967.190779,2,59013983,59015723,1740,audio/Bl122_59013983.jpg,Bl122
7273,15247.379074,15247.545074,1,457421372,457426352,4980,audio/Ti81_457421372.jpg,Ti81
7274,762.287271,762.465271,1,22868618,22873958,5340,audio/Or61_22868618.jpg,Or61
7275,559.554416,559.559416,2,16786632,16786782,150,audio/Or61_16786632.jpg,Or61
7276,6333.146902,6333.193902,1,189994407,189995817,1410,audio/Li145_189994407.jpg,Li145
7277,746.551271,746.572271,1,22396538,22397168,630,audio/Or61_22396538.jpg,Or61
7278,1973.847779,1973.861779,2,59215433,59215853,420,audio/Bl122_59215433.jpg,Bl122
7279,1783.402323,1783.413323,1,53502069,53502399,330,audio/Bl122_53502069.jpg,Bl122
7280,502.002221,502.136221,1,15060066,15064086,4020,audio/Or61_15060066.jpg,Or61
7281,15235.624874,15235.660874,1,457068746,457069826,1080,audio/Ti81_457068746.jpg,Ti81
7282,15221.140443,15221.271443,1,456634213,456638143,3930,audio/Ti81_456634213.jpg,Ti81
7283,15316.835428,15317.005428,1,459505062,459510162,5100,audio/Ti81_459505062.jpg,Ti81
7284,1957.981779,1958.180779,1,58739453,58745423,5970,audio/Bl122_58739453.jpg,Bl122
7285,476.601221,476.665221,1,14298036,14299956,1920,audio/Or61_14298036.jpg,Or61
7286,430.506962,430.578962,1,12915208,12917368,2160,audio/Or61_12915208.jpg,Or61
7287,15030.363122,15030.643423,1,450910893,450919302,8409,audio/Ti81_450910893.jpg,Ti81
7288,15093.080823,15093.192823,1,452792424,452795784,3360,audio/Ti81_452792424.jpg,Ti81
7289,15058.767966,15058.820966,1,451763038,451764628,1590,audio/Ti81_451763038.jpg,Ti81
7290,15072.169618,15072.347682,1,452165088,452170430,5342,audio/Ti81_452165088.jpg,Ti81
7291,201.073012,201.098012,2,6032190,6032940,750,audio/Or61_6032190.jpg,Or61
7292,15076.365682,15076.525682,1,452290970,452295770,4800,audio/Ti81_452290970.jpg,Ti81
7293,1987.923779,1987.932779,1,59637713,59637983,270,audio/Bl122_59637713.jpg,Bl122
7294,1976.969779,1977.165779,1,59309093,59314973,5880,audio/Bl122_59309093.jpg,Bl122
7295,513.567221,513.780221,1,15407016,15413406,6390,audio/Or61_15407016.jpg,Or61
7296,602.549417,602.551417,2,18076482,18076542,60,audio/Or61_18076482.jpg,Or61
7297,565.312416,565.342416,2,16959372,16960272,900,audio/Or61_16959372.jpg,Or61
7298,89.263871,89.267871,2,2677916,2678036,120,audio/Bl122_2677916.jpg,Bl122
7299,2211.479183,2211.483183,2,66344375,66344495,120,audio/Bl122_66344375.jpg,Bl122
7300,713.997271,714.008271,1,21419918,21420248,330,audio/Or61_21419918.jpg,Or61
7301,2216.079183,2216.159183,1,66482375,66484775,2400,audio/Bl122_66482375.jpg,Bl122
7302,845.905385,846.093812,1,25377161,25382814,5653,audio/Ti81_25377161.jpg,Ti81
7303,15106.944256,15107.089256,1,453208327,453212677,4350,audio/Ti81_453208327.jpg,Ti81
7304,2176.594183,2176.602183,2,65297825,65298065,240,audio/Bl122_65297825.jpg,Bl122
7305,2162.872183,2162.875183,2,64886165,64886255,90,audio/Bl122_64886165.jpg,Bl122
7306,15110.066256,15110.081256,1,453301987,453302437,450,audio/Ti81_453301987.jpg,Ti81
7307,558.602416,558.868416,1,16758072,16766052,7980,audio/Or61_16758072.jpg,Or61
7308,8084.391803,8084.397803,2,242531754,242531934,180,audio/Li145_242531754.jpg,Li145
7309,529.931416,530.031416,1,15897942,15900942,3000,audio/Or61_15897942.jpg,Or61
7310,503.626221,503.684221,1,15108786,15110526,1740,audio/Or61_15108786.jpg,Or61
7311,2083.100961,2083.104961,2,62493028,62493148,120,audio/Bl122_62493028.jpg,Bl122
7312,3410.512721,3410.679741,1,102315381,102320392,5011,audio/Ti81_102315381.jpg,Ti81
7313,14931.047576,14931.078861,1,447931427,447932365,938,audio/Ti81_447931427.jpg,Ti81
7314,3413.718389,3413.899285,1,102411551,102416978,5427,audio/Ti81_102411551.jpg,Ti81
7315,804.077882,804.201882,1,24122336,24126056,3720,audio/Or61_24122336.jpg,Or61
7316,2001.528779,2001.700779,1,60045863,60051023,5160,audio/Bl122_60045863.jpg,Bl122
7317,2224.282183,2224.328183,2,66728465,66729845,1380,audio/Bl122_66728465.jpg,Bl122
7318,1954.245779,1954.256779,2,58627373,58627703,330,audio/Bl122_58627373.jpg,Bl122
7319,7550.323715,7550.337715,1,226509711,226510131,420,audio/Li145_226509711.jpg,Li145
7320,7220.262918,7220.355918,1,216607887,216610677,2790,audio/Li145_216607887.jpg,Li145
7321,204.296643,204.474643,1,6128899,6134239,5340,audio/Or61_6128899.jpg,Or61
7322,1975.487779,1975.505779,2,59264633,59265173,540,audio/Bl122_59264633.jpg,Bl122
7323,2120.841183,2121.033183,1,63625235,63630995,5760,audio/Bl122_63625235.jpg,Bl122
7324,2186.174183,2186.394183,1,65585225,65591825,6600,audio/Bl122_65585225.jpg,Bl122
7325,747.259271,747.264271,2,22417778,22417928,150,audio/Or61_22417778.jpg,Or61
7326,529.256416,529.260416,2,15877692,15877812,120,audio/Or61_15877692.jpg,Or61
7327,564.056416,564.082416,2,16921692,16922472,780,audio/Or61_16921692.jpg,Or61
7328,2003.934779,2003.966779,1,60118043,60119003,960,audio/Bl122_60118043.jpg,Bl122
7329,3541.629627,3541.775076,1,106248888,106253252,4364,audio/Ti81_106248888.jpg,Ti81
7330,753.955271,754.049271,1,22618658,22621478,2820,audio/Or61_22618658.jpg,Or61
7331,1985.881779,1985.902779,2,59576453,59577083,630,audio/Bl122_59576453.jpg,Bl122
7332,2179.213183,2179.587183,1,65376395,65387615,11220,audio/Bl122_65376395.jpg,Bl122
7333,480.495221,480.540221,2,14414856,14416206,1350,audio/Or61_14414856.jpg,Or61
7334,6495.642725,6495.857239,1,194869281,194875717,6436,audio/Ti81_194869281.jpg,Ti81
7335,8083.878803,8083.881803,2,242516364,242516454,90,audio/Li145_242516364.jpg,Li145
7336,2154.279183,2154.298183,2,64628375,64628945,570,audio/Bl122_64628375.jpg,Bl122
7337,186.803971,187.028971,1,5604119,5610869,6750,audio/Or61_5604119.jpg,Or61
7338,503.885221,503.904221,1,15116556,15117126,570,audio/Or61_15116556.jpg,Or61
7339,197.618012,197.781012,1,5928540,5933430,4890,audio/Or61_5928540.jpg,Or61
7340,2201.547183,2201.591183,2,66046415,66047735,1320,audio/Bl122_66046415.jpg,Bl122
7341,701.549271,701.634271,1,21046478,21049028,2550,audio/Or61_21046478.jpg,Or61
7342,15060.189966,15060.359966,1,451805698,451810798,5100,audio/Ti81_451805698.jpg,Ti81
7343,1950.607779,1950.641779,1,58518233,58519253,1020,audio/Bl122_58518233.jpg,Bl122
7344,2159.714183,2159.722183,1,64791425,64791665,240,audio/Bl122_64791425.jpg,Bl122
7345,541.242416,541.287416,1,16237272,16238622,1350,audio/Or61_16237272.jpg,Or61
7346,2097.604961,2097.723961,1,62928148,62931718,3570,audio/Bl122_62928148.jpg,Bl122
7347,751.826271,752.135271,1,22554788,22564058,9270,audio/Or61_22554788.jpg,Or61
7348,1951.427779,1951.475779,2,58542833,58544273,1440,audio/Bl122_58542833.jpg,Bl122
7349,2189.948183,2189.953183,2,65698445,65698595,150,audio/Bl122_65698445.jpg,Bl122
7350,727.413271,727.432271,1,21822398,21822968,570,audio/Or61_21822398.jpg,Or61
7351,637.896417,637.982417,1,19136892,19139472,2580,audio/Or61_19136892.jpg,Or61
7352,15127.347831,15127.359966,1,453820434,453820798,364,audio/Ti81_453820434.jpg,Ti81
7353,15165.058257,15165.101257,1,454951747,454953037,1290,audio/Ti81_454951747.jpg,Ti81
7354,413.673165,413.675165,2,12410194,12410254,60,audio/Or61_12410194.jpg,Or61
7355,2219.232183,2219.273183,1,66576965,66578195,1230,audio/Bl122_66576965.jpg,Bl122
7356,1970.593779,1970.626779,1,59117813,59118803,990,audio/Bl122_59117813.jpg,Bl122
7357,139.268615,139.523615,1,4178058,4185708,7650,audio/Or61_4178058.jpg,Or61
7358,2049.146469,2049.155469,2,61474394,61474664,270,audio/Bl122_61474394.jpg,Bl122
7359,2166.057183,2166.392183,1,64981715,64991765,10050,audio/Bl122_64981715.jpg,Bl122
7360,1788.173115,1788.338115,1,53645193,53650143,4950,audio/Bl122_53645193.jpg,Bl122
7361,2207.720183,2207.724183,2,66231605,66231725,120,audio/Bl122_66231605.jpg,Bl122
7362,2078.580823,2078.722823,1,62357424,62361684,4260,audio/Bl122_62357424.jpg,Bl122
7363,2198.076183,2198.093183,2,65942285,65942795,510,audio/Bl122_65942285.jpg,Bl122
7364,15327.303625,15327.398937,1,459819108,459821968,2860,audio/Ti81_459819108.jpg,Ti81
7365,499.298221,499.305221,2,14978946,14979156,210,audio/Or61_14978946.jpg,Or61
7366,8091.779536,8091.794536,1,242753386,242753836,450,audio/Li145_242753386.jpg,Li145
7367,2183.222183,2183.238183,2,65496665,65497145,480,audio/Bl122_65496665.jpg,Bl122
7368,2109.240082,2109.321082,1,63277202,63279632,2430,audio/Bl122_63277202.jpg,Bl122
7369,615.248417,615.256417,2,18457452,18457692,240,audio/Or61_18457452.jpg,Or61
7370,1953.958779,1953.987779,1,58618763,58619633,870,audio/Bl122_58618763.jpg,Bl122
7371,14928.099754,14928.122839,1,447842992,447843685,693,audio/Ti81_447842992.jpg,Ti81
7372,735.013271,735.019271,2,22050398,22050578,180,audio/Or61_22050398.jpg,Or61
7373,2094.928961,2094.952961,1,62847868,62848588,720,audio/Bl122_62847868.jpg,Bl122
7374,2127.255183,2127.259183,2,63817655,63817775,120,audio/Bl122_63817655.jpg,Bl122
7375,1785.30943,1785.31843,2,53559282,53559552,270,audio/Bl122_53559282.jpg,Bl122
7376,1485.459018,1485.474018,1,44563770,44564220,450,audio/Li145_44563770.jpg,Li145
7377,2229.629183,2229.641183,1,66888875,66889235,360,audio/Bl122_66888875.jpg,Bl122
7378,15341.368971,15341.476971,1,460241069,460244309,3240,audio/Ti81_460241069.jpg,Ti81
7379,765.279271,765.296271,1,22958378,22958888,510,audio/Or61_22958378.jpg,Or61
7380,2203.636183,2203.672183,1,66109085,66110165,1080,audio/Bl122_66109085.jpg,Bl122
7381,1986.911779,1987.130779,1,59607353,59613923,6570,audio/Bl122_59607353.jpg,Bl122
7382,2148.494183,2148.546183,2,64454825,64456385,1560,audio/Bl122_64454825.jpg,Bl122
7383,1790.349115,1790.354115,2,53710473,53710623,150,audio/Bl122_53710473.jpg,Bl122
7384,2000.953779,2000.963779,2,60028613,60028913,300,audio/Bl122_60028613.jpg,Bl122
7385,547.828416,547.903416,1,16434852,16437102,2250,audio/Or61_16434852.jpg,Or61
7386,1963.035779,1963.051779,2,58891073,58891553,480,audio/Bl122_58891073.jpg,Bl122
7387,15236.603874,15236.773874,1,457098116,457103216,5100,audio/Ti81_457098116.jpg,Ti81
7388,1956.402779,1956.416779,2,58692083,58692503,420,audio/Bl122_58692083.jpg,Bl122
7389,397.190529,397.359529,1,11915715,11920785,5070,audio/Or61_11915715.jpg,Or61
7390,1808.833926,1808.850926,1,54265017,54265527,510,audio/Bl122_54265017.jpg,Bl122
7391,3547.850355,3547.907878,1,106435510,106437236,1726,audio/Ti81_106435510.jpg,Ti81
7392,2039.714815,2039.730815,1,61191444,61191924,480,audio/Li145_61191444.jpg,Li145
7393,15252.366074,15252.467074,1,457570982,457574012,3030,audio/Ti81_457570982.jpg,Ti81
7394,1992.883779,1992.887779,2,59786513,59786633,120,audio/Bl122_59786513.jpg,Bl122
7395,15272.724439,15272.805439,1,458181733,458184163,2430,audio/Ti81_458181733.jpg,Ti81
7396,15298.228664,15298.244664,1,458946859,458947339,480,audio/Ti81_458946859.jpg,Ti81
7397,2168.322183,2168.427183,1,65049665,65052815,3150,audio/Bl122_65049665.jpg,Bl122
7398,15343.855971,15343.898971,1,460315679,460316969,1290,audio/Ti81_460315679.jpg,Ti81
7399,1993.699779,1993.717779,2,59810993,59811533,540,audio/Bl122_59810993.jpg,Bl122
7400,2165.394183,2165.417183,2,64961825,64962515,690,audio/Bl122_64961825.jpg,Bl122
7401,2140.798183,2140.801183,2,64223945,64224035,90,audio/Bl122_64223945.jpg,Bl122
7402,2013.179959,2013.191959,2,60395398,60395758,360,audio/Bl122_60395398.jpg,Bl122
7403,15164.769257,15164.807257,1,454943077,454944217,1140,audio/Ti81_454943077.jpg,Ti81
7404,111.562667,111.753667,1,3346880,3352610,5730,audio/Bl122_3346880.jpg,Bl122
7405,2215.937183,2216.009183,1,66478115,66480275,2160,audio/Bl122_66478115.jpg,Bl122
7406,15342.760971,15342.945971,1,460282829,460288379,5550,audio/Ti81_460282829.jpg,Ti81
7407,492.104221,492.384221,1,14763126,14771526,8400,audio/Or61_14763126.jpg,Or61
7408,502.300221,502.466221,1,15069006,15073986,4980,audio/Or61_15069006.jpg,Or61
7409,1972.663779,1972.694779,2,59179913,59180843,930,audio/Bl122_59179913.jpg,Bl122
7410,2212.275183,2212.350183,1,66368255,66370505,2250,audio/Bl122_66368255.jpg,Bl122
7411,15237.657874,15237.699874,1,457129736,457130996,1260,audio/Ti81_457129736.jpg,Ti81
7412,671.810078,672.090078,1,20154302,20162702,8400,audio/Or61_20154302.jpg,Or61
7413,1984.746779,1984.806779,2,59542403,59544203,1800,audio/Bl122_59542403.jpg,Bl122
7414,15075.102623,15075.116402,1,452253078,452253492,414,audio/Ti81_452253078.jpg,Ti81
7415,925.205939,925.321995,1,27756178,27759659,3481,audio/Ti81_27756178.jpg,Ti81
7416,526.688416,526.723416,1,15800652,15801702,1050,audio/Or61_15800652.jpg,Or61
7417,1794.797115,1794.999115,1,53843913,53849973,6060,audio/Bl122_53843913.jpg,Bl122
7418,773.178271,773.181271,2,23195348,23195438,90,audio/Or61_23195348.jpg,Or61
7419,2232.698183,2232.722183,1,66980945,66981665,720,audio/Bl122_66980945.jpg,Bl122
7420,745.138271,745.248271,1,22354148,22357448,3300,audio/Or61_22354148.jpg,Or61
7421,2162.459183,2162.487183,1,64873775,64874615,840,audio/Bl122_64873775.jpg,Bl122
7422,1953.403779,1953.408779,2,58602113,58602263,150,audio/Bl122_58602113.jpg,Bl122
7423,2040.631815,2040.635815,2,61218954,61219074,120,audio/Li145_61218954.jpg,Li145
7424,815.494882,815.616882,1,24464846,24468506,3660,audio/Or61_24464846.jpg,Or61
7425,786.572827,786.589827,1,23597184,23597694,510,audio/Or61_23597184.jpg,Or61
7426,2081.143287,2081.179287,1,62434298,62435378,1080,audio/Bl122_62434298.jpg,Bl122
7427,15045.935061,15046.003181,1,451378051,451380095,2044,audio/Ti81_451378051.jpg,Ti81
7428,1992.027779,1992.032779,2,59760833,59760983,150,audio/Bl122_59760833.jpg,Bl122
7429,3498.489086,3498.543086,1,104954672,104956292,1620,audio/Li145_104954672.jpg,Li145
7430,487.247221,487.271221,2,14617416,14618136,720,audio/Or61_14617416.jpg,Or61
7431,1984.412779,1984.460779,2,59532383,59533823,1440,audio/Bl122_59532383.jpg,Bl122
7432,15341.006971,15341.053971,1,460230209,460231619,1410,audio/Ti81_460230209.jpg,Ti81
7433,2183.430183,2183.608183,1,65502905,65508245,5340,audio/Bl122_65502905.jpg,Bl122
7434,15298.761664,15298.834664,1,458962849,458965039,2190,audio/Ti81_458962849.jpg,Ti81
7435,501.032221,501.177221,1,15030966,15035316,4350,audio/Or61_15030966.jpg,Or61
7436,15256.512114,15256.723114,1,457695363,457701693,6330,audio/Ti81_457695363.jpg,Ti81
7437,2008.384779,2008.410779,2,60251543,60252323,780,audio/Bl122_60251543.jpg,Bl122
7438,575.48071,575.67271,1,17264421,17270181,5760,audio/Or61_17264421.jpg,Or61
7439,626.118417,626.163417,1,18783552,18784902,1350,audio/Or61_18783552.jpg,Or61
7440,15225.492443,15225.885443,1,456764773,456776563,11790,audio/Ti81_456764773.jpg,Ti81
7441,2057.858469,2057.861469,2,61735754,61735844,90,audio/Bl122_61735754.jpg,Bl122
7442,9167.950583,9167.954583,1,275038517,275038637,120,audio/Li145_275038517.jpg,Li145
7443,15314.449428,15314.582428,1,459433482,459437472,3990,audio/Ti81_459433482.jpg,Ti81
7444,2035.302469,2035.369469,1,61059074,61061084,2010,audio/Bl122_61059074.jpg,Bl122
7445,15289.316439,15289.584134,1,458679493,458687524,8031,audio/Ti81_458679493.jpg,Ti81
7446,15055.130966,15055.317419,1,451653928,451659522,5594,audio/Ti81_451653928.jpg,Ti81
7447,715.248271,715.380271,1,21457448,21461408,3960,audio/Or61_21457448.jpg,Or61
7448,1788.582115,1788.651115,2,53657463,53659533,2070,audio/Bl122_53657463.jpg,Bl122
7449,179.932971,179.975971,1,5397989,5399279,1290,audio/Or61_5397989.jpg,Or61
7450,727.322271,727.341271,1,21819668,21820238,570,audio/Or61_21819668.jpg,Or61
7451,1984.497779,1984.665779,1,59534933,59539973,5040,audio/Bl122_59534933.jpg,Bl122
7452,7553.434715,7553.461715,1,226603041,226603851,810,audio/Li145_226603041.jpg,Li145
7453,2223.232183,2223.298183,1,66696965,66698945,1980,audio/Bl122_66696965.jpg,Bl122
7454,2195.370183,2195.400183,2,65861105,65862005,900,audio/Bl122_65861105.jpg,Bl122
7455,7551.369715,7551.593715,1,226541091,226547811,6720,audio/Li145_226541091.jpg,Li145
7456,472.606221,472.631221,2,14178186,14178936,750,audio/Or61_14178186.jpg,Or61
7457,534.421416,534.433416,2,16032642,16033002,360,audio/Or61_16032642.jpg,Or61
7458,754.612271,754.631271,1,22638368,22638938,570,audio/Or61_22638368.jpg,Or61
7459,2202.175183,2202.403183,1,66065255,66072095,6840,audio/Bl122_66065255.jpg,Bl122
7460,750.886271,750.905271,1,22526588,22527158,570,audio/Or61_22526588.jpg,Or61
7461,2140.606183,2140.621183,2,64218185,64218635,450,audio/Bl122_64218185.jpg,Bl122
7462,1774.710974,1774.714974,2,53241329,53241449,120,audio/Bl122_53241329.jpg,Bl122
7463,15274.855439,15275.024439,1,458245663,458250733,5070,audio/Ti81_458245663.jpg,Ti81
7464,2167.688183,2167.703183,2,65030645,65031095,450,audio/Bl122_65030645.jpg,Bl122
7465,2219.939183,2219.964183,2,66598175,66598925,750,audio/Bl122_66598175.jpg,Bl122
7466,15214.07658,15214.21858,1,456422297,456426557,4260,audio/Ti81_456422297.jpg,Ti81
7467,1800.025115,1800.029115,2,54000753,54000873,120,audio/Bl122_54000753.jpg,Bl122
7468,8864.701987,8864.776987,1,265941059,265943309,2250,audio/Li145_265941059.jpg,Li145
7469,300.61956,300.71156,1,9018586,9021346,2760,audio/Or61_9018586.jpg,Or61
7470,2052.277469,2052.371469,1,61568324,61571144,2820,audio/Bl122_61568324.jpg,Bl122
7471,628.111417,628.169417,1,18843342,18845082,1740,audio/Or61_18843342.jpg,Or61
7472,2070.345469,2070.622469,1,62110364,62118674,8310,audio/Bl122_62110364.jpg,Bl122
7473,495.796221,495.833221,2,14873886,14874996,1110,audio/Or61_14873886.jpg,Or61
7474,499.369221,499.392221,2,14981076,14981766,690,audio/Or61_14981076.jpg,Or61
7475,9168.253583,9168.259583,1,275047607,275047787,180,audio/Li145_275047607.jpg,Li145
7476,2081.364287,2081.393287,1,62440928,62441798,870,audio/Bl122_62440928.jpg,Bl122
7477,2220.440183,2220.509183,1,66613205,66615275,2070,audio/Bl122_66613205.jpg,Bl122
7478,789.490827,789.541827,1,23684724,23686254,1530,audio/Or61_23684724.jpg,Or61
7479,804.374882,804.378882,2,24131246,24131366,120,audio/Or61_24131246.jpg,Or61
7480,480.986221,481.009221,1,14429586,14430276,690,audio/Or61_14429586.jpg,Or61
7481,2002.304779,2002.316779,2,60069143,60069503,360,audio/Bl122_60069143.jpg,Bl122
7482,2144.646183,2144.650183,2,64339385,64339505,120,audio/Bl122_64339385.jpg,Bl122
7483,15057.605966,15057.630966,1,451728178,451728928,750,audio/Ti81_451728178.jpg,Ti81
7484,2077.858823,2078.090823,1,62335764,62342724,6960,audio/Bl122_62335764.jpg,Bl122
7485,2218.806183,2218.857183,1,66564185,66565715,1530,audio/Bl122_66564185.jpg,Bl122
7486,15214.98658,15215.00358,1,456449597,456450107,510,audio/Ti81_456449597.jpg,Ti81
7487,2126.409183,2126.432183,2,63792275,63792965,690,audio/Bl122_63792275.jpg,Bl122
7488,15116.530981,15116.661981,1,453495929,453499859,3930,audio/Ti81_453495929.jpg,Ti81
7489,183.607971,183.661971,2,5508239,5509859,1620,audio/Or61_5508239.jpg,Or61
7490,15281.230439,15281.476439,1,458436913,458444293,7380,audio/Ti81_458436913.jpg,Ti81
7491,2215.533183,2215.545183,2,66465995,66466355,360,audio/Bl122_66465995.jpg,Bl122
7492,485.261221,485.334221,2,14557836,14560026,2190,audio/Or61_14557836.jpg,Or61
7493,6956.734877,6956.751877,1,208702046,208702556,510,audio/Li145_208702046.jpg,Li145
7494,818.810882,818.830882,1,24564326,24564926,600,audio/Or61_24564326.jpg,Or61
7495,613.826417,613.838417,2,18414792,18415152,360,audio/Or61_18414792.jpg,Or61
7496,15080.042682,15080.069682,1,452401280,452402090,810,audio/Ti81_452401280.jpg,Ti81
7497,2126.044183,2126.055183,2,63781325,63781655,330,audio/Bl122_63781325.jpg,Bl122
7498,534.866416,534.898416,1,16045992,16046952,960,audio/Or61_16045992.jpg,Or61
7499,6296.653561,6296.822561,1,188899606,188904676,5070,audio/Li145_188899606.jpg,Li145
7500,15309.205373,15309.337373,1,459276161,459280121,3960,audio/Ti81_459276161.jpg,Ti81
7501,1957.549779,1957.572779,1,58726493,58727183,690,audio/Bl122_58726493.jpg,Bl122
7502,3419.533047,3419.657555,1,102585991,102589726,3735,audio/Ti81_102585991.jpg,Ti81
7503,15251.705074,15251.791074,1,457551152,457553732,2580,audio/Ti81_457551152.jpg,Ti81
7504,743.332271,743.402271,1,22299968,22302068,2100,audio/Or61_22299968.jpg,Or61
7505,1800.669115,1800.774115,2,54020073,54023223,3150,audio/Bl122_54020073.jpg,Bl122
7506,718.398271,718.582271,1,21551948,21557468,5520,audio/Or61_21551948.jpg,Or61
7507,2234.648183,2234.657183,2,67039445,67039715,270,audio/Bl122_67039445.jpg,Bl122
7508,176.070735,176.332735,1,5282122,5289982,7860,audio/Or61_5282122.jpg,Or61
7509,627.267417,627.494417,1,18818022,18824832,6810,audio/Or61_18818022.jpg,Or61
7510,804.225882,804.344882,1,24126776,24130346,3570,audio/Or61_24126776.jpg,Or61
7511,761.801271,761.836271,1,22854038,22855088,1050,audio/Or61_22854038.jpg,Or61
7512,3542.515059,3542.613959,1,106275451,106278418,2967,audio/Ti81_106275451.jpg,Ti81
7513,2092.980961,2093.061961,1,62789428,62791858,2430,audio/Bl122_62789428.jpg,Bl122
7514,501.180221,501.198221,1,15035406,15035946,540,audio/Or61_15035406.jpg,Or61
7515,15343.543971,15343.661971,1,460306319,460309859,3540,audio/Ti81_460306319.jpg,Ti81
7516,2155.727183,2155.733183,2,64671815,64671995,180,audio/Bl122_64671815.jpg,Bl122
7517,14899.842327,14900.022908,1,446995269,447000687,5418,audio/Ti81_446995269.jpg,Ti81
7518,721.333271,721.363271,1,21639998,21640898,900,audio/Or61_21639998.jpg,Or61
7519,2118.159183,2118.302183,1,63544775,63549065,4290,audio/Bl122_63544775.jpg,Bl122
7520,2203.730183,2203.735183,2,66111905,66112055,150,audio/Bl122_66111905.jpg,Bl122
7521,1948.001779,1948.049779,1,58440053,58441493,1440,audio/Bl122_58440053.jpg,Bl122
7522,2097.946961,2097.950961,2,62938408,62938528,120,audio/Bl122_62938408.jpg,Bl122
7523,2084.061961,2084.087961,1,62521858,62522638,780,audio/Bl122_62521858.jpg,Bl122
7524,2198.760183,2198.767183,2,65962805,65963015,210,audio/Bl122_65962805.jpg,Bl122
7525,2222.237183,2222.240183,2,66667115,66667205,90,audio/Bl122_66667115.jpg,Bl122
7526,1787.288115,1787.330115,1,53618643,53619903,1260,audio/Bl122_53618643.jpg,Bl122
7527,704.183271,704.187271,2,21125498,21125618,120,audio/Or61_21125498.jpg,Or61
7528,2121.332183,2121.335183,2,63639965,63640055,90,audio/Bl122_63639965.jpg,Bl122
7529,2045.002469,2045.043469,1,61350074,61351304,1230,audio/Bl122_61350074.jpg,Bl122
7530,3449.887239,3450.078329,1,103496617,103502349,5732,audio/Ti81_103496617.jpg,Ti81
7531,759.517271,759.521271,2,22785518,22785638,120,audio/Or61_22785518.jpg,Or61
7532,15096.402823,15096.466823,1,452892084,452894004,1920,audio/Ti81_452892084.jpg,Ti81
7533,2190.121183,2190.266183,1,65703635,65707985,4350,audio/Bl122_65703635.jpg,Bl122
7534,1959.823779,1959.928779,1,58794713,58797863,3150,audio/Bl122_58794713.jpg,Bl122
7535,2092.489961,2092.498961,2,62774698,62774968,270,audio/Bl122_62774698.jpg,Bl122
7536,15241.614874,15241.788874,1,457248446,457253666,5220,audio/Ti81_457248446.jpg,Ti81
7537,2164.293183,2164.300183,2,64928795,64929005,210,audio/Bl122_64928795.jpg,Bl122
7538,1486.186018,1486.205018,1,44585580,44586150,570,audio/Li145_44585580.jpg,Li145
7539,398.011529,398.033529,1,11940345,11941005,660,audio/Or61_11940345.jpg,Or61
7540,2001.450779,2001.454779,2,60043523,60043643,120,audio/Bl122_60043523.jpg,Bl122
7541,2225.387183,2225.848183,1,66761615,66775445,13830,audio/Bl122_66761615.jpg,Bl122
7542,1956.494779,1956.497779,2,58694843,58694933,90,audio/Bl122_58694843.jpg,Bl122
7543,803.762882,803.778882,1,24112886,24113366,480,audio/Or61_24112886.jpg,Or61
7544,15046.489355,15046.597966,1,451394680,451397938,3258,audio/Ti81_451394680.jpg,Ti81
7545,5885.082674,5885.091674,1,176552480,176552750,270,audio/Li145_176552480.jpg,Li145
7546,2114.544183,2114.552183,2,63436325,63436565,240,audio/Bl122_63436325.jpg,Bl122
7547,15105.012256,15105.064256,1,453150367,453151927,1560,audio/Ti81_453150367.jpg,Ti81
7548,1791.267115,1791.270115,2,53738013,53738103,90,audio/Bl122_53738013.jpg,Bl122
7549,2200.075183,2200.114183,2,66002255,66003425,1170,audio/Bl122_66002255.jpg,Bl122
7550,2151.054183,2151.258183,1,64531625,64537745,6120,audio/Bl122_64531625.jpg,Bl122
7551,469.266221,469.316221,1,14077986,14079486,1500,audio/Or61_14077986.jpg,Or61
7552,1969.422779,1969.433779,2,59082683,59083013,330,audio/Bl122_59082683.jpg,Bl122
7553,480.552221,480.622221,2,14416566,14418666,2100,audio/Or61_14416566.jpg,Or61
7554,385.872161,386.054161,1,11576164,11581624,5460,audio/Or61_11576164.jpg,Or61
7555,2223.981183,2224.011183,2,66719435,66720335,900,audio/Bl122_66719435.jpg,Bl122
7556,1791.873115,1791.992115,1,53756193,53759763,3570,audio/Bl122_53756193.jpg,Bl122
7557,5704.651085,5704.800085,1,171139532,171144002,4470,audio/Li145_171139532.jpg,Li145
7558,529.796416,529.895416,1,15893892,15896862,2970,audio/Or61_15893892.jpg,Or61
7559,817.288882,817.689882,1,24518666,24530696,12030,audio/Or61_24518666.jpg,Or61
7560,627.533417,627.536417,2,18826002,18826092,90,audio/Or61_18826002.jpg,Or61
7561,2083.970961,2084.014961,1,62519128,62520448,1320,audio/Bl122_62519128.jpg,Bl122
7562,725.516271,725.615271,1,21765488,21768458,2970,audio/Or61_21765488.jpg,Or61
7563,2186.551183,2186.788183,1,65596535,65603645,7110,audio/Bl122_65596535.jpg,Bl122
7564,2082.798961,2082.858961,2,62483968,62485768,1800,audio/Bl122_62483968.jpg,Bl122
7565,558.461416,558.477416,1,16753842,16754322,480,audio/Or61_16753842.jpg,Or61
7566,569.95899,570.14599,1,17098769,17104379,5610,audio/Or61_17098769.jpg,Or61
7567,721.085271,721.195271,1,21632558,21635858,3300,audio/Or61_21632558.jpg,Or61
7568,3624.787464,3624.793464,1,108743623,108743803,180,audio/Li145_108743623.jpg,Li145
7569,3439.759083,3440.099682,1,103192772,103202990,10218,audio/Ti81_103192772.jpg,Ti81
7570,15348.379971,15348.673971,1,460451399,460460219,8820,audio/Ti81_460451399.jpg,Ti81
7571,735.027271,735.212271,1,22050818,22056368,5550,audio/Or61_22050818.jpg,Or61
7572,1975.514779,1975.553779,2,59265443,59266613,1170,audio/Bl122_59265443.jpg,Bl122
7573,713.054271,713.070271,2,21391628,21392108,480,audio/Or61_21391628.jpg,Or61
7574,814.240882,814.246882,2,24427226,24427406,180,audio/Or61_24427226.jpg,Or61
7575,501.210221,501.271221,2,15036306,15038136,1830,audio/Or61_15036306.jpg,Or61
7576,183.891971,183.899971,2,5516759,5516999,240,audio/Or61_5516759.jpg,Or61
7577,2137.027183,2137.071183,1,64110815,64112135,1320,audio/Bl122_64110815.jpg,Bl122
7578,1962.999779,1963.002779,2,58889993,58890083,90,audio/Bl122_58889993.jpg,Bl122
7579,15326.255488,15326.368488,1,459787664,459791054,3390,audio/Ti81_459787664.jpg,Ti81
7580,2206.772183,2206.779183,2,66203165,66203375,210,audio/Bl122_66203165.jpg,Bl122
7581,6531.564326,6531.719326,1,195946929,195951579,4650,audio/Li145_195946929.jpg,Li145
7582,2069.068469,2069.073469,2,62072054,62072204,150,audio/Bl122_62072054.jpg,Bl122
7583,15148.455716,15148.525716,1,454453671,454455771,2100,audio/Ti81_454453671.jpg,Ti81
7584,15257.112114,15257.273114,1,457713363,457718193,4830,audio/Ti81_457713363.jpg,Ti81
7585,3580.495097,3580.514097,1,107414852,107415422,570,audio/Li145_107414852.jpg,Li145
7586,5873.211637,5873.226637,1,176196349,176196799,450,audio/Li145_176196349.jpg,Li145
7587,2034.074469,2034.077469,2,61022234,61022324,90,audio/Bl122_61022234.jpg,Bl122
7588,493.759221,493.788221,2,14812776,14813646,870,audio/Or61_14812776.jpg,Or61
7589,3467.577641,3467.614287,1,104027329,104028428,1099,audio/Ti81_104027329.jpg,Ti81
7590,675.696078,675.778078,1,20270882,20273342,2460,audio/Or61_20270882.jpg,Or61
7591,2099.146961,2099.152961,2,62974408,62974588,180,audio/Bl122_62974408.jpg,Bl122
7592,565.814416,565.832416,2,16974432,16974972,540,audio/Or61_16974432.jpg,Or61
7593,7547.278781,7547.290781,2,226418363,226418723,360,audio/Li145_226418363.jpg,Li145
7594,2227.796183,2227.851183,1,66833885,66835535,1650,audio/Bl122_66833885.jpg,Bl122
7595,15304.161373,15304.223373,1,459124841,459126701,1860,audio/Ti81_459124841.jpg,Ti81
7596,718.108271,718.131271,1,21543248,21543938,690,audio/Or61_21543248.jpg,Or61
7597,7492.101261,7492.279261,1,224763037,224768377,5340,audio/Li145_224763037.jpg,Li145
7598,2057.439016,2057.682016,1,61723170,61730460,7290,audio/Li145_61723170.jpg,Li145
7599,2122.423183,2122.428183,2,63672695,63672845,150,audio/Bl122_63672695.jpg,Bl122
7600,1960.317779,1960.320779,2,58809533,58809623,90,audio/Bl122_58809533.jpg,Bl122
7601,503.821221,503.882221,1,15114636,15116466,1830,audio/Or61_15114636.jpg,Or61
7602,606.840417,607.096417,1,18205212,18212892,7680,audio/Or61_18205212.jpg,Or61
7603,15274.111439,15274.157439,1,458223343,458224723,1380,audio/Ti81_458223343.jpg,Ti81
7604,7493.381261,7493.398261,1,224801437,224801947,510,audio/Li145_224801437.jpg,Li145
7605,471.566221,471.611221,1,14146986,14148336,1350,audio/Or61_14146986.jpg,Or61
7606,501.483221,501.641221,1,15044496,15049236,4740,audio/Or61_15044496.jpg,Or61
7607,627.056417,627.100417,2,18811692,18813012,1320,audio/Or61_18811692.jpg,Or61
7608,635.898417,635.928417,1,19076952,19077852,900,audio/Or61_19076952.jpg,Or61
7609,1963.662779,1963.890779,1,58909883,58916723,6840,audio/Bl122_58909883.jpg,Bl122
7610,15244.031874,15244.066874,1,457320956,457322006,1050,audio/Ti81_457320956.jpg,Ti81
7611,2032.454469,2032.534469,1,60973634,60976034,2400,audio/Bl122_60973634.jpg,Bl122
7612,736.827271,736.868271,1,22104818,22106048,1230,audio/Or61_22104818.jpg,Or61
7613,546.176416,546.197416,1,16385292,16385922,630,audio/Or61_16385292.jpg,Or61
7614,2177.634183,2177.678183,2,65329025,65330345,1320,audio/Bl122_65329025.jpg,Bl122
7615,15026.637725,15026.808277,1,450799131,450804248,5117,audio/Ti81_450799131.jpg,Ti81
7616,9537.186343,9537.219343,1,286115590,286116580,990,audio/Li145_286115590.jpg,Li145
7617,2036.994469,2037.124469,1,61109834,61113734,3900,audio/Bl122_61109834.jpg,Bl122
7618,622.179417,622.209417,2,18665382,18666282,900,audio/Or61_18665382.jpg,Or61
7619,625.009417,625.014417,2,18750282,18750432,150,audio/Or61_18750282.jpg,Or61
7620,15213.17858,15213.21558,1,456395357,456396467,1110,audio/Ti81_456395357.jpg,Ti81
7621,2143.291183,2143.303183,2,64298735,64299095,360,audio/Bl122_64298735.jpg,Bl122
7622,2227.658183,2227.664183,2,66829745,66829925,180,audio/Bl122_66829745.jpg,Bl122
7623,637.555417,637.568417,1,19126662,19127052,390,audio/Or61_19126662.jpg,Or61
7624,15241.252874,15241.429874,1,457237586,457242896,5310,audio/Ti81_457237586.jpg,Ti81
7625,2125.581183,2125.585183,2,63767435,63767555,120,audio/Bl122_63767435.jpg,Bl122
7626,2057.932469,2057.936469,2,61737974,61738094,120,audio/Bl122_61737974.jpg,Bl122
7627,2072.409469,2072.414469,2,62172284,62172434,150,audio/Bl122_62172284.jpg,Bl122
7628,615.827417,615.946417,1,18474822,18478392,3570,audio/Or61_18474822.jpg,Or61
7629,15314.846428,15314.966428,1,459445392,459448992,3600,audio/Ti81_459445392.jpg,Ti81
7630,15328.363625,15328.498719,1,459850908,459854961,4053,audio/Ti81_459850908.jpg,Ti81
7631,6283.246145,6283.404145,1,188497384,188502124,4740,audio/Li145_188497384.jpg,Li145
7632,719.557271,719.640271,1,21586718,21589208,2490,audio/Or61_21586718.jpg,Or61
7633,554.926416,555.110416,1,16647792,16653312,5520,audio/Or61_16647792.jpg,Or61
7634,526.504416,526.538416,1,15795132,15796152,1020,audio/Or61_15795132.jpg,Or61
7635,2178.963183,2178.972183,2,65368895,65369165,270,audio/Bl122_65368895.jpg,Bl122
7636,2211.803183,2211.806183,2,66354095,66354185,90,audio/Bl122_66354095.jpg,Bl122
7637,2064.798469,2065.047469,1,61943954,61951424,7470,audio/Bl122_61943954.jpg,Bl122
7638,14902.342483,14902.357273,1,447070274,447070718,444,audio/Ti81_447070274.jpg,Ti81
7639,2183.053183,2183.057183,2,65491595,65491715,120,audio/Bl122_65491595.jpg,Bl122
7640,2173.569183,2173.839183,1,65207075,65215175,8100,audio/Bl122_65207075.jpg,Bl122
7641,747.096271,747.103271,2,22412888,22413098,210,audio/Or61_22412888.jpg,Or61
7642,2217.979183,2218.000183,2,66539375,66540005,630,audio/Bl122_66539375.jpg,Bl122
7643,2228.578183,2228.582183,2,66857345,66857465,120,audio/Bl122_66857345.jpg,Bl122
7644,2083.561961,2083.614961,2,62506858,62508448,1590,audio/Bl122_62506858.jpg,Bl122
7645,589.398867,589.401867,2,17681966,17682056,90,audio/Or61_17681966.jpg,Or61
7646,14731.014098,14731.12145,1,441930422,441933643,3221,audio/Ti81_441930422.jpg,Ti81
7647,1992.866779,1992.871779,2,59786003,59786153,150,audio/Bl122_59786003.jpg,Bl122
7648,491.439221,491.459221,2,14743176,14743776,600,audio/Or61_14743176.jpg,Or61
7649,2223.651183,2223.660183,1,66709535,66709805,270,audio/Bl122_66709535.jpg,Bl122
7650,2077.225823,2077.369823,1,62316774,62321094,4320,audio/Bl122_62316774.jpg,Bl122
7651,15044.40533,15044.650119,1,451332159,451339503,7344,audio/Ti81_451332159.jpg,Ti81
7652,815.618882,815.714882,1,24468566,24471446,2880,audio/Or61_24468566.jpg,Or61
7653,15262.332358,15262.370358,1,457869970,457871110,1140,audio/Ti81_457869970.jpg,Ti81
7654,3544.672186,3544.686315,1,106340165,106340589,424,audio/Ti81_106340165.jpg,Ti81
7655,2086.129961,2086.360961,1,62583898,62590828,6930,audio/Bl122_62583898.jpg,Bl122
7656,754.825271,755.048271,1,22644758,22651448,6690,audio/Or61_22644758.jpg,Or61
7657,289.884864,290.080864,1,8696545,8702425,5880,audio/Or61_8696545.jpg,Or61
7658,551.021416,551.111416,1,16530642,16533342,2700,audio/Or61_16530642.jpg,Or61
7659,1953.457779,1953.460779,2,58603733,58603823,90,audio/Bl122_58603733.jpg,Bl122
7660,15215.53158,15215.55858,1,456465947,456466757,810,audio/Ti81_456465947.jpg,Ti81
7661,2188.002183,2188.063183,1,65640065,65641895,1830,audio/Bl122_65640065.jpg,Bl122
7662,1976.267779,1976.272779,2,59288033,59288183,150,audio/Bl122_59288033.jpg,Bl122
7663,2054.806469,2054.808469,2,61644194,61644254,60,audio/Bl122_61644194.jpg,Bl122
7664,15078.284682,15078.375682,1,452348540,452351270,2730,audio/Ti81_452348540.jpg,Ti81
7665,750.550271,750.597271,1,22516508,22517918,1410,audio/Or61_22516508.jpg,Or61
7666,553.469416,553.559416,1,16604082,16606782,2700,audio/Or61_16604082.jpg,Or61
7667,1792.971115,1792.974115,2,53789133,53789223,90,audio/Bl122_53789133.jpg,Bl122
7668,479.549221,479.702221,1,14386476,14391066,4590,audio/Or61_14386476.jpg,Or61
7669,15053.516966,15053.554966,1,451605508,451606648,1140,audio/Ti81_451605508.jpg,Ti81
7670,1976.667779,1976.677779,2,59300033,59300333,300,audio/Bl122_59300033.jpg,Bl122
7671,480.196221,480.254221,2,14405886,14407626,1740,audio/Or61_14405886.jpg,Or61
7672,15047.993966,15048.026966,1,451439818,451440808,990,audio/Ti81_451439818.jpg,Ti81
7673,1949.145779,1949.203779,2,58474373,58476113,1740,audio/Bl122_58474373.jpg,Bl122
7674,15209.915925,15210.01658,1,456297477,456300497,3020,audio/Ti81_456297477.jpg,Ti81
7675,1991.102779,1991.113779,2,59733083,59733413,330,audio/Bl122_59733083.jpg,Bl122
7676,8083.290803,8083.317803,2,242498724,242499534,810,audio/Li145_242498724.jpg,Li145
7677,2178.871183,2178.897183,2,65366135,65366915,780,audio/Bl122_65366135.jpg,Bl122
7678,636.314417,636.332417,1,19089432,19089972,540,audio/Or61_19089432.jpg,Or61
7679,15022.204638,15022.274398,1,450666139,450668231,2092,audio/Ti81_450666139.jpg,Ti81
7680,544.530416,544.931416,1,16335912,16347942,12030,audio/Or61_16335912.jpg,Or61
7681,2061.170469,2061.174469,2,61835114,61835234,120,audio/Bl122_61835114.jpg,Bl122
7682,2186.014183,2186.145183,1,65580425,65584355,3930,audio/Bl122_65580425.jpg,Bl122
7683,752.558271,752.620271,1,22576748,22578608,1860,audio/Or61_22576748.jpg,Or61
7684,2183.167183,2183.195183,2,65495015,65495855,840,audio/Bl122_65495015.jpg,Bl122
7685,793.732827,793.746827,1,23811984,23812404,420,audio/Or61_23811984.jpg,Or61
7686,1971.852779,1972.142779,1,59155583,59164283,8700,audio/Bl122_59155583.jpg,Bl122
7687,733.801271,733.837271,1,22014038,22015118,1080,audio/Or61_22014038.jpg,Or61
7688,6299.398561,6299.430561,1,188981956,188982916,960,audio/Li145_188981956.jpg,Li145
7689,2159.626183,2159.704183,1,64788785,64791125,2340,audio/Bl122_64788785.jpg,Bl122
7690,488.601221,488.627221,2,14658036,14658816,780,audio/Or61_14658036.jpg,Or61
7691,15128.038981,15128.107981,1,453841169,453843239,2070,audio/Ti81_453841169.jpg,Ti81
7692,2215.445183,2215.462183,2,66463355,66463865,510,audio/Bl122_66463355.jpg,Bl122
7693,15090.3799,15090.4059,1,452711397,452712177,780,audio/Ti81_452711397.jpg,Ti81
7694,514.929221,515.154221,1,15447876,15454626,6750,audio/Or61_15447876.jpg,Or61
7695,749.151271,749.185271,1,22474538,22475558,1020,audio/Or61_22474538.jpg,Or61
7696,1791.502115,1791.505115,2,53745063,53745153,90,audio/Bl122_53745063.jpg,Bl122
7697,798.483827,798.524827,2,23954514,23955744,1230,audio/Or61_23954514.jpg,Or61
7698,2214.505183,2214.789183,1,66435155,66443675,8520,audio/Bl122_66435155.jpg,Bl122
7699,786.666827,786.693827,1,23600004,23600814,810,audio/Or61_23600004.jpg,Or61
7700,15116.809981,15116.849981,1,453504299,453505499,1200,audio/Ti81_453504299.jpg,Ti81
7701,2146.167183,2146.419183,1,64385015,64392575,7560,audio/Bl122_64385015.jpg,Bl122
7702,5842.191404,5842.211404,1,175265742,175266342,600,audio/Li145_175265742.jpg,Li145
7703,744.626271,744.630271,2,22338788,22338908,120,audio/Or61_22338788.jpg,Or61
7704,477.596221,477.693221,1,14327886,14330796,2910,audio/Or61_14327886.jpg,Or61
7705,927.095382,927.261392,1,27812861,27817841,4980,audio/Ti81_27812861.jpg,Ti81
7706,482.281221,482.322221,1,14468436,14469666,1230,audio/Or61_14468436.jpg,Or61
7707,726.305271,726.311271,2,21789158,21789338,180,audio/Or61_21789158.jpg,Or61
7708,1940.821779,1940.824779,2,58224653,58224743,90,audio/Bl122_58224653.jpg,Bl122
7709,14943.86924,14944.046983,1,448316077,448321409,5332,audio/Ti81_448316077.jpg,Ti81
7710,699.026271,699.233271,1,20970788,20976998,6210,audio/Or61_20970788.jpg,Or61
7711,576.65171,576.72771,1,17299551,17301831,2280,audio/Or61_17299551.jpg,Or61
7712,15132.764989,15132.832989,1,453982949,453984989,2040,audio/Ti81_453982949.jpg,Ti81
7713,2055.169469,2055.178469,1,61655084,61655354,270,audio/Bl122_61655084.jpg,Bl122
7714,2179.026183,2179.036183,2,65370785,65371085,300,audio/Bl122_65370785.jpg,Bl122
7715,2124.613183,2124.776183,1,63738395,63743285,4890,audio/Bl122_63738395.jpg,Bl122
7716,568.705467,568.726467,1,17061164,17061794,630,audio/Or61_17061164.jpg,Or61
7717,618.026417,618.224417,1,18540792,18546732,5940,audio/Or61_18540792.jpg,Or61
7718,2168.665183,2168.678183,2,65059955,65060345,390,audio/Bl122_65059955.jpg,Bl122
7719,1769.600657,1769.609657,2,53088019,53088289,270,audio/Bl122_53088019.jpg,Bl122
7720,8097.728141,8097.742141,1,242931844,242932264,420,audio/Li145_242931844.jpg,Li145
7721,2126.917183,2126.927183,2,63807515,63807815,300,audio/Bl122_63807515.jpg,Bl122
7722,586.14673,586.15573,2,17584401,17584671,270,audio/Or61_17584401.jpg,Or61
7723,15127.472981,15127.492981,1,453824189,453824789,600,audio/Ti81_453824189.jpg,Ti81
7724,1948.309779,1948.417779,1,58449293,58452533,3240,audio/Bl122_58449293.jpg,Bl122
7725,1939.636779,1939.656779,2,58189103,58189703,600,audio/Bl122_58189103.jpg,Bl122
7726,810.313882,810.378882,1,24309416,24311366,1950,audio/Or61_24309416.jpg,Or61
7727,512.134221,512.208221,1,15364026,15366246,2220,audio/Or61_15364026.jpg,Or61
7728,813.589882,813.649882,1,24407696,24409496,1800,audio/Or61_24407696.jpg,Or61
7729,9168.543583,9168.573583,1,275056307,275057207,900,audio/Li145_275056307.jpg,Li145
7730,518.739221,518.745221,2,15562176,15562356,180,audio/Or61_15562176.jpg,Or61
7731,1994.557779,1994.647779,1,59836733,59839433,2700,audio/Bl122_59836733.jpg,Bl122
7732,1977.198779,1977.248779,1,59315963,59317463,1500,audio/Bl122_59315963.jpg,Bl122
7733,1935.149613,1935.230613,1,58054488,58056918,2430,audio/Bl122_58054488.jpg,Bl122
7734,15039.334881,15039.57595,1,451180046,451187278,7232,audio/Ti81_451180046.jpg,Ti81
7735,942.774546,942.997828,1,28283236,28289934,6698,audio/Ti81_28283236.jpg,Ti81
7736,1989.777779,1989.781779,2,59693333,59693453,120,audio/Bl122_59693333.jpg,Bl122
7737,2029.062908,2029.065908,2,60871887,60871977,90,audio/Bl122_60871887.jpg,Bl122
7738,7555.286715,7555.310715,1,226658601,226659321,720,audio/Li145_226658601.jpg,Li145
7739,15277.162412,15277.386919,1,458314872,458321607,6735,audio/Ti81_458314872.jpg,Ti81
7740,485.420221,485.557221,1,14562606,14566716,4110,audio/Or61_14562606.jpg,Or61
7741,2231.312183,2231.343183,2,66939365,66940295,930,audio/Bl122_66939365.jpg,Bl122
7742,528.230416,528.241416,2,15846912,15847242,330,audio/Or61_15846912.jpg,Or61
7743,851.378055,851.545075,1,25541341,25546352,5011,audio/Ti81_25541341.jpg,Ti81
7744,1988.380779,1988.385779,2,59651423,59651573,150,audio/Bl122_59651423.jpg,Bl122
7745,2120.823183,2120.829183,2,63624695,63624875,180,audio/Bl122_63624695.jpg,Bl122
7746,402.945692,402.991692,2,12088370,12089750,1380,audio/Or61_12088370.jpg,Or61
7747,1788.671115,1788.703115,2,53660133,53661093,960,audio/Bl122_53660133.jpg,Bl122
7748,711.454271,711.592271,1,21343628,21347768,4140,audio/Or61_21343628.jpg,Or61
7749,15041.799936,15041.877769,1,451253998,451256333,2335,audio/Ti81_451253998.jpg,Ti81
7750,3449.569599,3449.77194,1,103487087,103493158,6071,audio/Ti81_103487087.jpg,Ti81
7751,504.875221,504.891221,1,15146256,15146736,480,audio/Or61_15146256.jpg,Or61
7752,2055.702469,2055.722469,1,61671074,61671674,600,audio/Bl122_61671074.jpg,Bl122
7753,8083.427803,8083.620803,1,242502834,242508624,5790,audio/Li145_242502834.jpg,Li145
7754,565.423416,565.558416,1,16962702,16966752,4050,audio/Or61_16962702.jpg,Or61
7755,2172.193183,2172.197183,2,65165795,65165915,120,audio/Bl122_65165795.jpg,Bl122
7756,3583.254686,3583.264686,1,107497640,107497940,300,audio/Li145_107497640.jpg,Li145
7757,1990.111779,1990.117779,2,59703353,59703533,180,audio/Bl122_59703353.jpg,Bl122
7758,2212.689183,2212.730183,2,66380675,66381905,1230,audio/Bl122_66380675.jpg,Bl122
7759,15257.523114,15257.677114,1,457725693,457730313,4620,audio/Ti81_457725693.jpg,Ti81
7760,9038.124853,9038.280853,1,271143745,271148425,4680,audio/Li145_271143745.jpg,Li145
7761,2063.168469,2063.172469,2,61895054,61895174,120,audio/Bl122_61895054.jpg,Bl122
7762,2117.156183,2117.188183,1,63514685,63515645,960,audio/Bl122_63514685.jpg,Bl122
7763,2217.666183,2217.740183,2,66529985,66532205,2220,audio/Bl122_66529985.jpg,Bl122
7764,812.572882,812.651882,1,24377186,24379556,2370,audio/Or61_24377186.jpg,Or61
7765,1752.489451,1752.588451,1,52574683,52577653,2970,audio/Bl122_52574683.jpg,Bl122
7766,9176.127719,9176.191719,1,275283831,275285751,1920,audio/Li145_275283831.jpg,Li145
7767,1970.030779,1970.062779,2,59100923,59101883,960,audio/Bl122_59100923.jpg,Bl122
7768,2167.588183,2167.662183,1,65027645,65029865,2220,audio/Bl122_65027645.jpg,Bl122
7769,15264.618358,15264.686358,1,457938550,457940590,2040,audio/Ti81_457938550.jpg,Ti81
7770,2054.520469,2054.538469,2,61635614,61636154,540,audio/Bl122_61635614.jpg,Bl122
7771,15096.471823,15096.523823,1,452894154,452895714,1560,audio/Ti81_452894154.jpg,Ti81
7772,620.600417,620.652417,1,18618012,18619572,1560,audio/Or61_18618012.jpg,Or61
7773,793.259827,793.263827,2,23797794,23797914,120,audio/Or61_23797794.jpg,Or61
7774,2044.008469,2044.081469,1,61320254,61322444,2190,audio/Bl122_61320254.jpg,Bl122
7775,15080.166682,15080.483682,1,452405000,452414510,9510,audio/Ti81_452405000.jpg,Ti81
7776,2172.038183,2172.132183,1,65161145,65163965,2820,audio/Bl122_65161145.jpg,Bl122
7777,15240.832874,15240.992874,1,457224986,457229786,4800,audio/Ti81_457224986.jpg,Ti81
7778,2191.292183,2191.415183,1,65738765,65742455,3690,audio/Bl122_65738765.jpg,Bl122
7779,2125.658183,2125.686183,2,63769745,63770585,840,audio/Bl122_63769745.jpg,Bl122
7780,1798.897115,1798.921115,1,53966913,53967633,720,audio/Bl122_53966913.jpg,Bl122
7781,2126.733183,2126.819183,1,63801995,63804575,2580,audio/Bl122_63801995.jpg,Bl122
7782,2153.612183,2153.670183,1,64608365,64610105,1740,audio/Bl122_64608365.jpg,Bl122
7783,1955.959779,1956.002779,2,58678793,58680083,1290,audio/Bl122_58678793.jpg,Bl122
7784,2158.714183,2158.955183,1,64761425,64768655,7230,audio/Bl122_64761425.jpg,Bl122
7785,611.372417,611.374417,2,18341172,18341232,60,audio/Or61_18341172.jpg,Or61
7786,806.329882,806.372882,1,24189896,24191186,1290,audio/Or61_24189896.jpg,Or61
7787,2196.574183,2196.577183,2,65897225,65897315,90,audio/Bl122_65897225.jpg,Bl122
7788,771.764271,771.773271,2,23152928,23153198,270,audio/Or61_23152928.jpg,Or61
7789,1958.745779,1958.805779,1,58762373,58764173,1800,audio/Bl122_58762373.jpg,Bl122
7790,8097.881141,8097.922141,1,242936434,242937664,1230,audio/Li145_242936434.jpg,Li145
7791,5841.187404,5841.192404,1,175235622,175235772,150,audio/Li145_175235622.jpg,Li145
7792,2221.146183,2221.157183,1,66634385,66634715,330,audio/Bl122_66634385.jpg,Bl122
7793,2057.880469,2057.914469,2,61736414,61737434,1020,audio/Bl122_61736414.jpg,Bl122
7794,15061.558966,15061.842966,1,451846768,451855288,8520,audio/Ti81_451846768.jpg,Ti81
7795,2013.910959,2013.914959,2,60417328,60417448,120,audio/Bl122_60417328.jpg,Bl122
7796,15309.100373,15309.121373,1,459273011,459273641,630,audio/Ti81_459273011.jpg,Ti81
7797,2109.854082,2109.883082,1,63295622,63296492,870,audio/Bl122_63295622.jpg,Bl122
7798,493.705221,493.751221,2,14811156,14812536,1380,audio/Or61_14811156.jpg,Or61
7799,2207.556183,2207.602183,1,66226685,66228065,1380,audio/Bl122_66226685.jpg,Bl122
7800,2183.248183,2183.400183,1,65497445,65502005,4560,audio/Bl122_65497445.jpg,Bl122
7801,15096.557823,15096.648823,1,452896734,452899464,2730,audio/Ti81_452896734.jpg,Ti81
7802,1790.279115,1790.300115,1,53708373,53709003,630,audio/Bl122_53708373.jpg,Bl122
7803,2093.646961,2093.671961,1,62809408,62810158,750,audio/Bl122_62809408.jpg,Bl122
7804,1986.485779,1986.494779,2,59594573,59594843,270,audio/Bl122_59594573.jpg,Bl122
7805,2184.207183,2184.237183,1,65526215,65527115,900,audio/Bl122_65526215.jpg,Bl122
7806,15280.850439,15281.064439,1,458425513,458431933,6420,audio/Ti81_458425513.jpg,Ti81
7807,2125.969183,2126.007183,2,63779075,63780215,1140,audio/Bl122_63779075.jpg,Bl122
7808,2167.720183,2167.909183,1,65031605,65037275,5670,audio/Bl122_65031605.jpg,Bl122
7809,1995.862779,1995.881779,1,59875883,59876453,570,audio/Bl122_59875883.jpg,Bl122
7810,1947.125779,1947.158779,1,58413773,58414763,990,audio/Bl122_58413773.jpg,Bl122
7811,15306.900012,15306.915181,1,459207000,459207455,455,audio/Ti81_459207000.jpg,Ti81
7812,2198.214183,2198.234183,2,65946425,65947025,600,audio/Bl122_65946425.jpg,Bl122
7813,510.372221,510.377221,2,15311166,15311316,150,audio/Or61_15311166.jpg,Or61
7814,818.631882,818.801882,1,24558956,24564056,5100,audio/Or61_24558956.jpg,Or61
7815,187.346971,187.399971,1,5620409,5621999,1590,audio/Or61_5620409.jpg,Or61
7816,657.695685,657.715685,1,19730870,19731470,600,audio/Li145_19730870.jpg,Li145
7817,485.929221,486.183221,1,14577876,14585496,7620,audio/Or61_14577876.jpg,Or61
7818,2005.296779,2005.374779,1,60158903,60161243,2340,audio/Bl122_60158903.jpg,Bl122
7819,921.272524,921.442319,1,27638175,27643269,5094,audio/Ti81_27638175.jpg,Ti81
7820,544.130416,544.182416,1,16323912,16325472,1560,audio/Or61_16323912.jpg,Or61
7821,601.945417,601.978417,1,18058362,18059352,990,audio/Or61_18058362.jpg,Or61
7822,2158.653183,2158.658183,2,64759595,64759745,150,audio/Bl122_64759595.jpg,Bl122
7823,15055.795966,15055.953017,1,451673878,451678590,4712,audio/Ti81_451673878.jpg,Ti81
7824,15263.222358,15263.289358,1,457896670,457898680,2010,audio/Ti81_457896670.jpg,Ti81
7825,673.891078,673.941078,1,20216732,20218232,1500,audio/Or61_20216732.jpg,Or61
7826,2156.137183,2156.142183,2,64684115,64684265,150,audio/Bl122_64684115.jpg,Bl122
7827,1969.555779,1969.598779,2,59086673,59087963,1290,audio/Bl122_59086673.jpg,Bl122
7828,15231.626443,15231.647443,1,456948793,456949423,630,audio/Ti81_456948793.jpg,Ti81
7829,2078.567823,2078.577823,2,62357034,62357334,300,audio/Bl122_62357034.jpg,Bl122
7830,1785.57643,1785.61343,1,53567292,53568402,1110,audio/Bl122_53567292.jpg,Bl122
7831,2199.142183,2199.148183,2,65974265,65974445,180,audio/Bl122_65974265.jpg,Bl122
7832,2218.864183,2219.113183,1,66565925,66573395,7470,audio/Bl122_66565925.jpg,Bl122
7833,2045.201361,2045.386361,1,61356040,61361590,5550,audio/Li145_61356040.jpg,Li145
7834,793.062827,793.121827,1,23791884,23793654,1770,audio/Or61_23791884.jpg,Or61
7835,636.102417,636.149417,2,19083072,19084482,1410,audio/Or61_19083072.jpg,Or61
7836,472.173221,472.181221,2,14165196,14165436,240,audio/Or61_14165196.jpg,Or61
7837,604.593417,604.852417,1,18137802,18145572,7770,audio/Or61_18137802.jpg,Or61
7838,1946.287779,1946.298779,2,58388633,58388963,330,audio/Bl122_58388633.jpg,Bl122
7839,796.692827,796.861827,1,23900784,23905854,5070,audio/Or61_23900784.jpg,Or61
7840,718.890271,718.913271,1,21566708,21567398,690,audio/Or61_21566708.jpg,Or61
7841,2214.114183,2214.119183,2,66423425,66423575,150,audio/Bl122_66423425.jpg,Bl122
7842,7550.826715,7550.838715,1,226524801,226525161,360,audio/Li145_226524801.jpg,Li145
7843,561.704416,561.950416,1,16851132,16858512,7380,audio/Or61_16851132.jpg,Or61
7844,565.565416,565.591416,1,16966962,16967742,780,audio/Or61_16966962.jpg,Or61
7845,610.894417,610.956417,1,18326832,18328692,1860,audio/Or61_18326832.jpg,Or61
7846,1975.675779,1975.731779,1,59270273,59271953,1680,audio/Bl122_59270273.jpg,Bl122
7847,15271.553439,15271.934439,1,458146603,458158033,11430,audio/Ti81_458146603.jpg,Ti81
7848,15142.84692,15143.031481,1,454285407,454290944,5537,audio/Ti81_454285407.jpg,Ti81
